year2,fage4,Firms,Estabs,Emp,Denom,Estabs_Entry,Estabs_Entry_Rate,Estabs_Exit,Estabs_Exit_Rate,Job_Creation,Job_Creation_Births,Job_Creation_Continuers,Job_Creation_Rate_Births,Job_Creation_Rate,Job_Destruction,Job_Destruction_Deaths,Job_Destruction_Continuers,Job_Destruction_Rate_Deaths,Job_Destruction_Rate,Net_Job_Creation,Net_Job_Creation_Rate,Reallocation_Rate,d_flag,firmdeath_firms,firmdeath_estabs,firmdeath_emp,sic1
1977,a) 0,564916,614722,3771393,1913359,603561,196.4,0,0,3716068,3716068,0,194.2,194.2,0,0,0,0,0,3716068,194.2,0,0,,,,
1977,l) Left Censored,2852989,3539070,62320419,62074272,94188,2.5,526010,14,10203446,2142834,8060612,3.5,16.4,9711153,3909657,5801496,6.3,15.6,492293,0.8,31.2,0,350748,352967,2224963,
1978,a) 0,503977,508428,2717384,1365036,503805,198.2,0,0,2704697,2704697,0,198.1,198.1,0,0,0,0,0,2704697,198.1,0,0,,,,
1978,b) 1,413128,465143,3724038,3742178,7163,1.3,150490,27.9,1106734,93577,1013157,2.5,29.6,1143014,676050,466964,18.1,30.5,-36280,-0.9,59.2,0,106729,107104,449996,
1978,l) Left Censored,2553135,3249112,63228930,62726068,115845,3.4,398475,11.7,10250926,1757829,8493097,2.8,16.3,9245202,3607043,5638159,5.8,14.7,1005724,1.6,29.4,0,253713,255352,1673418,
1979,a) 0,497762,503436,2860458,1438816,498952,198.2,0,0,2843284,2843284,0,197.6,197.6,0,0,0,0,0,2843284,197.6,0,0,,,,
1979,b) 1,390339,397178,2794170,2788489,2309,0.5,106725,23.5,849295,36725,812570,1.3,30.5,837932,443120,394812,15.9,30,11363,0.5,60,0,76126,76175,321013,
1979,c) 2,355885,407821,3630616,3667948,21111,4.8,74036,17,847104,157063,690041,4.3,23.1,921768,416979,504789,11.4,25.1,-74664,-2,46.2,0,47397,47546,238594,
1979,l) Left Censored,2354094,3067890,64731435,63935427,119416,3.8,291131,9.2,9903494,1961447,7942047,3.1,15.5,8311479,2779088,5532391,4.3,13,1592015,2.5,26,0,169728,171169,1107893,
1980,a) 0,451533,456278,2505863,1259348,452092,198.2,0,0,2493030,2493030,0,198,198,0,0,0,0,0,2493030,198,0,0,,,,
1980,b) 1,363739,371248,2621001,2719376,2143,0.5,114416,26.1,712244,41700,670544,1.5,26.2,908993,499664,409329,18.4,33.4,-196749,-7.2,52.4,0,92585,92673,410394,
1980,c) 2,319382,327390,2404651,2554489,12611,3.5,74514,20.6,516546,88084,428462,3.4,20.2,816221,393276,422945,15.4,32,-299675,-11.8,40.4,0,60094,60164,323069,
1980,d) 3,307600,358515,3443277,3528427,15399,4,62433,16.3,706871,150836,556035,4.3,20,877171,370474,506697,10.5,24.9,-170300,-4.9,40,0,43433,43695,231864,
1980,l) Left Censored,2164218,2885322,63775133,64223351,98060,3.3,272993,9.2,8289484,1794030,6495454,2.8,12.9,9185920,2684673,6501247,4.2,14.3,-896436,-1.4,25.8,0,175371,176832,1158248,
1981,a) 0,453764,456698,2968748,1527351,444110,194.5,0,0,2882794,2882794,0,188.7,188.7,0,0,0,0,0,2882794,188.7,0,0,,,,
1981,b) 1,331936,337467,2343917,2425550,2199,0.6,110152,27.8,668599,38646,629953,1.6,27.6,831865,501448,330417,20.7,34.3,-163266,-6.7,55.2,0,80307,80370,358305,
1981,c) 2,305852,314095,2412981,2535659,12065,3.5,74043,21.6,518102,88877,429225,3.5,20.4,763457,409772,353685,16.2,30.1,-245355,-9.7,40.8,0,53029,53099,289247,
1981,d) 3,268723,276857,2155788,2276432,10167,3.4,58959,19.6,418047,72955,345092,3.2,18.4,659334,317792,341542,14,29,-241287,-10.6,36.8,0,42762,42806,222194,
1981,e) 4,261941,305388,3051976,3215717,12955,3.9,62319,18.8,545660,126494,419166,3.9,17,873142,409236,463906,12.7,27.2,-327482,-10.2,34,0,34095,34386,186124,
1981,l) Left Censored,1944368,2650719,60605624,61620766,96150,3.5,303869,11,7750780,2009251,5741529,3.3,12.6,9781064,3399516,6381548,5.5,15.9,-2030284,-3.3,25.2,0,155548,157021,1077091,
1982,a) 0,448747,461672,3024786,1528561,458773,198.7,0,0,2992451,2992451,0,195.8,195.8,0,0,0,0,0,2992451,195.8,0,0,,,,
1982,b) 1,351102,363539,2974017,3008960,7675,1.9,92819,22.6,845896,127903,717993,4.3,28.1,915783,453840,461943,15.1,30.4,-69887,-2.3,56.2,0,64280,64282,321715,
1982,c) 2,280428,290671,2135663,2220737,18651,5.9,59257,18.9,533363,151995,381368,6.8,24,703511,326586,376925,14.7,31.7,-170148,-7.7,48,0,38296,38311,217915,
1982,d) 3,264770,279318,2198468,2291063,18827,6.3,49132,16.6,478248,145733,332515,6.4,20.9,663440,287680,375760,12.6,29,-185192,-8.1,41.8,0,31021,31026,182652,
1982,e) 4,233224,247181,2114556,2125802,15814,6,41077,15.7,544917,212874,332043,10,25.6,567408,228604,338804,10.8,26.7,-22491,-1.1,51.2,0,24991,24999,147732,
1982,f) 5,233004,284661,3023568,3045960,20893,7.1,38350,13,609717,215936,393781,7.1,20,654500,248349,406151,8.2,21.5,-44783,-1.5,40,0,20850,20905,123593,
1982,l) Left Censored,1792719,2543672,59011166,59731190,139337,5.4,224586,8.6,7635540,2379885,5255655,4,12.8,9075588,2507402,6568186,4.2,15.2,-1440048,-2.4,25.6,0,110350,110879,786809,
1983,a) 0,433663,439090,2502666,1262473,430915,196.3,0,0,2480387,2480387,0,196.5,196.5,0,0,0,0,0,2480387,196.5,0,0,,,,
1983,b) 1,341633,355221,2617250,2819842,2017,0.5,103172,25.3,667869,37847,630022,1.3,23.7,1073055,498460,574595,17.7,38.1,-405186,-14.4,47.4,0,77339,77530,377636,
1983,c) 2,298311,311357,2594105,2772318,10459,3.1,61946,18.4,510705,70276,440429,2.5,18.4,867132,389000,478132,14,31.3,-356427,-12.9,36.8,0,47006,47025,277420,
1983,d) 3,246441,256969,1946659,2044548,8867,3.2,44642,16.3,374681,49277,325404,2.4,18.3,570458,246074,324384,12,27.9,-195777,-9.6,36.6,0,32348,32422,183686,
1983,e) 4,237189,251497,2054383,2124134,8496,3.2,38697,14.6,382671,57531,325140,2.7,18,522174,227651,294523,10.7,24.6,-139503,-6.6,36,0,27361,27413,161881,
1983,f) 5,213699,228089,1864546,1993113,7655,3.2,30219,12.7,324340,54617,269723,2.7,16.3,581473,174900,406573,8.8,29.2,-257133,-12.9,32.6,0,21382,21440,120745,
1983,g) 6 to 10,216611,267711,2863640,2951272,10645,3.9,30982,11.2,472726,101850,370876,3.5,16,647991,217012,430979,7.4,22,-175265,-6,32,0,18288,18537,112664,
1983,l) Left Censored,1700656,2446896,56273616,57493823,91661,3.7,204683,8.2,6941348,1873231,5068117,3.3,12.1,9381762,2481537,6900225,4.3,16.3,-2440414,-4.2,24.2,0,104758,106082,728101,
1984,a) 0,503134,507498,2797735,1404217,504412,198.8,0,0,2787036,2787036,0,198.5,198.5,0,0,0,0,0,2787036,198.5,0,0,,,,
1984,b) 1,337820,345261,2599106,2565683,2534,0.6,92893,23.7,803491,61038,742453,2.4,31.3,736645,404799,331846,15.8,28.7,66846,2.6,57.4,0,66184,66205,302299,
1984,c) 2,289634,302706,2562459,2579441,11770,3.6,61921,18.8,610118,82942,527176,3.2,23.7,644083,345707,298376,13.4,25,-33965,-1.3,47.4,0,44166,44349,253853,
1984,d) 3,263145,276339,2624122,2610561,10328,3.5,45338,15.4,564953,74125,490828,2.8,21.6,537832,259070,278762,9.9,20.6,27121,1,41.2,0,32355,32403,186143,
1984,e) 4,222933,233305,1979144,1958200,9744,4,34412,14,424802,56924,367878,2.9,21.7,382913,182646,200267,9.3,19.6,41889,2.1,39.2,0,23661,23728,128045,
1984,f) 5,216746,230765,2035061,2023732,9752,4,31201,12.9,423524,60912,362612,3,20.9,400866,176918,223948,8.7,19.8,22658,1.1,39.6,0,21091,21162,117194,
1984,g) 6 to 10,399043,465267,4839082,4789495,20532,4.3,53054,11,915819,154846,760973,3.2,19.1,816645,310176,506469,6.5,17.1,99174,2,34.2,0,31767,31992,172017,
1984,l) Left Censored,1603810,2361628,57950055,57130305,93851,3.9,184900,7.7,8353065,2101378,6251687,3.7,14.6,6713567,2097434,4616133,3.7,11.8,1639498,2.8,23.6,0,90126,91070,595018,
1985,a) 0,509016,514742,2941916,1478219,511430,198.7,0,0,2927394,2927394,0,198,198,0,0,0,0,0,2927394,198,0,0,,,,
1985,b) 1,406017,413429,3168270,3091029,2640,0.6,92856,20.1,961137,73190,887947,2.4,31.1,806657,413180,393477,13.4,26.1,154480,5,52.2,0,66812,66825,306367,
1985,c) 2,286138,295490,2536397,2582450,12974,4,60345,18.8,612727,100355,512372,3.9,23.7,704833,341402,363431,13.2,27.3,-92106,-3.6,47.4,0,45528,45578,257968,
1985,d) 3,254517,267538,2457055,2506806,10489,3.7,45680,16,502482,68731,433751,2.7,20,601983,296105,305878,11.8,24,-99501,-4,40,0,33443,33682,213472,
1985,e) 4,236781,250469,2594151,2623086,9483,3.6,35777,13.6,485622,66855,418767,2.5,18.5,543491,238292,305199,9.1,20.7,-57869,-2.2,37,0,25591,25686,157657,
1985,f) 5,203094,213688,1936656,1957214,8547,3.8,28768,12.9,370294,50978,319316,2.6,18.9,411409,179981,231428,9.2,21,-41115,-2.1,37.8,0,20582,20687,127629,
1985,g) 6 to 10,566479,648222,6804354,6834810,27843,4.1,77122,11.5,1223875,222975,1000900,3.3,17.9,1284786,553617,731169,8.1,18.8,-60911,-0.9,35.8,0,49650,50063,326463,
1985,l) Left Censored,1513667,2273334,58458090,58484717,90174,3.9,190148,8.2,7502430,1854490,5647940,3.2,12.8,7555684,2674636,4881048,4.6,12.9,-53254,-0.1,25.6,0,95321,96661,810807,
1986,a) 0,522206,527695,3143241,1576096,526153,199.4,0,0,3134290,3134290,0,198.9,198.9,0,0,0,0,0,3134290,198.9,0,0,,,,
1986,b) 1,404839,412574,3216521,3088309,9437,2,105149,22.7,1135350,291971,843379,9.5,36.8,878925,489036,389889,15.8,28.5,256425,8.3,57,0,75337,75406,365024,
1986,c) 2,346261,355183,2954033,3041832,14314,3.7,68437,17.8,683125,110788,572337,3.6,22.5,858724,443597,415127,14.6,28.2,-175599,-5.7,45,0,51349,51364,332683,
1986,d) 3,247643,258436,2424674,2492264,10935,3.9,46053,16.6,498818,90171,408647,3.6,20,633999,298166,335833,12,25.4,-135181,-5.4,40,0,34711,34727,220466,
1986,e) 4,225412,238836,2350702,2412167,8744,3.5,36424,14.4,430184,63369,366815,2.6,17.8,553113,244561,308552,10.1,22.9,-122929,-5.1,35.6,0,26676,26740,175336,
1986,f) 5,213343,227648,2536182,2577092,8506,3.6,30858,12.9,455672,71983,383689,2.8,17.7,537491,220139,317352,8.5,20.9,-81819,-3.2,35.4,0,22078,22142,151185,
1986,g) 6 to 10,707811,803174,8639152,8733404,35061,4.2,93671,11.2,1510080,300919,1209161,3.4,17.3,1698583,631232,1067351,7.2,19.4,-188503,-2.1,34.6,0,62246,62524,390248,
1986,l) Left Censored,1418110,2186753,58203333,58212102,98600,4.4,178497,8,7637798,2180694,5457104,3.7,13.1,7655337,2406839,5248498,4.1,13.2,-17539,-0.1,26.2,0,91607,92570,756170,
1987,a) 0,544186,558689,3588167,1947948,554993,198.7,0,0,3280439,3280439,0,168.4,168.4,0,0,0,0,0,3280439,168.4,0,0,,,,
1987,b) 1,404622,417730,3610400,3627948,7616,1.6,105955,22.4,968148,118236,849912,3.3,26.7,1003244,535619,467625,14.8,27.7,-35096,-1,53.4,0,81378,81436,412711,
1987,c) 2,341990,354928,3005618,3093352,20052,5.2,70211,18.3,744629,161078,583551,5.2,24.1,920097,470802,449295,15.2,29.7,-175468,-5.6,48.2,0,54475,54571,335142,
1987,d) 3,303872,318270,2805151,2869156,16175,4.8,50008,14.9,618146,134583,483563,4.7,21.5,746158,351853,394305,12.3,26,-128012,-4.5,43,0,38581,38612,267556,
1987,e) 4,218807,235209,2333938,2385018,12850,5.2,35234,14.2,487798,125325,362473,5.3,20.5,589958,263456,326502,11,24.7,-102160,-4.2,41,0,26703,26895,189258,
1987,f) 5,201316,215945,2245071,2288464,9223,4.1,30854,13.6,409787,69732,340055,3,17.9,496572,218056,278516,9.5,21.7,-86785,-3.8,35.8,0,22295,22522,151841,
1987,g) 6 to 10,843542,959986,10899818,11051742,48415,4.9,116658,11.7,1934726,412342,1522384,3.7,17.5,2238575,898731,1339844,8.1,20.3,-303849,-2.8,35,0,74933,76035,537441,
1987,l) Left Censored,1321477,2104804,57163814,57655596,113918,5.3,197209,9.2,7482950,2136343,5346607,3.7,13,8466514,3024864,5441650,5.2,14.7,-983564,-1.7,26,0,90443,92609,798938,
1988,a) 0,489345,496510,3084100,1556438,491710,198.1,0,0,3055325,3055325,0,196.3,196.3,0,0,0,0,0,3055325,196.3,0,0,,,,
1988,b) 1,405873,420833,4076785,4091003,3699,0.8,129060,26.4,1032961,126471,906490,3.1,25.2,1061397,637328,424069,15.6,25.9,-28436,-0.7,50.4,0,102502,102505,484155,
1988,c) 2,337425,351768,2918610,2996081,13474,3.5,74998,19.5,686944,108988,577956,3.6,22.9,841886,436538,405348,14.6,28.1,-154942,-5.2,45.8,0,59945,59945,354757,
1988,d) 3,297386,311413,2846015,2915197,11840,3.6,53608,16.1,592582,106152,486430,3.6,20.3,730945,349594,381351,12,25.1,-138363,-4.8,40.6,0,42363,42363,278894,
1988,e) 4,270940,286163,2665003,2737613,10074,3.3,40959,13.6,504881,82472,422409,3,18.4,650102,274427,375675,10,23.7,-145221,-5.3,36.8,0,31108,31108,200784,
1988,f) 5,196422,213850,2255678,2279588,7901,3.5,28510,12.7,417539,73042,344497,3.2,18.3,465358,184877,280481,8.1,20.4,-47819,-2.1,36.6,0,21352,21352,131714,
1988,g) 6 to 10,813355,890860,9829297,9929333,33760,3.7,98797,10.7,1671068,332910,1338158,3.4,16.8,1871140,688643,1182497,6.9,18.8,-200072,-2,33.6,0,68705,68706,441436,
1988,h) 11 to 15,150145,209586,3133828,3095558,11132,5.2,19224,9,586029,158013,428016,5.1,18.9,509489,163867,345622,5.3,16.5,76540,2.4,33,0,9979,9981,57536,
1988,l) Left Censored,1236728,2040239,56605367,56384480,117500,5.7,167214,8.1,8000673,2280584,5720089,4,14.2,7558899,2515712,5043187,4.5,13.4,441774,0.8,26.8,0,71980,71992,474935,
1989,a) 0,473827,480278,2967358,1490356,477014,198.6,0,0,2954004,2954004,0,198.2,198.2,0,0,0,0,0,2954004,198.2,0,0,,,,
1989,b) 1,378897,388877,3213489,3185401,3356,0.8,106719,24.1,995095,92232,902863,2.9,31.2,938919,543707,395212,17.1,29.5,56176,1.7,59,0,79104,79168,428886,
1989,c) 2,339362,354979,3736039,3853735,13576,3.5,77905,20.1,725951,121521,604430,3.2,18.8,961343,556803,404540,14.4,24.9,-235392,-6.1,37.6,0,58798,58918,444465,
1989,d) 3,292710,307533,2827113,2873249,11463,3.5,55847,16.9,605906,80984,524922,2.8,21.1,698179,344411,353768,12,24.3,-92273,-3.2,42.2,0,41571,41655,258396,
1989,e) 4,263447,279002,2769760,2818379,10162,3.4,43452,14.7,515351,82792,432559,2.9,18.3,612588,281341,331247,10,21.7,-97237,-3.4,36.6,0,31595,31699,203933,
1989,f) 5,244113,259947,2573969,2611577,8911,3.3,35288,12.9,461380,81747,379633,3.1,17.7,536596,238833,297763,9.1,20.5,-75216,-2.8,35.4,0,24639,24748,165999,
1989,g) 6 to 10,791013,873945,10236954,10326752,31626,3.5,105938,11.6,1711260,302468,1408792,2.9,16.6,1890856,786522,1104334,7.6,18.3,-179596,-1.7,33.2,0,67027,67617,471096.5,
1989,h) 11 to 15,272275,349762,4855585,4872108,15331,4.3,34775,9.7,768224,169961,598263,3.5,15.8,801271,290351,510920,6,16.4,-33047,-0.6,31.6,0,18977,19309,134123,
1989,l) Left Censored,1156092,1985865,57235542,56949973,107114,5.3,163362,8.1,7838672,2361819,5476853,4.1,13.8,7267534,2242437,5025097,3.9,12.8,571138,1,25.6,0,70555,72943,607718.5,
1990,a) 0,476960,481534,2901923,1455006,479418,199.1,0,0,2893835,2893835,0,198.9,198.9,0,0,0,0,0,2893835,198.9,0,0,,,,
1990,b) 1,377996,386394,3062130,3004758,3284,0.8,86472,20,941384,94460,846924,3.1,31.3,826639,429996,396643,14.3,27.5,114745,3.8,55,0,68030,68070,352481,
1990,c) 2,323663,335053,2964999,3066768,15762,4.4,63044,17.4,653749,110277,543472,3.6,21.3,857287,427959,429328,14,28,-203538,-6.7,42.6,0,51237,51324,354037,
1990,d) 3,297228,313807,3586607,3648604,15299,4.6,52801,15.8,599535,107815,491720,3,16.4,723529,344875,378654,9.5,19.8,-123994,-3.4,32.8,0,42329,42430,277500,
1990,e) 4,261876,277340,2657630,2728652,12745,4.4,40343,13.8,509150,91292,417858,3.3,18.7,651195,278451,372744,10.2,23.9,-142045,-5.2,37.4,0,31892,31964,215724,
1990,f) 5,239238,255648,2673176,2710765,11451,4.3,33020,12.4,461876,95415,366461,3.5,17,537054,218807,318247,8.1,19.8,-75178,-2.8,34,0,25405,25484,168803,
1990,g) 6 to 10,836167,920277,10748849,10851549,42978,4.5,91371,9.7,1712381,394387,1317994,3.6,15.8,1917780,701496,1216284,6.5,17.7,-205399,-1.9,31.6,0,66215,66641,479817,
1990,h) 11 to 15,394647,491601,6673897,6677458,24539,4.9,40497,8.1,1030220,252061,778159,3.8,15.4,1037342,332591,704751,5,15.5,-7122,-0.1,30.8,0,25654,25983,188399,
1990,l) Left Censored,1101987,1946520,57284188,57274772,98553,5,135416,6.9,6842805,1818377,5024428,3.2,11.9,6823973,1856852,4967121,3.2,11.9,18832,0,23.8,0,60212,61389,484938,
1991,a) 0,468905,475806,2718314,1367892,471908,198.4,0,0,2700845,2700845,0,197.4,197.4,0,0,0,0,0,2700845,197.4,0,0,,,,
1991,b) 1,383449,391854,2893858,2891759,4537,1,87341,20,877355,117890,759465,4.1,30.3,873156,423454,449702,14.6,30.2,4199,0.1,60.4,0,61400,61455,319889,
1991,c) 2,323948,334263,2637632,2828894,11706,3.3,61634,17.1,536508,82356,454152,2.9,19,919031,432974,486057,15.3,32.5,-382523,-13.5,38,0,46255,46475,350045,
1991,d) 3,282273,295796,2679617,2824648,11417,3.6,49866,15.8,468673,88182,380491,3.1,16.6,758735,330048,428687,11.7,26.9,-290062,-10.3,33.2,0,37728,37830,266414,
1991,e) 4,262328,280201,3275599,3428086,10995,3.7,44838,15.1,440313,91743,348570,2.7,12.8,745287,340976,404311,9.9,21.7,-304974,-8.9,25.6,0,32870,33450,264894,
1991,f) 5,234040,251053,2420565,2540114,9436,3.6,35867,13.6,391086,84285,306801,3.3,15.4,630183,261413,368770,10.3,24.8,-239097,-9.4,30.8,0,26355,26520,200476,
1991,g) 6 to 10,867052,960143,10856140,11249403,37229,3.8,103641,10.4,1560549,375560,1184989,3.3,13.9,2347076,800480,1546596,7.1,20.9,-786527,-7,27.8,0,71212,72008,529414,
1991,h) 11 to 15,497328,615183,8055702,8234878,28224,4.5,54985,8.8,1122088,315585,806503,3.8,13.6,1480439,440503,1039936,5.3,18,-358351,-4.4,27.2,0,32720,33512,241899,
1991,l) Left Censored,1043269,1912603,55867452,56590365,107405,5.6,145179,7.5,6512316,2140843,4371473,3.8,11.5,7958144,2131488,5826656,3.8,14.1,-1445828,-2.6,23,0,58336,60831,565937,
1992,a) 0,463156,472629,2821437,1416701,471248,199.4,0,0,2809472,2809472,0,198.3,198.3,0,0,0,0,0,2809472,198.3,0,0,,,,
1992,b) 1,359703,370703,2676467,2666863,5105,1.2,98146,23.2,857446,114463,742983,4.3,32.2,838238,471772,366466,17.7,31.4,19208,0.8,62.8,0,76905,76946,387526,
1992,c) 2,320287,331070,2504066,2642443,14872,4.1,67431,18.7,566099,90533,475566,3.4,21.4,842854,454285,388569,17.2,31.9,-276755,-10.5,42.8,0,53819,53938,361964,
1992,d) 3,278877,291474,2433551,2506595,12829,4.1,50157,16.1,506182,85419,420763,3.4,20.2,652271,317071,335200,12.6,26,-146089,-5.8,40.4,0,39575,39806,257666,
1992,e) 4,247625,262693,2465956,2533437,11298,4.1,40405,14.5,475658,87728,387930,3.5,18.8,610619,279539,331080,11,24.1,-134961,-5.3,37.6,0,30818,30987,213933,
1992,f) 5,234291,253055,3151262,3187589,10894,4.1,35355,13.3,557805,100624,457181,3.2,17.5,630461,243912,386549,7.7,19.8,-72656,-2.3,35,0,25601,26083,180433,
1992,g) 6 to 10,881021,977259,10720970,10894795,41017,4.1,105539,10.4,1720790,338314,1382476,3.1,15.8,2068440,759972,1308468,7,19,-347650,-3.2,31.6,0,72080,73502,512159,
1992,h) 11 to 15,601737,747012,10059542,10181757,33640,4.4,66448,8.7,1501589,345164,1156425,3.4,14.7,1746020,565316,1180704,5.6,17.1,-244431,-2.4,29.4,0,38342,39747,314029,
1992,l) Left Censored,990451,1865050,54852068,55418842,92495,4.9,149265,7.9,6491436,1764766,4726670,3.2,11.7,7624985,2153378,5471607,3.9,13.8,-1133549,-2.1,23.4,0,53351,57351,458468,
1993,a) 0,474578,476795,2642395,1328506,472940,198.4,0,0,2627778,2627778,0,197.8,197.8,0,0,0,0,0,2627778,197.8,0,0,,,,
1993,b) 1,356024,366427,2916408,2866276,1833,0.4,98879,23.6,918902,114595,804307,4,32.1,818638,432719,385919,15.1,28.6,100264,3.5,57.2,0,79802,79832,363624,
1993,c) 2,307602,319398,2454760,2551361,11120,3.2,59642,17.3,559308,68075,491233,2.7,21.9,752510,381963,370547,15,29.5,-193202,-7.6,43.8,0,48332,48445,313899,
1993,d) 3,282170,292816,2397291,2437961,10601,3.4,46723,15,503144,61719,441425,2.5,20.6,584483,265779,318704,10.9,24,-81339,-3.4,41.2,0,37518,37594,216154,
1993,e) 4,250073,262981,2334845,2374730,9227,3.3,36736,13.3,438016,62454,375562,2.6,18.4,517787,222015,295772,9.3,21.8,-79771,-3.4,36.8,0,29116,29189,178957,
1993,f) 5,224670,239201,2374895,2411180,8204,3.3,30826,12.3,407711,66237,341474,2.7,16.9,480280,197634,282646,8.2,19.9,-72569,-3,33.8,0,23698,23819,151084,
1993,g) 6 to 10,912819,1008141,11703037,11834020,33019,3.2,98437,9.5,1700401,263749,1436652,2.2,14.4,1962366,661844,1300522,5.6,16.6,-261965,-2.2,28.8,0,70828,71471,447242,
1993,h) 11 to 15,585951,682241,8731906,8787592,20731,3,53689,7.7,1206902,198109,1008793,2.3,13.7,1318274,392593,925681,4.5,15,-111372,-1.3,27.4,0,35445,36091,231502,
1993,i) 16 to 20,113461,180163,3164600,3151075,6516,3.6,12747,7,452242,103088,349154,3.3,14.4,425192,118304,306888,3.8,13.5,27050,0.9,27,0,5946,6245,36653,
1993,l) Left Censored,941687,1797402,54529266,54699460,71277,3.9,136855,7.5,6494500,1537599,4956901,2.8,11.9,6834887,2000636,4834251,3.7,12.5,-340387,-0.6,23.8,0,47473,49358,357604,
1994,a) 0,496805,500917,2921950,1466272,497357,198.6,0,0,2911356,2911356,0,198.6,198.6,0,0,0,0,0,2911356,198.6,0,0,,,,
1994,b) 1,366601,370573,2669044,2655633,1913,0.5,98867,23.3,798243,52524,745719,2,30.1,771421,447412,324009,16.8,29,26822,1.1,58,0,79390,79403,374989,
1994,c) 2,301353,312309,2606664,2749335,10024,3,60909,18,550744,66869,483875,2.4,20,836086,408518,427568,14.9,30.4,-285342,-10.4,40,0,48888,48923,334681,
1994,d) 3,269683,281555,2296230,2366338,9367,3.1,45171,15,456527,56616,399911,2.4,19.3,596744,283865,312879,12,25.2,-140217,-5.9,38.6,0,35616,35652,226836,
1994,e) 4,252211,263211,2267090,2326497,9020,3.2,37503,13.5,421601,54879,366722,2.4,18.1,540414,240061,300353,10.3,23.2,-118813,-5.1,36.2,0,29135,29252,187672,
1994,f) 5,225807,239347,2228386,2273843,8371,3.3,31194,12.4,390211,60137,330074,2.6,17.2,481124,192043,289081,8.4,21.2,-90913,-4,34.4,0,24252,24314,145480,
1994,g) 6 to 10,931270,1023436,11920102,12034381,34691,3.3,103084,9.7,1732887,291167,1441720,2.4,14.4,1961446,719494,1241952,6,16.3,-228559,-1.9,28.8,0,74188,74644,493318,
1994,h) 11 to 15,577576,673694,8918087,8955253,21667,3.1,54234,7.9,1199712,231091,968621,2.6,13.4,1274045,400565,873480,4.5,14.2,-74333,-0.8,26.8,0,35231,35618,231258,
1994,i) 16 to 20,207618,294451,4733363,4718666,11483,3.8,21575,7.2,629718,136140,493578,2.9,13.3,600323,173191,427132,3.7,12.7,29395,0.6,25.4,0,11388,11664,76599,
1994,l) Left Censored,894287,1762607,54384197,54474019,83635,4.7,119858,6.7,6223224,1721460,4501764,3.2,11.4,6402868,1817812,4585056,3.3,11.8,-179644,-0.4,22.8,0,44684,45955,336509,
1995,a) 0,512619,516618,2971419,1492033,512939,198.6,0,0,2958773,2958773,0,198.3,198.3,0,0,0,0,0,2958773,198.3,0,0,,,,
1995,b) 1,382899,389284,2922737,2902914,2308,0.5,103727,23.3,858531,68256,790275,2.4,29.6,818884,462999,355885,15.9,28.2,39647,1.4,56.4,0,83741,83775,390358,
1995,c) 2,311155,316325,2549548,2586602,10555,3.1,61010,17.8,603861,75616,528245,2.9,23.3,677970,369390,308580,14.3,26.2,-74109,-2.9,46.6,0,50071,50105,316030,
1995,d) 3,264660,276114,2437707,2478310,9860,3.4,43873,14.9,480415,70642,409773,2.9,19.4,561621,271497,290124,11,22.7,-81206,-3.3,38.8,0,34832,34949,212386,
1995,e) 4,241970,254372,2257126,2276571,9008,3.4,34879,13,429853,59946,369907,2.6,18.9,468743,210512,258231,9.2,20.6,-38890,-1.7,37.8,0,27014,27123,159741,
1995,f) 5,228800,239726,2232141,2241896,8617,3.4,30524,12.2,408095,63498,344597,2.8,18.2,427605,183507,244098,8.2,19.1,-19510,-0.9,36.4,0,23518,23615,138882,
1995,g) 6 to 10,913579,1001846,11979031,11984963,35467,3.4,101558,9.8,1817736,351491,1466245,2.9,15.2,1829601,690337,1139264,5.8,15.3,-11865,-0.1,30.4,0,73427,74040,475575,
1995,h) 11 to 15,608380,706779,9507611,9454032,24090,3.3,54365,7.5,1356339,282867,1073472,3,14.3,1249181,409286,839895,4.3,13.2,107158,1.1,26.4,0,35427,35740,229860,
1995,i) 16 to 20,297955,405712,6602047,6536406,14689,3.6,29047,7,927137,212546,714591,3.3,14.2,795855,233397,562458,3.6,12.2,131282,2,24.4,0,16598,16979,106948,
1995,l) Left Censored,851834,1729833,55026099,54703216,84471,4.8,116092,6.6,6385969,1757936,4628033,3.2,11.7,5740203,1606214,4133989,2.9,10.5,645766,1.2,21,0,41436,42696,300287,
1996,a) 0,514590,518910,2989369,1503496,514467,198.3,0,0,2971747,2971747,0,197.7,197.7,0,0,0,0,0,2971747,197.7,0,0,,,,
1996,b) 1,395788,402793,2944413,2938972,3250,0.7,107947,23.5,868486,79959,788527,2.7,29.6,857606,475472,382134,16.2,29.2,10880,0.4,58.4,0,86443,86446,394948,
1996,c) 2,325393,332847,2692486,2783104,10905,3,64352,17.8,574283,76326,497957,2.7,20.6,755519,387365,368154,13.9,27.1,-181236,-6.5,41.2,0,52454,52455,329886,
1996,d) 3,272976,279359,2411746,2470278,9839,3.3,45447,15.3,483477,69140,414337,2.8,19.6,600541,295830,304711,12,24.3,-117064,-4.7,39.2,0,36939,36941,252330,
1996,e) 4,236916,248712,2310738,2366463,8570,3.3,35346,13.5,410534,77741,332793,3.3,17.3,521984,217505,304479,9.2,22.1,-111450,-4.8,34.6,0,27700,27703,171951,
1996,f) 5,219948,233010,2181768,2217553,8301,3.4,29446,12.1,373579,63043,310536,2.8,16.8,445149,184246,260903,8.3,20.1,-71570,-3.3,33.6,0,22724,22729,141904,
1996,g) 6 to 10,907152,989243,11658057,11807257,33866,3.3,103850,10.1,1666116,326337,1339779,2.8,14.1,1964516,720604,1243912,6.1,16.6,-298400,-2.5,28.2,0,75051,75063,489877,
1996,h) 11 to 15,633189,735937,10205137,10272044,23365,3.1,59027,7.8,1347567,274079,1073488,2.7,13.1,1481382,472264,1009118,4.6,14.4,-133815,-1.3,26.2,0,38154,38163,256913,
1996,i) 16 to 20,376961,502733,8066592,8087988,17315,3.4,37245,7.3,1033666,253550,780116,3.1,12.8,1076459,348292,728167,4.3,13.3,-42793,-0.5,25.6,0,21053,21067,130645,
1996,l) Left Censored,807565,1687597,54884245,55014022,81838,4.8,120890,7.1,6313047,1871249,4441798,3.4,11.5,6572601,1927130,4645471,3.5,11.9,-259554,-0.4,23,0,40073,40112,289208,
1997,a) 0,519877,527805,3050956,1531928,523720,198.5,0,0,3038056,3038056,0,198.3,198.3,0,0,0,0,0,3038056,198.3,0,0,,,,
1997,b) 1,394262,402478,2970147,2963709,4061,0.9,110631,24,911773,110747,801026,3.7,30.8,898896,523036,375860,17.6,30.3,12877,0.5,60.6,0,88264,88264,430622,
1997,c) 2,333885,343455,2677431,2765028,12518,3.4,68022,18.3,622809,87918,534891,3.2,22.5,798003,430836,367167,15.6,28.9,-175194,-6.4,45,0,54746,54746,361575,
1997,d) 3,283401,292653,2535492,2588741,10589,3.4,48936,15.7,530242,85517,444725,3.3,20.5,636740,322425,314315,12.5,24.6,-106498,-4.1,41,0,38984,38985,258776,
1997,e) 4,242255,251314,2255770,2315949,9497,3.6,36585,13.8,432145,74455,357690,3.2,18.7,552503,254303,298200,11,23.9,-120358,-5.2,37.4,0,29121,29122,202174,
1997,f) 5,212998,225977,2269659,2286966,8277,3.5,30218,12.7,425075,69937,355138,3.1,18.6,459690,200821,258869,8.8,20.1,-34615,-1.5,37.2,0,22886,22886,151745,
1997,g) 6 to 10,891311,973426,11366306,11460074,38977,3.9,107334,10.6,1881752,393727,1488025,3.4,16.4,2069288,793754,1275534,6.9,18.1,-187536,-1.7,32.8,0,75613,75613,500832,
1997,h) 11 to 15,644075,749770,10264051,10286974,30914,4,65819,8.6,1580096,380083,1200013,3.7,15.4,1625943,586315,1039628,5.7,15.8,-45847,-0.4,30.8,0,40160,40162,289782,
1997,i) 16 to 20,460111,612316,10264447,10232403,29544,4.7,51115,8.2,1552542,450815,1101727,4.4,15.2,1488454,453296,1035158,4.4,14.5,64088,0.7,29,0,25233,25233,175876,
1997,l) Left Censored,770092,1662353,55530480,55391331,105799,6.3,144023,8.6,7542396,2184422,5357974,3.9,13.6,7264098,2427598,4836500,4.4,13.1,278298,0.5,26.2,0,37671,37673,312987,
1998,a) 0,514869,519749,3431242,1722132,515962,198.5,0,0,3418220,3418220,0,198.5,198.5,0,0,0,0,0,3418220,198.5,0,0,,,,
1998,b) 1,396855,405503,3050802,3038991,1492,0.3,114860,24.6,895766,58839,836927,1.9,29.5,872144,511571,360573,16.8,28.7,23622,0.8,57.4,0,91604,91604,419287,
1998,c) 2,332925,341682,2757275,2843115,10590,2.8,68718,18.5,611557,82806,528751,2.9,21.5,783236,417282,365954,14.7,27.5,-171679,-6,43,0,55551,55551,347012,
1998,d) 3,291380,301171,2516781,2580968,10201,3.2,50551,15.7,500146,68436,431710,2.7,19.4,628521,304200,324321,11.8,24.4,-128375,-5,38.8,0,40051,40051,246030,
1998,e) 4,251902,261046,2402331,2454404,8139,2.9,38586,13.9,449088,59773,389315,2.4,18.3,553233,246584,306649,10,22.5,-104145,-4.2,36.6,0,30461,30461,197519,
1998,f) 5,218088,227753,2162661,2203941,7157,3,30392,12.7,393012,58171,334841,2.6,17.8,475572,210207,265365,9.5,21.6,-82560,-3.8,35.6,0,23818,23818,161222,
1998,g) 6 to 10,870434,942249,10573146,10679388,29539,3,101667,10.4,1691502,285007,1406495,2.7,15.8,1903986,746695,1157291,7,17.8,-212484,-2,31.6,0,74202,74202,500027,
1998,h) 11 to 15,660202,768793,11134597,11162042,24981,3.2,63633,8.1,1513608,316890,1196718,2.8,13.6,1568499,539769,1028730,4.8,14.1,-54891,-0.5,27.2,0,41353,41353,282765,
1998,i) 16 to 20,443104,542973,8670255,8675029,15123,2.7,40739,7.3,1148328,220844,927484,2.5,13.2,1157877,371516,786361,4.3,13.3,-9549,-0.1,26.4,0,24753,24773,181040,
1998,j) 21 to 25,87136,164229,3687560,3652205,7713,4.6,11972,7.2,551001,149540,401461,4.1,15.1,480291,157461,322830,4.3,13.2,70710,1.9,26.4,0,4467,4467,30275,
1998,l) Left Censored,729339,1633176,55886248,55672827,95187,5.8,122685,7.4,6854752,1931028,4923724,3.5,12.3,6427910,2017885,4410025,3.6,11.5,426842,0.8,23,0,35649,35649,297509,
1999,a) 0,496663,501336,3210735,1612226,497482,198.5,0,0,3197018,3197018,0,198.3,198.3,0,0,0,0,0,3197018,198.3,0,0,,,,
1999,b) 1,399747,412276,3459424,3431573,7621,1.6,107588,23.1,1025466,219011,806455,6.4,29.9,969763,504564,465199,14.7,28.3,55703,1.6,56.6,0,83883,83883,407585,
1999,c) 2,335534,344567,2826515,2908328,10138,2.7,69313,18.5,639689,76558,563131,2.6,22,803314,456095,347219,15.7,27.6,-163625,-5.6,44,0,54269,54269,354931,
1999,d) 3,290077,298404,2580262,2646237,9297,2.9,51422,16.1,489120,63620,425500,2.4,18.5,621069,317531,303538,12,23.5,-131949,-5,37,0,39948,39948,244598,
1999,e) 4,259156,269609,2436588,2472578,9040,3.2,40252,14.1,461040,69811,391229,2.8,18.6,533021,253377,279644,10.2,21.6,-71981,-3,37.2,0,30753,30753,196588,
1999,f) 5,226708,236369,2324535,2356119,7810,3.1,32068,12.9,424900,75828,349072,3.2,18,488069,224186,263883,9.5,20.7,-63169,-2.7,36,0,24505,24505,165261,
1999,g) 6 to 10,861723,928607,10176796,10314062,28152,2.9,101585,10.5,1587618,268618,1319000,2.6,15.4,1862149,763519,1098630,7.4,18.1,-274531,-2.7,30.8,0,73797,73797,505859,
1999,h) 11 to 15,669382,778930,11586074,11635640,25823,3.2,65623,8.2,1563688,339860,1223828,2.9,13.4,1662819,581791,1081028,5,14.3,-99131,-0.9,26.8,0,42504,42504,299946,
1999,i) 16 to 20,435081,535346,8906728,8913418,16116,2.9,40331,7.4,1169687,284611,885076,3.2,13.1,1183068,388610,794458,4.4,13.3,-13381,-0.2,26.2,0,24385,24385,171824,
1999,j) 21 to 25,157954,257040,5286965,5290998,10441,4,18629,7.1,709159,191452,517707,3.6,13.4,717224,228837,488387,4.3,13.6,-8065,-0.2,26.8,0,8364,8364,56420,
1999,l) Left Censored,692469,1611263,56269157,56262194,93529,5.8,116369,7.2,6839606,2026895,4812711,3.6,12.2,6825680,2181277,4644403,3.9,12.1,13926,0.1,24.2,0,33677,33677,279860,
2000,a) 0,481816,486681,3096717,1554953,482747,198.4,0,0,3083528,3083528,0,198.3,198.3,0,0,0,0,0,3083528,198.3,0,0,,,,
2000,b) 1,384739,394492,3372166,3288250,5175,1.2,106950,23.9,1054384,159650,894734,4.9,32.1,886551,484812,401739,14.7,27,167833,5.1,54,0,79728,79728,378727,
2000,c) 2,340381,358170,3432511,3416630,15824,4.1,67926,17.7,865005,219800,645205,6.4,25.3,833244,393493,439751,11.5,24.4,31761,0.9,48.8,0,51591,51591,312374,
2000,d) 3,292987,302537,2738696,2770692,10007,3.1,52042,16.1,559298,81073,478225,2.9,20.2,623290,328043,295247,11.8,22.5,-63992,-2.3,40.4,0,38908,38908,251326,
2000,e) 4,257944,266223,2526011,2545791,8001,2.8,40413,14.3,469125,56422,412703,2.2,18.4,508686,247176,261510,9.7,20,-39561,-1.6,36.8,0,29730,29730,181178,
2000,f) 5,232943,243448,2405870,2418453,7725,3,34106,13.3,451787,52384,399403,2.2,18.7,476953,219576,257377,9.1,19.7,-25166,-1,37.4,0,24560,24560,156086,
2000,g) 6 to 10,860163,920508,10359362,10410499,26174,2.7,104274,10.9,1711465,279353,1432112,2.7,16.4,1813741,766601,1047140,7.4,17.4,-102276,-1,32.8,0,72663,72663,504970,
2000,h) 11 to 15,645096,748875,11552561,11548035,24899,3.2,66851,8.7,1633759,365770,1267989,3.2,14.1,1624708,597463,1027245,5.2,14.1,9051,0,28.2,0,41675,41675,287165,
2000,i) 16 to 20,458836,562679,9179738,9194061,16157,2.8,43005,7.5,1214957,275781,939176,3,13.2,1243604,460620,782984,5,13.5,-28647,-0.3,26.4,0,24516,24516,181730,
2000,j) 21 to 25,225599,348228,7223069,7166389,13848,3.9,25215,7.1,1003438,291795,711643,4.1,14,890077,277442,612635,3.9,12.4,113361,1.6,24.8,0,11854,11854,76778,
2000,l) Left Censored,656091,1586943,56720343,56513782,95739,6,121891,7.6,7232534,2194929,5037605,3.9,12.8,6819413,2290890,4528523,4.1,12.1,413121,0.7,24.2,0,30909,30922,262903,
2001,a) 0,471211,476920,2966029,1494379,472819,198.3,0,0,2943300,2943300,0,197,197,0,0,0,0,0,2943300,197,0,0,,,,
2001,b) 1,374542,383364,3131765,3113190,4414,1,107765,24.8,942564,140964,801600,4.5,30.3,905414,484823,420591,15.6,29.1,37150,1.2,58.2,0,76037,76126,366448,
2001,c) 2,327127,340183,3177686,3262607,13398,3.7,69261,18.9,726285,155490,570795,4.8,22.3,896128,435128,461000,13.3,27.5,-169843,-5.2,44.6,0,50195,50198,328015,
2001,d) 3,298402,321175,3296861,3352506,15730,4.6,53575,15.8,681826,206107,475719,6.1,20.3,793116,339532,453584,10.1,23.7,-111290,-3.4,40.6,0,38661,38661,255297,
2001,e) 4,260500,270496,2550756,2647930,8718,3,43252,15.1,440234,62590,377644,2.4,16.6,634584,283586,350998,10.7,24,-194350,-7.4,33.2,0,30494,30501,192952,
2001,f) 5,231767,240460,2426302,2493680,7589,3,35639,14.1,407251,60159,347092,2.4,16.3,542008,235275,306733,9.4,21.7,-134757,-5.4,32.6,0,25059,25060,161007,
2001,g) 6 to 10,863051,921663,10256641,10505669,27944,2.9,112157,11.7,1518691,308860,1209831,2.9,14.5,2016747,805861,1210886,7.7,19.2,-498056,-4.7,29,0,73363,73365,500385,
2001,h) 11 to 15,634854,729164,10935978,11113350,22814,3,70504,9.4,1384367,311608,1072759,2.8,12.5,1739113,603817,1135296,5.4,15.6,-354746,-3.1,25,0,41804,41805,284413,
2001,i) 16 to 20,475569,588575,9934796,10033895,21246,3.5,47553,7.9,1251847,316531,935316,3.2,12.5,1450045,474997,975048,4.7,14.5,-198198,-2,25,0,24801,24861,174671,
2001,j) 21 to 25,285459,426121,8541329,8590096,17290,4,32174,7.4,1067695,307969,759726,3.6,12.4,1165229,375695,789534,4.4,13.6,-97534,-1.2,24.8,0,14805,14876,93052,
2001,l) Left Censored,659119,1610409,56791855,56963679,109773,6.8,114546,7.1,6925146,2196180,4728966,3.9,12.2,7268794,2083453,5185341,3.7,12.8,-343648,-0.6,24.4,0,28383,28505,239602,
2002,a) 0,496138,503778,3297275,1654349,503774,200,0,0,3285852,3285852,0,198.6,198.6,0,0,0,0,0,3285852,198.6,0,0,,,,
2002,b) 1,368030,375751,2738352,2814903,3025,0.7,111931,26,736306,54601,681705,1.9,26.2,889407,477031,412376,16.9,31.6,-153101,-5.4,52.4,0,77942,78022,365726,
2002,c) 2,319999,330345,2724525,2850993,15798,4.4,69156,19.4,586644,121596,465048,4.3,20.6,839580,393967,445613,13.8,29.4,-252936,-8.8,41.2,0,49349,49474,314187,
2002,d) 3,287290,302002,2783023,2892844,16090,5,52192,16.3,545385,131927,413458,4.6,18.9,765028,322322,442706,11.1,26.4,-219643,-7.5,37.8,0,36934,37017,250347,
2002,e) 4,263886,290339,2909481,2980794,16735,5.5,42612,14.1,564126,162121,402005,5.4,18.9,706751,253046,453705,8.5,23.7,-142625,-4.8,37.8,0,29766,29787,191924,
2002,f) 5,234233,243751,2312627,2408969,10948,4.3,36574,14.3,397290,80579,316711,3.3,16.5,589976,239573,350403,9.9,24.5,-192686,-8,33,0,24418,24478,167892,
2002,g) 6 to 10,874913,925858,9942050,10331765,41096,4.3,115970,12,1542353,351016,1191337,3.4,14.9,2321784,897206,1424578,8.7,22.5,-779431,-7.6,29.8,0,72494,72602,499975,
2002,h) 11 to 15,626335,714259,10206474,10462134,31980,4.4,72668,9.9,1434623,357177,1077446,3.4,13.7,1945943,691680,1254263,6.6,18.6,-511320,-4.9,27.4,0,39771,39865,298157,
2002,i) 16 to 20,485656,597632,9651229,9896297,26782,4.4,55663,9.1,1315948,388485,927463,3.9,13.3,1806084,609866,1196218,6.2,18.3,-490136,-5,26.6,0,24895,25122,189770,
2002,j) 21 to 25,348478,508716,10077415,10296377,26168,5,47368,9.1,1360086,426632,933454,4.1,13.2,1798009,615384,1182625,6,17.5,-437923,-4.3,26.4,0,17234,17387,135665,
2002,l) Left Censored,603782,1560290,55184965,56108605,112922,7.2,147522,9.4,7242475,2628406,4614069,4.7,12.9,9089754,2895195,6194559,5.2,16.2,-1847279,-3.3,25.8,0,25748,26085,276540,
2003,a) 0,500847,504417,3130999,1565500,504417,200,0,0,3130999,3130999,0,200,200,0,0,0,0,0,3130999,200,0,0,,,,
2003,b) 1,376240,384909,3022431,3135354,1549,0.3,109833,24.7,750036,27847,722189,0.9,23.9,975882,592485,383397,18.9,31.1,-225846,-7.2,47.8,0,85197,85256,501220,
2003,c) 2,316781,325896,2628253,2667486,16417,4.7,59585,17,576632,79157,497475,3,21.6,655099,329676,325423,12.4,24.6,-78467,-3,43.2,0,47067,47071,276175,
2003,d) 3,282181,293431,2597340,2641343,14100,4.5,46149,14.8,525054,77375,447679,2.9,19.9,613059,265579,347480,10.1,23.2,-88005,-3.3,39.8,0,35970,35987,219174,
2003,e) 4,257989,273703,2697292,2733972,13013,4.5,37300,13,502446,76691,425755,2.8,18.4,575805,251184,324621,9.2,21.1,-73359,-2.7,36.8,0,28599,28647,202928,
2003,f) 5,239564,267789,2825677,2856022,12642,4.5,31610,11.3,504930,102756,402174,3.6,17.7,565622,206248,359374,7.2,19.8,-60692,-2.1,35.4,0,23977,23982,165120,
2003,g) 6 to 10,895085,940253,10087909,10205302,40268,4.1,99230,10.2,1681660,309461,1372199,3,16.5,1916446,655034,1261412,6.4,18.8,-234786,-2.3,33,0,73949,74035,499246,
2003,h) 11 to 15,613831,691888,9209279,9243096,27021,3.8,56284,7.9,1376977,255190,1121787,2.8,14.9,1444612,457068,987544,4.9,15.6,-67635,-0.7,29.8,0,38734,38842,281296,
2003,i) 16 to 20,499208,611878,10398517,10401252,22883,3.7,40002,6.4,1321298,291805,1029493,2.8,12.7,1326768,369346,957422,3.6,12.8,-5470,-0.1,25.4,0,25947,26442,200308,
2003,j) 21 to 25,338754,441107,8119321,8102688,15152,3.4,26286,5.9,1028053,253939,774114,3.1,12.7,994787,241278,753509,3,12.3,33266,0.4,24.6,0,16796,16973,125426,
2003,k) 26+,65894,145658,3618875,3621690,7451,5.1,7498,5.1,478063,110902,367161,3.1,13.2,483693,101744,381949,2.8,13.4,-5630,-0.2,26.4,0,2860,2989,21292,
2003,l) Left Censored,576707,1534091,54073219,54190853,94401,6.2,84166,5.5,6263529,1966799,4296730,3.6,11.6,6498797,1642609,4856188,3,12,-235268,-0.4,23.2,0,23984,24908,238191,
2004,a) 0,521642,524385,3129108,1569248,522001,199.1,0,0,3119721,3119721,0,198.8,198.8,0,0,0,0,0,3119721,198.8,0,0,,,,
2004,b) 1,379896,384587,2920177,3008187,1151,0.3,110323,24.8,770551,18306,752245,0.6,25.6,946571,553152,393419,18.4,31.5,-176020,-5.9,51.2,0,86321,86331,474071,
2004,c) 2,323438,332665,2881728,2937692,12845,3.6,61323,17.1,577701,69540,508161,2.4,19.7,689631,352753,336878,12,23.5,-111930,-3.8,39.4,0,48582,48600,299085,
2004,d) 3,280582,290636,2517736,2560117,11777,3.8,44619,14.5,475745,58598,417147,2.3,18.6,560506,272935,287571,10.7,21.9,-84761,-3.3,37.2,0,34742,34776,232270,
2004,e) 4,253828,265192,2520757,2545826,10704,3.8,36382,13,444511,61468,383043,2.4,17.5,494648,214229,280419,8.4,19.4,-50137,-1.9,35,0,27772,27808,166096,
2004,f) 5,234081,249689,2599898,2632416,9660,3.7,31243,12,422763,59301,363462,2.3,16.1,487799,212360,275439,8.1,18.5,-65036,-2.4,32.2,0,23576,23649,167667,
2004,g) 6 to 10,917022,982101,10863050,10959716,37891,3.7,100700,9.9,1646911,262158,1384753,2.4,15,1840244,669099,1171145,6.1,16.8,-193333,-1.8,30,0,74731,74921,510265,
2004,h) 11 to 15,611395,680690,8781562,8835015,23070,3.3,55973,8,1221699,225405,996294,2.6,13.8,1328606,451051,877555,5.1,15,-106907,-1.2,27.6,0,38661,38754,279262,
2004,i) 16 to 20,508018,620343,10573435,10664669,20870,3.3,40637,6.4,1223009,260460,962549,2.4,11.5,1405477,427975,977502,4,13.2,-182468,-1.7,23,0,26298,26624,185309,
2004,j) 21 to 25,335750,439989,8237098,8256934,15403,3.5,26525,5.9,942919,210493,732426,2.5,11.4,982590,278711,703879,3.4,11.9,-39671,-0.5,22.8,0,16141,16342,118741,
2004,k) 26+,121304,222214,5101995,5096476,8370,3.7,10971,4.9,601309,170145,431164,3.3,11.8,590271,142373,447898,2.8,11.6,11038,0.2,23.2,0,5644,5760,55017,
2004,l) Left Censored,552529,1504923,53581086,53532882,86347,5.7,94770,6.3,6188336,1755368,4432968,3.3,11.6,6091928,1770768,4321160,3.3,11.4,96408,0.2,22.8,0,22244,22660,222634,
2005,a) 0,544352,550733,3381664,1698405,547220,198.7,0,0,3366518,3366518,0,198.2,198.2,0,0,0,0,0,3366518,198.2,0,0,,,,
2005,b) 1,397912,401902,2897187,2977210,1422,0.3,112278,24.2,769228,18211,751017,0.6,25.8,929274,537287,391987,18,31.2,-160046,-5.4,51.6,0,88372,88380,459019,
2005,c) 2,326754,332284,2666673,2756932,13335,3.7,62140,17.3,551027,64637,486390,2.3,20,731546,379313,352233,13.8,26.5,-180519,-6.5,40,0,50524,50571,332396,
2005,d) 3,287382,297200,2693212,2772246,11465,3.6,44966,14.3,459169,59238,399931,2.1,16.6,617238,282156,335082,10.2,22.3,-158069,-5.7,33.2,0,36083,36096,240234,
2005,e) 4,253717,264449,2404820,2442750,10834,3.9,35077,12.6,424774,57337,367437,2.3,17.4,500634,208528,292106,8.5,20.5,-75860,-3.1,34.8,0,27528,27582,175386,
2005,f) 5,231605,243258,2400131,2449792,9591,3.8,29762,11.7,378600,56026,322574,2.3,15.5,477922,190667,287255,7.8,19.5,-99322,-4,31,0,22853,22916,156930,
2005,g) 6 to 10,927919,1002695,11082022,11266021,39610,3.8,101244,9.8,1659996,322790,1337206,2.9,14.7,2027993,726680,1301313,6.5,18,-367997,-3.3,29.4,0,76296,76489,575878,
2005,h) 11 to 15,615338,677966,8625661,8707453,24411,3.5,54630,7.9,1191306,244913,946393,2.8,13.7,1354889,402068,952821,4.6,15.6,-163583,-1.9,27.4,0,39776,39862,286134,
2005,i) 16 to 20,488444,595855,10117695,10196370,21254,3.5,40638,6.7,1145522,265363,880159,2.6,11.2,1302872,376301,926571,3.7,12.8,-157350,-1.6,22.4,0,26898,27150,215188,
2005,j) 21 to 25,361210,472045,8435444,8493564,15370,3.2,26164,5.5,922216,205421,716795,2.4,10.9,1038456,277635,760821,3.3,12.2,-116240,-1.3,21.8,0,17051,17199,166608,
2005,k) 26+,175005,304516,6892436,6845890,13132,4.3,15907,5.2,876675,277248,599427,4,12.8,783582,174215,609367,2.5,11.4,93093,1.4,22.8,0,8384,8545,67526,
2005,l) Left Censored,529785,1490240,53543137,53470872,93606,6.3,85404,5.7,5952478,1973756,3978722,3.7,11.1,5807948,1535797,4272151,2.9,10.9,144530,0.2,21.8,0,22065,22484,274321,
2006,a) 0,557843,569766,3529563,1773138,564888,198.3,0,0,3512851,3512851,0,198.1,198.1,0,0,0,0,0,3512851,198.1,0,0,,,,
2006,b) 1,409239,417843,3214005,3270352,2447,0.5,121938,25.2,848090,34523,813567,1.1,25.9,960785,567536,393249,17.4,29.4,-112695,-3.5,51.8,0,95514,95553,479417,
2006,c) 2,337546,342861,2733726,2783546,12761,3.4,68039,18.3,576802,68437,508365,2.5,20.7,676443,364457,311986,13.1,24.3,-99641,-3.6,41.4,0,53802,53838,310261,
2006,d) 3,284301,291025,2573465,2601272,10698,3.4,49737,16,507974,58428,449546,2.2,19.5,563587,280874,282713,10.8,21.7,-55613,-2.2,39,0,38899,38923,235268,
2006,e) 4,255626,266579,2645729,2662197,9845,3.5,38565,13.7,460767,64453,396314,2.4,17.3,493702,229781,263921,8.6,18.5,-32935,-1.2,34.6,0,29555,29594,187050,
2006,f) 5,228334,239763,2340581,2346751,8715,3.5,31702,12.6,402643,51741,350902,2.2,17.2,414983,183853,231130,7.8,17.7,-12340,-0.5,34.4,0,23870,23945,151198,
2006,g) 6 to 10,919733,1001066,11411238,11453575,37286,3.6,109931,10.6,1752564,297041,1455523,2.6,15.3,1837238,740952,1096286,6.5,16,-84674,-0.7,30.6,0,79206,79340,567286,
2006,h) 11 to 15,613079,675498,8685039,8690059,23766,3.4,62099,8.9,1273282,246147,1027135,2.8,14.7,1283322,480294,803028,5.5,14.8,-10040,-0.1,29.4,0,43461,43614,345019,
2006,i) 16 to 20,478463,581760,10026074,9985935,23391,3.9,44331,7.5,1279304,323723,955581,3.2,12.8,1199026,374747,824279,3.8,12,80278,0.8,24,0,29293,29396,236768,
2006,j) 21 to 25,372617,495998,9177668,9152588,18923,3.8,31905,6.3,1074953,284648,790305,3.1,11.7,1024795,298919,725876,3.3,11.2,50158,0.5,22.4,0,19008,19159,162251,
2006,k) 26+,220866,370491,8258828,8166962,17594,4.7,22981,6.2,1085044,380356,704688,4.7,13.3,901311,262610,638701,3.2,11,183733,2.3,22,0,11694,11821,101467,
2006,l) Left Censored,502188,1483728,54018887,53663100,93077,6.3,80185,5.4,6254460,1871345,4383115,3.5,11.7,5542887,1459749,4083138,2.7,10.3,711573,1.4,20.6,0,22954,23575,318263,
2007,a) 0,525424,529199,3040643,1541771,515289,194.7,0,0,2997745,2997745,0,194.4,194.4,0,0,0,0,0,2997745,194.4,0,0,,,,
2007,b) 1,420075,434338,3213445,3338035,3148,0.6,123612,24.6,809966,48539,761427,1.5,24.3,1059146,569492,489654,17.1,31.7,-249180,-7.4,48.6,0,96399,96548,467780,
2007,c) 2,353265,363753,2939566,3046206,14202,3.6,67739,17.3,603249,91840,511409,3,19.8,816529,379400,437129,12.5,26.8,-213280,-7,39.6,0,53891,54008,309902,
2007,d) 3,299692,307781,2574232,2639034,11810,3.6,49522,15.2,489098,76522,412576,2.9,18.5,618702,290510,328192,11,23.4,-129604,-4.9,37,0,39098,39155,232678,
2007,e) 4,257658,271871,2546726,2572995,11160,3.9,37724,13.3,503456,91017,412439,3.5,19.6,555995,237946,318049,9.2,21.6,-52539,-2,39.2,0,29077,29117,175917,
2007,f) 5,232747,242891,2450411,2511019,9063,3.6,31114,12.3,388042,66806,321236,2.7,15.5,509258,207598,301660,8.3,20.3,-121216,-4.8,31,0,22938,23066,143384,
2007,g) 6 to 10,919100,995745,11228226,11425300,39640,3.8,108315,10.5,1712801,338628,1374173,3,15,2106951,777927,1329024,6.8,18.4,-394150,-3.4,30,0,73607,74607,506636,
2007,h) 11 to 15,620982,678742,8520495,8667113,25092,3.6,60590,8.7,1163127,245216,917911,2.8,13.4,1456362,462745,993617,5.3,16.8,-293235,-3.4,26.8,0,40891,41383,282183,
2007,i) 16 to 20,471692,573313,9635846,9679164,24230,4.2,44096,7.6,1293217,280882,1012335,2.9,13.4,1379853,391267,988586,4,14.3,-86636,-0.9,26.8,0,26645,27122,196494,
2007,j) 21 to 25,380731,505938,9334791,9370387,23076,4.5,36929,7.2,1246545,335854,910691,3.6,13.3,1317736,378082,939654,4,14.1,-71191,-0.8,26.6,0,18126,18713,137799,
2007,k) 26+,273093,450950,10155837,10125501,24303,5.4,30276,6.7,1345374,368527,976847,3.6,13.3,1284703,321207,963496,3.2,12.7,60671,0.6,25.4,0,13378,14044,101677,
2007,l) Left Censored,485589,1488308,53986803,53973539,110997,7.5,100149,6.8,6781920,2039115,4742805,3.8,12.6,6755393,1846338,4909055,3.4,12.5,26527,0.1,25,0,19923,21567,222067,
2008,a) 0,487673,493181,2837088,1444996,480053,194.7,0,0,2784184,2784184,0,192.7,192.7,0,0,0,0,0,2784184,192.7,0,0,,,,
2008,b) 1,385637,390486,2711189,2843051,1219,0.3,124510,27.1,683972,24905,659067,0.9,24.1,947695,540584,407111,19,33.3,-263723,-9.2,48.2,0,98919,98920,469368,
2008,c) 2,353299,368750,2894704,3033146,12927,3.2,75999,18.9,520187,67216,452971,2.2,17.2,797071,387063,410008,12.8,26.3,-276884,-9.1,34.4,0,60264,60283,332892,
2008,d) 3,305940,317237,2716418,2810501,10586,3.1,55634,16.4,471637,80111,391526,2.9,16.8,659805,301985,357820,10.7,23.5,-188168,-6.7,33.6,0,45196,45214,263628,
2008,e) 4,263844,273077,2407619,2479282,8988,3.1,42990,14.8,380843,48908,331935,2,15.4,524168,235031,289137,9.5,21.1,-143325,-5.7,30.8,0,34607,34632,202953,
2008,f) 5,230433,246216,2382892,2458820,8484,3.3,33480,12.9,357924,57352,300572,2.3,14.6,509779,216109,293670,8.8,20.7,-151855,-6.1,29.2,0,26580,26588,188293,
2008,g) 6 to 10,912582,989489,11220440,11442598,31690,3.1,106326,10.3,1521819,263800,1258019,2.3,13.3,1966135,715954,1250181,6.3,17.2,-444316,-3.9,26.6,0,80377,80568,562725,
2008,h) 11 to 15,631668,684625,8534474,8660669,21402,3,60095,8.5,1100411,246926,853485,2.9,12.7,1352800,411563,941237,4.8,15.6,-252389,-2.9,25.4,0,43476,43557,300582,
2008,i) 16 to 20,459117,548392,8513570,8591212,17751,3.2,40411,7.2,1062294,216806,845488,2.5,12.4,1217578,350077,867501,4.1,14.2,-155284,-1.8,24.8,0,27066,27111,196328,
2008,j) 21 to 25,389288,518427,9991771,10013204,17308,3.3,30693,5.8,1118430,271226,847204,2.7,11.2,1161297,287720,873577,2.9,11.6,-42867,-0.4,22.4,0,19610,19763,151052,
2008,k) 26+,316113,518101,11898266,11884175,20476,3.9,27799,5.3,1428913,351741,1077172,3,12,1400730,316897,1083833,2.7,11.8,28183,0.2,23.6,0,15829,15957,125293,
2008,l) Left Censored,464499,1479592,53672254,53630547,83083,5.6,69090,4.7,5902716,1748473,4154243,3.3,11,5819302,1195741,4623561,2.2,10.9,83414,0.1,21.8,0,18628,18908,224975,
2009,a) 0,406321,410737,2391953,1211563,401780,195.6,0,0,2360780,2360780,0,194.9,194.9,0,0,0,0,0,2360780,194.9,0,0,,,,
2009,b) 1,351951,358298,2367015,2583611,1083,0.3,121018,28.4,544444,14992,529452,0.6,21.1,977637,514331,463306,19.9,37.8,-433193,-16.7,42.2,0,94849,94920,439299,
2009,c) 2,315786,321158,2312579,2498304,10670,3,77263,21.7,390223,50369,339854,2,15.6,761672,360885,400787,14.4,30.5,-371449,-14.9,31.2,0,61033,61044,306074,
2009,d) 3,298888,314464,2511381,2685843,10473,3.1,62003,18.2,362286,48143,314143,1.8,13.5,711209,295296,415913,11,26.5,-348923,-13,27,0,48360,48459,244851,
2009,e) 4,263655,275164,2389194,2541815,8480,2.9,48416,16.4,339489,61636,277853,2.4,13.4,644732,246663,398069,9.7,25.4,-305243,-12,26.8,0,37572,37602,196521,
2009,f) 5,230559,239975,2104441,2247560,7013,2.7,38469,15,259591,33422,226169,1.5,11.5,545829,202474,343355,9,24.3,-286238,-12.8,23,0,29366,29407,166925,
2009,g) 6 to 10,885174,951336,9997330,10544403,27285,2.7,116878,11.7,1114153,191300,922853,1.8,10.6,2208300,719572,1488728,6.8,20.9,-1094147,-10.3,21.2,0,84758,85077,538099,
2009,h) 11 to 15,635262,705922,8558440,8967541,20289,2.8,67584,9.2,886251,189513,696738,2.1,9.9,1704453,437893,1266560,4.9,19,-818202,-9.1,19.8,0,46664,46888,306998,
2009,i) 16 to 20,449966,532224,7464111,7802770,15555,2.8,42766,7.8,722890,171045,551845,2.2,9.3,1400208,308032,1092176,3.9,17.9,-677318,-8.6,18.6,0,28108,28207,186321,
2009,j) 21 to 25,390299,512111,9589694,9901104,14839,2.8,33200,6.4,856239,244045,612194,2.5,8.6,1479058,309145,1169913,3.1,14.9,-622819,-6.3,17.2,0,20589,20671,154760,
2009,k) 26+,354544,585006,12790948,13176093,18504,3.1,32793,5.5,1168511,338638,829873,2.6,8.9,1938801,360642,1578159,2.7,14.7,-770290,-5.8,17.8,0,17722,18280,127121,
2009,l) Left Censored,445211,1444877,50856891,52000357,74108,5.1,83069,5.7,4400152,1350773,3049379,2.6,8.5,6687084,1324503,5362581,2.5,12.9,-2286932,-4.4,17,0,17470,18363,198336,
2010,a) 0,385358,392687,2406986,1213763,385766,196.5,0,0,2386447,2386447,0,196.6,196.6,0,0,0,0,0,2386447,196.6,0,0,,,,
2010,b) 1,301868,307432,2110323,2232242,1422,0.4,93897,26.2,487595,17296,470299,0.8,21.8,731432,412254,319178,18.5,32.8,-243837,-11,43.6,0,72003,72052,349783,
2010,c) 2,298728,305594,2155675,2255165,12589,3.8,64760,19.5,398899,55188,343711,2.4,17.7,597879,308088,289791,13.7,26.5,-198980,-8.8,35.4,0,50242,50270,260797,
2010,d) 3,274980,280728,2095827,2195955,11526,3.8,51630,17.2,328483,50033,278450,2.3,15,528738,254932,273806,11.6,24.1,-200255,-9.1,30,0,39340,39361,217377,
2010,e) 4,265110,281283,2305284,2403865,11383,3.8,43883,14.7,328563,53721,274842,2.2,13.7,525724,221869,303855,9.2,21.9,-197161,-8.2,27.4,0,32828,32856,181557,
2010,f) 5,236048,247721,2199404,2288010,9302,3.6,36084,13.8,309368,50408,258960,2.2,13.5,486579,198818,287761,8.7,21.3,-177211,-7.8,27,0,26755,26829,159459,
2010,g) 6 to 10,884280,945754,9490113,9785819,32949,3.4,107260,10.9,1185300,224556,960744,2.3,12.1,1776712,613754,1162958,6.3,18.2,-591412,-6.1,24.2,0,75991,76061,474641,
2010,h) 11 to 15,638149,714593,8564082,8790425,24024,3.3,64206,8.7,947817,211244,736573,2.4,10.8,1400502,412233,988269,4.7,15.9,-452685,-5.1,21.6,0,42463,42604,292569,
2010,i) 16 to 20,449887,523846,7048354,7212526,16528,3.1,38984,7.3,742691,159314,583377,2.2,10.3,1071034,284661,786373,3.9,14.8,-328343,-4.5,20.6,0,25530,25593,183345,
2010,j) 21 to 25,371060,486391,8916745,9056216,16304,3.3,30157,6.1,857498,235002,622496,2.6,9.5,1136442,255965,880477,2.8,12.5,-278944,-3,19,0,18142,18283,133623,
2010,k) 26+,419410,677746,14282306,14432346,23227,3.4,35325,5.2,1420383,377324,1043059,2.6,9.8,1720463,379909,1340554,2.6,11.9,-300080,-2.1,19.6,0,17963,18339,149419,
2010,l) Left Censored,428575,1414372,49217527,49866922,65236,4.6,73605,5.2,4253790,1201040,3052750,2.4,8.5,5552581,1146982,4405599,2.3,11.1,-1298791,-2.6,17,0,15385,15808,194286,
2011,a) 0,398364,404314,2318623,1167886,399131,197.4,0,0,2301474,2301474,0,197.1,197.1,0,0,0,0,0,2301474,197.1,0,0,,,,
2011,b) 1,286508,294832,2154604,2267626,1566,0.5,90324,26.3,530267,29517,500750,1.3,23.4,756310,427251,329059,18.8,33.4,-226043,-10,46.8,0,68603,68680,356637,
2011,c) 2,260026,266459,1989523,2037833,11414,4,52105,18.2,392644,50021,342623,2.5,19.3,489266,262927,226339,12.9,24,-96622,-4.7,38.6,0,40691,40713,223125,
2011,d) 3,263001,270535,2061944,2100568,12032,4.2,46387,16.1,359830,52009,307821,2.5,17.1,437078,221645,215433,10.6,20.8,-77248,-3.7,34.2,0,35734,35754,183210,
2011,e) 4,245984,252116,1989255,2035857,11132,4.2,39377,14.8,314924,44708,270216,2.2,15.5,408128,194434,213694,9.6,20,-93204,-4.5,31,0,29482,29498,150404,
2011,f) 5,239284,255445,2235976,2265250,10575,3.9,35753,13.3,333217,49242,283975,2.2,14.7,391764,177137,214627,7.8,17.3,-58547,-2.6,29.4,0,26176,26246,140427,
2011,g) 6 to 10,893648,955934,9553461,9686763,35531,3.6,107796,10.9,1280984,198104,1082880,2,13.2,1547588,605325,942263,6.2,16,-266604,-2.8,26.4,0,77151,77315,459575,
2011,h) 11 to 15,635104,716385,8752540,8846561,25630,3.5,63421,8.6,1056446,185908,870538,2.1,11.9,1244489,421959,822530,4.8,14.1,-188043,-2.2,23.8,0,42577,42741,293878,
2011,i) 16 to 20,449096,516564,6892302,6968994,16831,3.2,40130,7.6,743854,135694,608160,1.9,10.7,897239,252119,645120,3.6,12.9,-153385,-2.2,21.4,0,26540,26680,171096,
2011,j) 21 to 25,363609,474033,8705205,8664813,15218,3.2,31833,6.6,956828,206327,750501,2.4,11,876044,246164,629880,2.8,10.1,80784,0.9,20.2,0,19276,19536,122255,
2011,k) 26+,467144,750847,15993292,15954680,24990,3.3,40390,5.3,1670402,383258,1287144,2.4,10.5,1593179,381996,1211183,2.4,10,77223,0.5,20,0,21883,22229,150074,
2011,l) Left Censored,410517,1396456,49474965,49229263,68108,4.9,66205,4.7,4904560,1193605,3710955,2.4,10,4413156,990266,3422890,2,9,491404,1,18,0,15725,16243,181427,
2012,a) 0,408591,411939,2305197,1164971,406577,197.4,0,0,2280452,2280452,0,195.8,195.8,0,0,0,0,0,2280452,195.8,0,0,,,,
2012,b) 1,305428,312459,2238276,2267720,1849,0.5,86883,24.3,594939,31229,563710,1.4,26.2,653826,383973,269853,16.9,28.8,-58887,-2.6,52.4,0,64989,65024,299694,
2012,c) 2,251615,260986,2140686,2140916,12040,4.3,47289,17,452133,65985,386148,3.1,21.1,452592,244608,207984,11.4,21.1,-459,0,42.2,0,36023,36075,184350,
2012,d) 3,234903,242821,2003147,1993955,11270,4.4,36844,14.4,395494,58177,337317,2.9,19.8,377110,194507,182603,9.8,18.9,18384,0.9,37.8,0,27738,27761,148174,
2012,e) 4,241980,255035,2125026,2100454,12773,4.8,34404,13,427761,81610,346151,3.9,20.4,378618,187648,190970,8.9,18,49143,2.4,36,0,25202,25243,140057,
2012,f) 5,226827,231686,1931240,1944996,10578,4.4,30617,12.7,321914,48566,273348,2.5,16.6,349425,170530,178895,8.8,18,-27511,-1.4,33.2,0,21991,22091,124713,
2012,g) 6 to 10,923284,983331,9871218,9898887,41810,4.1,106413,10.5,1475144,247435,1227709,2.5,14.9,1530483,659854,870629,6.7,15.5,-55339,-0.6,29.8,0,70303,71016,441295,
2012,h) 11 to 15,642716,719165,8887332,8907742,29127,4,62252,8.5,1170416,222281,948135,2.5,13.1,1211237,448420,762817,5,13.6,-40821,-0.5,26.2,0,38276,38822,264965,
2012,i) 16 to 20,460204,519497,6937823,6911230,18642,3.5,39267,7.4,877152,153556,723596,2.2,12.7,823965,280732,543233,4.1,11.9,53187,0.8,23.8,0,24162,24511,154169,
2012,j) 21 to 25,362086,462879,8416886,8396225,17551,3.7,32258,6.9,993340,193429,799911,2.3,11.8,952017,282373,669644,3.4,11.3,41323,0.5,22.6,0,17403,17818,120299,
2012,k) 26+,520025,830254,17846104,17790559,34828,4.2,51270,6.1,2009930,453453,1556477,2.5,11.3,1898839,499442,1399397,2.8,10.7,111091,0.6,21.4,0,22502,23666,188318,
2012,l) Left Censored,401818,1395059,50058202,49788873,76962,5.5,76581,5.5,5354893,1247679,4107214,2.5,10.8,4816234,1164652,3651582,2.3,9.7,538659,1.1,19.4,0,13809,15022,161383,
2013,a) 0,404475,406881,2246252,1130922,402248,197.7,0,0,2230661,2230661,0,197.2,197.2,0,0,0,0,0,2230661,197.2,0,0,1,1,0,
2013,b) 1,315047,318609,2161028,2232877,517,0.1,93562,25.6,548189,8901,539288,0.4,24.6,691886,418928,272958,18.8,31,-143697,-6.4,49.2,0,67218,67230,341394,
2013,c) 2,269051,276437,2177668,2195603,11154,3.8,50485,17.2,444265,55021,389244,2.5,20.2,480136,253577,226559,11.5,21.9,-35871,-1.7,40.4,0,37353,37454,207010,
2013,d) 3,226793,236190,2108712,2121689,9343,3.8,36285,14.6,372163,46475,325688,2.2,17.5,398116,191820,206296,9,18.8,-25953,-1.3,35,0,26651,26691,154901,
2013,e) 4,214961,223579,1959741,1976398,8834,3.8,30239,13,313548,40870,272678,2.1,15.9,346862,159699,187163,8.1,17.6,-33314,-1.7,31.8,0,22047,22076,129518,
2013,f) 5,224071,237237,2076338,2095748,9592,3.9,29187,11.9,307733,40639,267094,1.9,14.7,346554,149067,197487,7.1,16.5,-38821,-1.8,29.4,0,20835,20862,118341,
2013,g) 6 to 10,935992,989730,9768418,9837540,37186,3.7,104015,10.2,1317101,202568,1114533,2.1,13.4,1455345,591000,864345,6,14.8,-138244,-1.4,26.8,0,70801,71081,442755,
2013,h) 11 to 15,650702,725790,9060783,9110666,23690,3.2,60027,8.1,1071027,176131,894896,1.9,11.8,1170793,411453,759340,4.5,12.9,-99766,-1.1,23.6,0,38965,39276,281167,
2013,i) 16 to 20,473726,528439,6999950,7011064,17102,3.2,39419,7.3,821614,157909,663705,2.3,11.7,843842,289643,554199,4.1,12,-22228,-0.3,23.4,0,25659,25804,191411,
2013,j) 21 to 25,355421,448684,7501618,7481982,15430,3.4,29770,6.5,863964,201178,662786,2.7,11.5,824691,240217,584474,3.2,11,39273,0.5,22,0,17570,17744,129902,
2013,k) 26+,564693,902874,20383809,20239777,28785,3.2,47272,5.2,2206309,472707,1733602,2.3,10.9,1918246,514017,1404229,2.5,9.5,288063,1.4,19,0,26016,26579,205366,
2013,l) Left Censored,387964,1379907,50750059,50372839,68251,5,64651,4.7,5152215,1267128,3885087,2.5,10.2,4397774,971042,3426732,1.9,8.7,754441,1.5,17.4,0,14307,14951,206747,
2014,a) 0,403902,410292,2459212,1229606,410292,200,0,0,2459212,2459212,0,200,200,0,0,0,0,0,2459212,200,0,0,,,,
2014,b) 1,312552,315436,2140122,2198471,577,0.2,91993,25.5,551717,9356,542361,0.4,25.1,668414,387407,281007,17.6,30.4,-116697,-5.3,50.2,0,71586,71587,323498,
2014,c) 2,275623,279229,2131232,2136641,14101,4.7,53405,17.9,459179,62811,396368,2.9,21.5,469996,260354,209642,12.2,22,-10817,-0.5,43,0,41555,41582,205906,
2014,d) 3,241545,248956,2156549,2163890,11640,4.4,38976,14.8,396103,52897,343206,2.4,18.3,410784,205907,204877,9.5,19,-14681,-0.7,36.6,0,30240,30246,163415,
2014,e) 4,206431,216089,2061654,2082430,10152,4.5,30020,13.3,351695,52196,299499,2.5,16.9,393246,177616,215630,8.5,18.9,-41551,-2,33.8,0,22680,22688,132003,
2014,f) 5,197968,207161,1937771,1951035,9746,4.5,25814,12,308305,51177,257128,2.6,15.8,334832,146500,188332,7.5,17.2,-26527,-1.4,31.6,0,19441,19448,110923,
2014,g) 6 to 10,944393,995917,9880022,9909740,44331,4.3,104335,10.2,1405016,226261,1178755,2.3,14.2,1464452,607229,857223,6.1,14.8,-59436,-0.6,28.4,0,75062,75305,430173,
2014,h) 11 to 15,653987,719123,8706032,8736212,28353,3.9,58904,8,1039350,175684,863666,2,11.9,1099709,390405,709304,4.5,12.6,-60359,-0.7,23.8,0,41128,41341,268947,
2014,i) 16 to 20,490210,559533,7729616,7749202,20993,3.7,40776,7.2,934803,193732,741071,2.5,12.1,973974,340901,633073,4.4,12.6,-39171,-0.5,24.2,0,27754,27969,174848,
2014,j) 21 to 25,355150,440370,7053096,7042224,14683,3.3,27861,6.2,773125,141397,631728,2,11,751381,221550,529831,3.1,10.7,21744,0.3,21.4,0,18719,18841,137181,
2014,k) 26+,602803,960959,22151532,22056120,34502,3.6,50729,5.2,2308846,506588,1802258,2.3,10.5,2118022,520716,1597306,2.4,9.6,190824,0.9,19.2,0,29212,29779,229089,
2014,l) Left Censored,373472,1368261,50696072,50498105,70547,5.2,54129,4,5012638,1332680,3679958,2.6,9.9,4616704,1083019,3533685,2.1,9.1,395934,0.8,18.2,0,14176,14900,196506,
2015,a) 0,414043,418788,2467344,1233672,418788,200,0,0,2467344,2467344,0,200,200,0,0,0,0,0,2467344,200,0,0,,,,
2015,b) 1,316075,322984,2343077,2376439,713,0.2,89815,24.4,584598,13674,570924,0.6,24.6,651321,377057,274264,15.9,27.4,-66723,-2.8,49.2,0,69469,69523,310886,
2015,c) 2,275148,278317,2087252,2107818,14558,4.9,52149,17.6,438913,63505,375408,3,20.8,480045,273766,206279,13,22.8,-41132,-2,41.6,0,40802,40808,220824,
2015,d) 3,248239,251902,2119615,2129694,12426,4.7,40041,15.1,411576,52745,358831,2.5,19.3,431734,231909,199825,10.9,20.3,-20158,-1,38.6,0,30880,30978,184827,
2015,e) 4,220588,227828,2112826,2134701,10388,4.4,31575,13.2,347237,50912,296325,2.4,16.3,390988,186027,204961,8.7,18.3,-43751,-2,32.6,0,23953,24067,148831,
2015,f) 5,190214,200182,2026776,2047124,9147,4.4,25366,12.2,326861,52626,274235,2.6,16,367557,175119,192438,8.6,18,-40696,-2,32,0,18875,18947,128985,
2015,g) 6 to 10,921965,975292,9931634,9970645,43128,4.3,101647,10.1,1389782,236268,1153514,2.4,13.9,1467804,629619,838185,6.3,14.7,-78022,-0.8,27.8,0,73584,74059,475101,
2015,h) 11 to 15,664666,725043,8721441,8743463,28235,3.8,60468,8.2,1053023,167864,885159,1.9,12,1097066,429832,667234,4.9,12.5,-44043,-0.5,24,0,42514,42824,308958,
2015,i) 16 to 20,499486,573851,8021238,8008737,21638,3.7,41946,7.2,958537,185644,772893,2.3,12,933534,320792,612742,4,11.7,25003,0.3,23.4,0,28854,29082,209806,
2015,j) 21 to 25,357284,434527,6964726,6965271,15202,3.4,28884,6.5,730254,141304,588950,2,10.5,731343,208143,523200,3,10.5,-1089,0,21,0,19696,19850,132632,
2015,k) 26+,638557,1032646,23857050,23744594,38823,3.7,55675,5.3,2579608,641579,1938029,2.7,10.9,2354697,624694,1730003,2.6,9.9,224911,1,19.8,0,32912,33862,252906,
2015,l) Left Censored,359879,1344737,50984472,50629643,72332,5.4,67922,5.1,5463076,1563457,3899619,3.1,10.8,4753418,1108673,3644745,2.2,9.4,709658,1.4,18.8,0,14063,15445,209181,
2016,a) 0,433192,438867,2573050,1286525,438867,200,0,0,2573050,2573050,0,200,200,0,0,0,0,0,2573050,200,0,0,,,,
2016,b) 1,322871,327671,2370171,2410520,665,0.2,92825,24.8,590802,12615,578187,0.5,24.5,671500,393885,277615,16.3,27.9,-80698,-3.4,49,0,71370,71387,325365,
2016,c) 2,278219,285654,2336668,2358234,14495,4.8,52341,17.2,475554,65152,410402,2.8,20.2,518686,274962,243724,11.7,22,-43132,-1.8,40.4,0,40890,40901,222796,
2016,d) 3,247050,250979,2083777,2102955,11904,4.5,40062,15.1,377359,60839,316520,2.9,17.9,415714,214180,201534,10.2,19.8,-38355,-1.9,35.8,0,31189,31200,174305,
2016,e) 4,226526,230547,2085236,2108070,10739,4.4,32537,13.5,362609,55591,307018,2.6,17.2,408276,213449,194827,10.1,19.4,-45667,-2.2,34.4,0,24895,24897,173271,
2016,f) 5,203131,210483,2077065,2092876,8988,4.1,26667,12.2,328974,52027,276947,2.5,15.7,360596,165480,195116,7.9,17.2,-31622,-1.5,31.4,0,20118,20147,124502,
2016,g) 6 to 10,884627,936994,9777478,9830081,39307,4.1,97412,10.1,1359641,247163,1112478,2.5,13.8,1464846,597366,867480,6.1,14.9,-105205,-1.1,27.6,0,70788,70849,447491,
2016,h) 11 to 15,683233,741571,9050701,9080767,28109,3.7,62393,8.2,1095382,191032,904350,2.1,12.1,1155514,435296,720218,4.8,12.7,-60132,-0.6,24.2,0,43517,43596,304723,
2016,i) 16 to 20,504872,584419,8284894,8303018,21406,3.6,42929,7.2,919671,197787,721884,2.4,11.1,955918,312670,643248,3.8,11.5,-36247,-0.4,22.2,0,29011,29065,203371,
2016,j) 21 to 25,360952,432481,6862604,6875944,14409,3.3,29391,6.7,781730,232893,548837,3.4,11.4,808409,252564,555845,3.7,11.8,-26679,-0.4,22.8,0,19978,19998,142946,
2016,k) 26+,674466,1095708,25500727,25400156,40071,3.6,59379,5.4,2661622,666127,1995495,2.6,10.5,2460480,667782,1792698,2.6,9.7,201142,0.8,19.4,0,35005,35131,249297,
2016,l) Left Censored,346879,1351079,51228964,50919755,76018,5.7,53861,4,4926497,1391940,3534557,2.7,9.7,4308078,996031,3312047,2,8.5,618419,1.2,17,0,13162,13283,169042,
