year2,ifsize,firms,Estabs,Emp,Denom,Estabs_Entry,Estabs_Entry_Rate,Estabs_Exit,Estabs_Exit_Rate,Job_Creation,Job_Creation_Births,Job_Creation_Continuers,Job_Creation_Rate_Births,Job_Creation_Rate,Job_Destruction,Job_Destruction_Deaths,Job_Destruction_Continuers,Job_Destruction_Rate_Deaths,Job_Destruction_Rate,Net_Job_Creation,Net_Job_Creation_Rate,Reallocation_Rate,d_flag,firmdeath_firms,firmdeath_estabs,firmdeath_emp
1977,a) 1 to 4,2022181,2027072,4825363,4428824,400549,20,332053,16.6,1725730,737084,988646,16.6,39,932651,594645,338006,13.4,21.1,793079,17.9,42.2,0,249288,249436,458021
1977,b) 5 to 9,674588,691465,4649618,4477342,92629,13.6,70205,10.3,1255644,578151,677493,12.9,28,911091,438735,472356,9.8,20.3,344553,7.7,40.6,0,53379,53735,345655
1977,c) 10 to 19,385101,422617,5342448,5203772,60663,14.7,40861,9.9,1293595,596965,696630,11.5,24.9,1016243,487944,528299,9.4,19.5,277352,5.4,39,0,27190,27698,362914
1977,d) 20 to 49,226877,294020,7149782,6929897,48482,17.1,27053,9.6,1746937,754147,992790,10.9,25.2,1307167,625690,681477,9,18.9,439770,6.3,37.8,0,15037,15603,447224
1977,e) 50 to 99,69307,123807,4938445,4792423,21787,18.5,9940,8.4,1156601,496867,659734,10.4,24.1,864557,401741,462816,8.4,18,292044,6.1,36,0,3963,4256,266926
1977,f) 100 to 249,34222,103631,5381173,5186435,17474,17.7,7469,7.6,1272922,543873,729049,10.5,24.5,883446,386476,496970,7.5,17,389476,7.5,34,0,1553,1806,227250
1977,g) 250 to 499,9490,58863,3242724,3196797,8586,15.2,4001,7.1,632529,305496,327033,9.6,19.8,540675,231269,309406,7.2,16.9,91854,2.9,33.8,0,335,415,113247
1977,h) 500 to 999,4592,49823,3159130,3058228,6265,13,3229,6.7,543797,217499,326298,7.1,17.8,341992,81376,260616,2.7,11.2,201805,6.6,22.4,1,1,3,
1977,i) 1000 to 2499,2850,69617,4298689,4162829,8930,13.1,5741,8.4,730117,306713,423404,7.4,17.5,458397,114958,343439,2.8,11,271720,6.5,22,1,2,15,
1977,j) 2500 to 4999,990,56896,3266977,3181790,5964,10.7,3547,6.4,539409,230642,308767,7.2,17,369035,77749,291286,2.4,11.6,170374,5.4,23.2,0,,,
1977,k) 5000 to 9999,617,46332,3405071,3314475,4576,10,3402,7.5,547363,178242,369121,5.4,16.5,366171,83573,282598,2.5,11,181192,5.5,22,0,,,
1977,l) 10000+,793,209649,16432392,16054821,21844,10.5,18509,8.9,2474871,913223,1561648,5.7,15.4,1719728,385501,1334227,2.4,10.7,755143,4.7,21.4,0,,,
1978,a) 1 to 4,2029409,2034500,5374586,4739982,401078,19.9,359456,17.8,2201345,748117,1453228,15.8,46.4,932136,656004,276132,13.8,19.7,1269209,26.7,39.4,0,265935,266002,488260
1978,b) 5 to 9,690361,708361,5093441,4758892,91290,13,75486,10.8,1551573,586855,964718,12.3,32.6,882475,476922,405553,10,18.5,669098,14.1,37,0,54475,54698,351926
1978,c) 10 to 19,395364,434745,5801940,5507014,44883,10.4,37508,8.7,1498411,561090,937321,10.2,27.2,908559,457083,451476,8.3,16.5,589852,10.7,33,0,24474,24890,323837
1978,d) 20 to 49,232300,300015,7528129,7224124,22508,7.5,22172,7.4,1677594,556243,1121351,7.7,23.2,1069583,512316,557267,7.1,14.8,608011,8.4,29.6,0,11469,11936,335022
1978,e) 50 to 99,70841,127162,5190662,5020483,11607,9.2,10232,8.1,1084149,358742,725407,7.1,21.6,743791,335042,408749,6.7,14.8,340358,6.8,29.6,0,2659,2997,178323
1978,f) 100 to 249,35020,107803,5554760,5424392,10652,10,8832,8.3,1069471,336990,732481,6.2,19.7,808734,366194,442540,6.8,14.9,260737,4.8,29.8,0,1081,1383,158822
1978,g) 250 to 499,9674,60451,3435857,3380257,6203,10.4,4612,7.7,643480,201955,441525,6,19,532279,223949,308330,6.6,15.7,111201,3.3,31.4,0,238,353,80486
1978,h) 500 to 999,4768,54336,3350501,3300368,5250,9.8,4213,7.8,557260,167744,389516,5.1,16.9,456993,175709,281284,5.3,13.8,100267,3.1,27.6,0,59,110,41698
1978,i) 1000 to 2499,2853,66839,4294002,4244785,6172,9.3,4879,7.4,658566,213021,445545,5,15.5,560132,219066,341066,5.2,13.2,98434,2.3,26.4,0,37,69,54564
1978,j) 2500 to 4999,1058,59289,3322991,3321104,4969,8.4,4032,6.9,472154,144843,327311,4.4,14.2,468380,174429,293951,5.3,14.1,3774,0.1,28.2,0,10,13,34738
1978,k) 5000 to 9999,584,49092,3519021,3517826,4257,8.8,2807,5.8,488271,136106,352165,3.9,13.9,485883,129733,356150,3.7,13.8,2388,0.1,27.6,1,2,2,
1978,l) 10000+,802,220090,17204463,17394057,17944,8.2,14736,6.7,2160084,544397,1615687,3.1,12.4,2539273,556646,1982627,3.2,14.6,-379189,-2.2,24.8,0,3,3,63088
1979,a) 1 to 4,2016141,2021604,5106174,4587780,390288,19.7,300890,15.2,1919742,742701,1177041,16.2,41.8,882954,550918,332036,12,19.2,1036788,22.6,38.4,0,215078,215138,395338
1979,b) 5 to 9,745825,762168,5202061,4941882,97780,13.1,65674,8.8,1460265,629958,830307,12.7,29.5,939906,410648,529258,8.3,19,520359,10.5,38,0,44991,45110,290752
1979,c) 10 to 19,437948,474206,6151564,5899444,50766,10.9,34093,7.3,1509187,628903,880284,10.7,25.6,1004947,400419,604528,6.8,17,504240,8.6,34,0,20614,20832,272065
1979,d) 20 to 49,260616,327825,8221048,7914617,27421,8.5,19854,6.1,1804243,641593,1162650,8.1,22.8,1191381,434783,756598,5.5,15.1,612862,7.7,30.2,0,9225,9509,269051
1979,e) 50 to 99,79461,138466,5716845,5544352,13067,9.6,9488,6.9,1167115,384860,782255,6.9,21.1,822128,295950,526178,5.3,14.8,344987,6.3,29.6,0,2128,2476,143473
1979,f) 100 to 249,39028,115510,6126791,5982641,11161,9.8,8248,7.2,1187174,374762,812412,6.3,19.8,898874,345725,553149,5.8,15,288300,4.8,30,0,977,1192,142215
1979,g) 250 to 499,10601,63599,3697966,3652601,6342,10.1,4320,6.9,629681,225987,403694,6.2,17.2,538950,189575,349375,5.2,14.8,90731,2.4,29.6,0,167,331,55944
1979,h) 500 to 999,5141,56006,3597333,3542360,5123,9.2,4091,7.4,576296,173407,402889,4.9,16.3,466350,146405,319945,4.1,13.2,109946,3.1,26.4,0,42,132,28291
1979,i) 1000 to 2499,3063,72898,4550732,4508230,7049,9.9,4277,6,666342,190598,475744,4.2,14.8,581338,163192,418146,3.6,12.9,85004,1.9,25.8,0,20,151,28935
1979,j) 2500 to 4999,1075,56049,3478922,3456088,5419,9.9,3138,5.7,509709,151942,357767,4.4,14.7,464043,124794,339249,3.6,13.4,45666,1.3,26.8,0,7,17,23886
1979,k) 5000 to 9999,621,57330,3742205,3703612,6301,11.3,3553,6.3,553647,164566,389081,4.4,14.9,476462,122235,354227,3.3,12.9,77185,2,25.8,1,2,2,
1979,l) 10000+,801,230664,18425039,18097074,21071,9.3,14266,6.3,2459777,689242,1770535,3.8,13.6,1803848,454543,1349305,2.5,10,655929,3.6,20,0,,,
1980,a) 1 to 4,1977253,1982964,4782215,4458005,359042,18.1,332947,16.8,1640550,676857,963693,15.2,36.8,992129,606336,385793,13.6,22.3,648421,14.5,44.6,0,266387,266469,489289
1980,b) 5 to 9,756995,772974,4968376,4927471,87652,11.4,74959,9.7,1206674,559466,647208,11.4,24.5,1124863,470570,654293,9.5,22.8,81811,1.7,45.6,0,58748,58966,381291
1980,c) 10 to 19,452476,487062,5992927,6003572,43964,9,40581,8.3,1255947,540140,715807,9,20.9,1277237,483643,793594,8.1,21.3,-21290,-0.4,41.8,0,28786,29080,380714
1980,d) 20 to 49,272880,338091,8097805,8132032,24213,7.2,23838,7,1482094,590124,891970,7.3,18.2,1550547,533862,1016685,6.6,19.1,-68453,-0.9,36.4,0,13281,13687,386979
1980,e) 50 to 99,84243,142068,5696502,5732667,10632,7.5,9647,6.8,949115,338578,610537,5.9,16.6,1021444,326223,695221,5.7,17.8,-72329,-1.2,33.2,0,2962,3331,200431
1980,f) 100 to 249,42141,118621,6356611,6354619,9083,7.7,8113,6.9,1036041,349490,686551,5.5,16.3,1032056,333943,698113,5.3,16.2,3985,0.1,32.4,0,1063,1289,152230
1980,g) 250 to 499,11806,67812,4049269,4043020,5729,8.5,4696,7,631902,204461,427441,5.1,15.6,619404,192779,426625,4.8,15.3,12498,0.3,30.6,0,189,372,63892
1980,h) 500 to 999,5164,55945,3567347,3555412,4694,8.5,3890,7,511475,168255,343220,4.7,14.4,487605,150917,336688,4.2,13.7,23870,0.7,27.4,0,47,133,33085
1980,i) 1000 to 2499,3222,74965,4720477,4672751,7423,10.1,4395,6,640588,197740,442848,4.2,13.7,545136,165282,379854,3.5,11.7,95452,2,23.4,0,18,35,27723
1980,j) 2500 to 4999,1090,56052,3431286,3402532,5069,9.2,3214,5.8,454042,142931,311111,4.2,13.3,396534,105765,290769,3.1,11.7,57508,1.6,23.4,1,2,2,
1980,k) 5000 to 9999,680,61618,3994067,3965157,5326,8.7,4060,6.7,537074,155274,381800,3.9,13.5,479254,121271,357983,3.1,12.1,57820,1.4,24.2,0,,,
1980,l) 10000+,851,240581,19093043,19037754,17478,7.3,14016,5.9,2372675,644364,1728311,3.4,12.5,2262097,457496,1804601,2.4,11.9,110578,0.6,23.8,0,,,
1981,a) 1 to 4,1973284,1978253,4804396,4503085,344845,17.3,364659,18.3,1626185,657292,968893,14.6,36.1,1023563,667272,356291,14.8,22.7,602622,13.4,45.4,0,265248,265321,484540
1981,b) 5 to 9,746336,759331,4973055,4911066,89301,11.8,86262,11.4,1232177,580902,651275,11.8,25.1,1108199,526221,581978,10.7,22.6,123978,2.5,45.2,0,55968,56149,362408
1981,c) 10 to 19,440458,467243,5877743,5890129,44171,9.4,52329,11.1,1240009,563729,676280,9.6,21.1,1264781,570383,694398,9.7,21.5,-24772,-0.4,42.2,0,26892,27206,356605
1981,d) 20 to 49,265007,315620,7784731,7884601,23521,7.3,38057,11.8,1419300,626932,792368,8,18,1619039,716575,902464,9.1,20.5,-199739,-2.5,36,0,13147,13496,385160
1981,e) 50 to 99,80730,136665,5418346,5468000,13076,9.6,12975,9.5,966263,446222,520041,8.2,17.7,1065571,421562,644009,7.7,19.5,-99308,-1.8,35.4,0,3020,3414,202363
1981,f) 100 to 249,40037,117950,5892219,5935959,11528,9.8,10482,8.9,1023683,479068,544615,8.1,17.2,1111162,442927,668235,7.5,18.7,-87479,-1.5,34.4,0,1157,1630,171283
1981,g) 250 to 499,11312,66919,3812452,3831875,6627,9.9,6276,9.4,652492,276902,375590,7.2,17,691338,276884,414454,7.2,18,-38846,-1,34,0,221,309,73434
1981,h) 500 to 999,5260,56620,3513221,3547448,5503,9.8,4770,8.5,504765,196912,307853,5.6,14.2,573220,207444,365776,5.8,16.2,-68455,-2,28.4,0,64,116,43560
1981,i) 1000 to 2499,3274,74881,4719303,4720767,7266,9.8,5540,7.5,642188,270426,371762,5.7,13.6,645116,208988,436128,4.4,13.7,-2928,-0.1,27.2,0,19,24,26870
1981,j) 2500 to 4999,1122,58522,3446921,3457790,5138,8.9,3751,6.5,455416,175574,279842,5.1,13.2,477154,127886,349268,3.7,13.8,-21738,-0.6,26.4,0,3,3,11137
1981,k) 5000 to 9999,666,58029,3693858,3701099,5418,9.4,5249,9.1,490352,138613,351739,3.7,13.2,504835,151434,353401,4.1,13.6,-14483,-0.4,26.4,1,1,12,
1981,l) 10000+,1014,251191,19602790,19749656,21252,8.5,18992,7.6,2531153,806445,1724708,4.1,12.8,2824884,720188,2104696,3.6,14.3,-293731,-1.5,25.6,1,1,2,
1982,a) 1 to 4,1987066,1994739,4930658,4517009,384768,19.3,325695,16.4,1782190,749396,1032794,16.6,39.5,954892,595282,359610,13.2,21.1,827298,18.4,42.2,0,206131,206132,381857
1982,b) 5 to 9,764817,785669,5063725,4960324,101622,13.2,69347,9,1291755,627147,664608,12.6,26,1084953,446785,638168,9,21.9,206802,4.1,43.8,0,45866,45873,297016
1982,c) 10 to 19,450189,492059,5969834,5916043,59339,12.4,34318,7.2,1335379,648651,686728,11,22.6,1227796,446442,781354,7.5,20.8,107583,1.8,41.6,0,22403,22421,297214
1982,d) 20 to 49,271861,342126,7978147,7947654,41711,12.6,19369,5.8,1602899,798444,804455,10,20.2,1541912,517656,1024256,6.5,19.4,60987,0.8,38.8,0,11215,11314,329838
1982,e) 50 to 99,81846,140275,5484104,5454515,17524,12.9,8740,6.4,1099313,518342,580971,9.5,20.2,1040135,344295,695840,6.3,19.1,59178,1.1,38.2,0,2858,3074,192485
1982,f) 100 to 249,41523,125969,5988411,5996462,14859,12.2,7414,6.1,1095051,554362,540689,9.2,18.3,1111152,333557,777595,5.6,18.5,-16101,-0.2,36.6,0,1055,1220,154003
1982,g) 250 to 499,11705,70135,3852208,3854636,7780,11.4,4278,6.3,663646,314796,348850,8.2,17.2,668501,196242,472259,5.1,17.3,-4855,-0.1,34.4,0,204,290,67474
1982,h) 500 to 999,5365,59433,3546226,3532996,6413,11.1,3281,5.7,542315,222706,319609,6.3,15.4,515854,129073,386781,3.7,14.6,26461,0.8,29.2,0,40,57,26874
1982,i) 1000 to 2499,3391,73741,4848515,4809527,7189,9.9,5238,7.2,679135,251873,427262,5.2,14.1,601159,144405,456754,3,12.5,77976,1.6,25,0,13,15,21602
1982,j) 2500 to 4999,1216,61969,3629013,3633100,5446,8.9,3891,6.4,490805,189886,300919,5.2,13.5,498979,132837,366142,3.7,13.7,-8174,-0.2,27,0,3,6,12053
1982,k) 5000 to 9999,685,64892,3799011,3812385,5961,9.3,4419,6.9,532482,207864,324618,5.5,14,559232,144247,414985,3.8,14.7,-26750,-0.7,28,0,,,
1982,l) 10000+,1070,259707,19392372,19517623,27358,10.7,19231,7.5,2525163,1143310,1381853,5.9,12.9,2775665,621640,2154025,3.2,14.2,-250502,-1.3,25.8,0,,,
1983,a) 1 to 4,2067761,2074488,5052723,4685313,355245,17.4,316129,15.5,1677596,672866,1004730,14.4,35.8,942776,593364,349412,12.7,20.1,734820,15.7,40.2,0,231478,231547,445098
1983,b) 5 to 9,771960,792577,5141299,5062105,81736,10.4,71482,9.1,1186776,520634,666142,10.3,23.4,1028387,448490,579897,8.9,20.3,158389,3.1,40.6,0,54430,54603,351772
1983,c) 10 to 19,442347,483701,5917856,5907224,37531,7.8,36640,7.6,1174659,471705,702954,8,19.9,1153394,444966,708428,7.5,19.5,21265,0.4,39,0,25789,26055,341243
1983,d) 20 to 49,264871,336076,7798824,7858965,20516,6.1,21852,6.5,1343860,511237,832623,6.5,17.1,1464142,508885,955257,6.5,18.6,-120282,-1.5,34.2,0,12593,12926,369474
1983,e) 50 to 99,80464,143969,5332332,5410292,11517,8,10719,7.5,887251,342612,544639,6.3,16.4,1043171,331258,711913,6.1,19.3,-155920,-2.9,32.8,0,2866,3178,193073
1983,f) 100 to 249,40539,126492,5816654,5930274,10843,8.6,9751,7.7,942885,344429,598456,5.8,15.9,1170124,342073,828051,5.8,19.7,-227239,-3.8,31.8,0,1091,1561,156799
1983,g) 250 to 499,11638,70976,3760589,3847204,6237,8.8,5769,8.2,574838,204256,370582,5.3,14.9,748067,205601,542466,5.3,19.4,-173229,-4.5,29.8,0,192,468,65474
1983,h) 500 to 999,5511,62483,3484696,3555247,5555,9,4628,7.5,494058,190854,303204,5.4,13.9,635161,150467,484694,4.2,17.9,-141103,-4,27.8,0,34,102,23140
1983,i) 1000 to 2499,3594,79147,4774125,4859664,8639,11,6822,8.7,591207,206895,384312,4.3,12.2,762284,184572,577712,3.8,15.7,-171077,-3.5,24.4,0,8,8,11596
1983,j) 2500 to 4999,1289,58328,3576518,3630710,4728,8.2,4069,7,472186,167978,304208,4.6,13,580569,130272,450297,3.6,16,-108383,-3,26,1,1,1,
1983,k) 5000 to 9999,764,63695,3752287,3827531,5290,8.3,5326,8.4,494446,175225,319221,4.6,12.9,644935,145852,499083,3.8,16.8,-150489,-3.9,25.8,0,,,
1983,l) 10000+,1258,264898,18308962,18886996,22878,8.6,21154,7.9,2314966,916325,1398641,4.9,12.3,3471034,748834,2722200,4,18.4,-1156068,-6.1,24.6,0,,,
1984,a) 1 to 4,2170057,2177112,5523443,4960839,418458,19.7,319417,15,2029120,795918,1233202,16,40.9,903911,581405,322506,11.7,18.2,1125209,22.7,36.4,0,224072,224171,416821
1984,b) 5 to 9,805051,825198,5640941,5362257,96643,11.9,68600,8.5,1493846,625677,868169,11.7,27.9,936477,428069,508408,8,17.5,557369,10.4,35,0,48614,48745,313982
1984,c) 10 to 19,453243,493908,6449839,6184207,44794,9.2,35059,7.2,1516533,566764,949769,9.2,24.5,985269,416001,569268,6.7,15.9,531264,8.6,31.8,0,22336,22579,296174
1984,d) 20 to 49,267092,337729,8485366,8164588,25350,7.6,21030,6.3,1811130,632218,1178912,7.7,22.2,1169573,466801,702772,5.7,14.3,641557,7.9,28.6,0,10816,11071,315411
1984,e) 50 to 99,80653,144669,5795663,5594958,13095,9.2,9725,6.8,1195019,432186,762833,7.7,21.4,793609,295220,498389,5.3,14.2,401410,7.2,28.4,0,2468,2757,165076
1984,f) 100 to 249,40315,127291,6305523,6104184,10998,8.7,8533,6.8,1237508,428302,809206,7,20.3,834830,287211,547619,4.7,13.7,402678,6.6,27.4,0,858,1149,124971
1984,g) 250 to 499,11554,73326,4038447,3934445,6791,9.4,4943,6.8,749687,266993,482694,6.8,19.1,541683,163503,378180,4.2,13.8,208004,5.3,27.6,0,136,248,47039
1984,h) 500 to 999,5410,63144,3711549,3641546,5624,9,3878,6.2,606603,202600,404003,5.6,16.7,466598,124798,341800,3.4,12.8,140005,3.9,25.6,0,31,105,21250
1984,i) 1000 to 2499,3432,76803,4987384,4922139,6539,8.6,5163,6.8,695715,212256,483459,4.3,14.1,565225,148962,416263,3,11.5,130490,2.6,23,0,14,79,21074
1984,j) 2500 to 4999,1222,60476,3650744,3613627,5195,8.7,3874,6.5,512414,169041,343373,4.7,14.2,438180,122979,315201,3.4,12.1,74234,2.1,24.2,0,3,3,10411
1984,k) 5000 to 9999,745,66711,3954216,3892913,5824,8.9,3885,5.9,590358,226084,364274,5.8,15.2,467751,123918,343833,3.2,12,122607,3.2,24,1,1,1,
1984,l) 10000+,1115,276402,18843649,18685934,23612,8.7,19612,7.2,2444875,821162,1623713,4.4,13.1,2129445,617883,1511562,3.3,11.4,315430,1.7,22.8,1,1,1,
1985,a) 1 to 4,2213801,2221284,5642947,5080521,424942,19.6,325318,15,2073172,804157,1269015,15.8,40.8,948320,596784,351536,11.7,18.7,1124852,22.1,37.4,0,237227,237326,443970
1985,b) 5 to 9,841255,861295,5815658,5588374,97543,11.5,74192,8.7,1500851,624006,876845,11.2,26.9,1046282,466354,579928,8.3,18.7,454569,8.2,37.4,0,54576,54819,353736
1985,c) 10 to 19,478076,518265,6647872,6477359,47187,9.2,39162,7.6,1484427,581631,902796,9,22.9,1143400,477621,665779,7.4,17.7,341027,5.2,35.4,0,26296,26641,348436
1985,d) 20 to 49,286240,356901,8916666,8742935,26655,7.5,24370,6.8,1799214,642014,1157200,7.3,20.6,1451751,591679,860072,6.8,16.6,347463,4,33.2,0,13663,14034,402829
1985,e) 50 to 99,88487,150470,6203837,6144277,10356,6.9,9642,6.4,1110439,381167,729272,6.2,18.1,991318,397632,593686,6.5,16.1,119121,2,32.2,0,3439,3739,231940
1985,f) 100 to 249,45366,132703,6901110,6873953,8632,6.5,8239,6.2,1117513,369525,747988,5.4,16.3,1063199,403660,659539,5.9,15.5,54314,0.8,31,0,1361,1837,198071
1985,g) 250 to 499,13015,76104,4465778,4429887,7773,10.4,5240,7,755316,292653,462663,6.6,17.1,683534,245403,438131,5.5,15.4,71782,1.7,30.8,0,263,422,88414
1985,h) 500 to 999,5838,66218,3979704,3951366,6505,10,4805,7.4,638093,251014,387079,6.4,16.1,581417,185096,396321,4.7,14.7,56676,1.4,29.4,0,65,94,44693
1985,i) 1000 to 2499,3654,79949,5152110,5154582,7929,10,5950,7.5,675579,235123,440456,4.6,13.1,680523,223918,456605,4.3,13.2,-4944,-0.1,26.2,0,31,134,46878
1985,j) 2500 to 4999,1246,60678,3731512,3720733,5833,9.8,4096,6.8,514060,170226,343834,4.6,13.8,492501,154286,338215,4.1,13.2,21559,0.6,26.4,0,3,125,11400
1985,k) 5000 to 9999,791,75168,4061968,4102039,6448,8.7,4598,6.2,500315,179204,321111,4.4,12.2,580458,176899,403559,4.3,14.2,-80143,-2,24.4,1,2,9,
1985,l) 10000+,1152,277877,19377727,19292305,23777,8.5,25084,9,2416982,834248,1582734,4.3,12.5,2246139,777881,1468258,4,11.6,170843,0.9,23.2,1,1,2,
1986,a) 1 to 4,2253340,2261030,5713771,5177114,433589,19.5,346788,15.6,2081651,820227,1261424,15.8,40.2,1008337,640584,367753,12.4,19.5,1073314,20.7,39,0,255208,255229,480840
1986,b) 5 to 9,868465,888454,5955244,5742048,104078,11.9,78691,9,1529097,668554,860543,11.6,26.6,1102704,497740,604964,8.7,19.2,426393,7.4,38.4,0,59762,59777,387614
1986,c) 10 to 19,497383,537065,6878383,6702842,51170,9.6,39988,7.5,1552628,643869,908759,9.6,23.2,1201545,497185,704360,7.4,17.9,351083,5.3,35.8,0,28965,29004,383629
1986,d) 20 to 49,300504,369361,9213384,9037669,29750,8.1,23371,6.4,1845844,753211,1092633,8.3,20.4,1494413,573989,920424,6.4,16.5,351431,3.9,33,0,14459,14511,424824
1986,e) 50 to 99,94263,157295,6506014,6419278,17193,11.1,12978,8.4,1295599,563296,732303,8.8,20.2,1122127,413464,708663,6.4,17.5,173472,2.7,35,0,3678,4177,249130
1986,f) 100 to 249,48340,137976,7241170,7182088,14575,10.7,11434,8.4,1407228,605886,801342,8.4,19.6,1289063,458048,831015,6.4,17.9,118165,1.7,35.8,0,1486,1925,218267
1986,g) 250 to 499,13728,78285,4584441,4590247,8098,10.5,5652,7.3,795810,335265,460545,7.3,17.3,807421,279758,527663,6.1,17.6,-11611,-0.3,34.6,0,333,475,113288
1986,h) 500 to 999,6071,68145,4017208,4024874,6898,10.3,4450,6.6,629533,249541,379992,6.2,15.6,644864,193655,451209,4.8,16,-15331,-0.4,31.2,0,74,210,49503
1986,i) 1000 to 2499,3881,84896,5404688,5416163,8944,10.8,5459,6.6,734608,267246,467362,4.9,13.6,757557,215371,542186,4,14,-22949,-0.4,27.2,0,36,162,48485
1986,j) 2500 to 4999,1348,65870,3901689,3866987,6238,9.6,4437,6.8,582148,219806,362342,5.7,15.1,512744,124170,388574,3.2,13.3,69404,1.8,26.6,1,2,2,
1986,k) 5000 to 9999,878,72942,4173771,4173437,6160,8.5,6057,8.3,557719,196773,360946,4.7,13.4,557052,160334,396718,3.8,13.3,667,0.1,26.6,0,,,
1986,l) 10000+,1254,288980,19878075,19800521,25057,8.7,19784,6.9,2473452,920511,1552941,4.6,12.5,2318344,679272,1639072,3.4,11.7,155108,0.8,23.4,1,1,1,
1987,a) 1 to 4,2307963,2315298,5831249,5273147,456284,20.1,348557,15.3,2142354,853470,1288884,16.2,40.6,1026149,648185,377964,12.3,19.5,1116205,21.1,39,0,268415,268774,506964
1987,b) 5 to 9,890350,909877,6094405,5890883,109218,12.1,87343,9.7,1581230,680743,900487,11.6,26.8,1174185,536017,638168,9.1,19.9,407045,6.9,39.8,0,64426,64956,417872
1987,c) 10 to 19,513479,554990,7005382,6883172,60249,10.9,51054,9.3,1598408,673351,925057,9.8,23.2,1353987,576088,777899,8.4,19.7,244421,3.5,39.4,0,32239,32963,428502
1987,d) 20 to 49,312574,391525,9490484,9391442,46067,11.9,35521,9.2,2036233,843717,1192516,9,21.7,1838149,738264,1099885,7.9,19.6,198084,2.1,39.2,0,17123,17898,506232
1987,e) 50 to 99,98728,166819,6736276,6698449,20377,12.5,13120,8,1327152,564488,762664,8.4,19.8,1251497,476744,774753,7.1,18.7,75655,1.1,37.4,0,4387,4876,296494
1987,f) 100 to 249,50491,144518,7463773,7464896,17597,12.4,11381,8.1,1377531,586138,791393,7.9,18.5,1379776,514173,865603,6.9,18.5,-2245,0,37,0,1753,2093,254181
1987,g) 250 to 499,14378,80767,4779608,4769446,9278,11.7,6136,7.8,840521,363337,477184,7.6,17.6,820197,297952,522245,6.2,17.2,20324,0.4,34.4,0,348,590,116028
1987,h) 500 to 999,6405,71425,4256862,4243433,8064,11.5,5685,8.1,657608,261232,396376,6.2,15.5,630750,223657,407093,5.3,14.9,26858,0.6,29.8,0,72,197,49899
1987,i) 1000 to 2499,4059,87477,5826569,5819328,9239,10.7,6589,7.7,765431,296341,469090,5.1,13.2,750948,255181,495767,4.4,12.9,14483,0.3,25.8,0,35,195,52375
1987,j) 2500 to 4999,1459,66782,4051198,4080084,6542,9.9,4662,7.1,512940,163217,349723,4,12.6,570712,179180,391532,4.4,14,-57772,-1.4,25.2,0,5,5,16051
1987,k) 5000 to 9999,937,80400,4361920,4417418,7133,8.9,7084,8.8,549825,179066,370759,4.1,12.4,660821,226143,434678,5.1,15,-110996,-2.6,24.8,1,1,1,
1987,l) 10000+,1324,295683,19754250,19987529,33194,11.3,28997,9.9,2537388,972978,1564410,4.9,12.7,3003945,1091797,1912148,5.5,15,-466557,-2.3,25.4,0,3,132,41722
1988,a) 1 to 4,2287208,2293866,5776450,5301969,404267,17.7,378084,16.5,2025606,770516,1255090,14.5,38.2,1076643,680165,396478,12.8,20.3,948963,17.9,40.6,0,294136,294137,537725
1988,b) 5 to 9,903088,923715,6152169,5986974,97088,10.6,81115,8.9,1495833,619274,876559,10.3,25,1165443,512267,653176,8.6,19.5,330390,5.5,39,0,63638,63639,412625
1988,c) 10 to 19,521264,565744,7158866,7036598,47744,8.5,42144,7.5,1516833,590422,926411,8.4,21.6,1272297,513438,758859,7.3,18.1,244536,3.5,36.2,0,30186,30186,399635
1988,d) 20 to 49,313233,394259,9591181,9464839,29011,7.4,25907,6.6,1854558,683915,1170643,7.2,19.6,1601873,604549,997324,6.4,16.9,252685,2.7,33.8,0,14977,14977,438627
1988,e) 50 to 99,97736,170347,6758202,6692211,16047,9.5,12224,7.3,1273158,495457,777701,7.4,19,1141176,400130,741046,6,17.1,131982,1.9,34.2,0,3393,3397,228325
1988,f) 100 to 249,50274,151007,7536916,7469456,16077,10.8,10978,7.4,1428168,576841,851327,7.7,19.1,1293248,435702,857546,5.8,17.3,134920,1.8,34.6,0,1237,1245,181528
1988,g) 250 to 499,14262,86904,4848206,4786616,10573,12.4,6754,7.9,967787,426365,541422,8.9,20.2,844607,297746,546861,6.2,17.6,123180,2.6,35.2,0,290,290,99304
1988,h) 500 to 999,6720,73394,4512420,4437586,8656,11.9,6384,8.8,796959,318308,478651,7.2,18,647291,193068,454223,4.4,14.6,149668,3.4,29.2,0,48,48,33111
1988,i) 1000 to 2499,4223,90275,6052996,5960642,10519,11.9,6418,7.3,906551,321636,584915,5.4,15.2,721843,231108,490735,3.9,12.1,184708,3.1,24.2,0,22,26,32332
1988,j) 2500 to 4999,1487,73919,4293906,4217622,7832,10.7,6081,8.3,697032,249442,447590,5.9,16.5,544464,173493,370971,4.1,12.9,152568,3.6,25.8,0,3,3,10014
1988,k) 5000 to 9999,906,76838,4482106,4463028,7255,9.4,6836,8.9,672788,226200,446588,5.1,15.1,634633,228826,405807,5.1,14.2,38155,0.9,28.4,1,2,2,
1988,l) 10000+,1192,320954,20251266,20167750,46021,14.7,29445,9.4,2912728,1045581,1867147,5.2,14.4,2745698,980494,1765204,4.9,13.6,167030,0.8,27.2,1,2,2,
1989,a) 1 to 4,2280176,2287718,5886829,5374611,393565,17.3,377050,16.5,2108688,750893,1357795,14,39.2,1084251,695574,388677,12.9,20.2,1024437,19,40.4,0,273707,273758,511561
1989,b) 5 to 9,909472,930227,6285101,6110170,95077,10.3,88839,9.6,1558688,609359,949329,10,25.5,1208825,564189,644636,9.2,19.8,349863,5.7,39.6,0,64270,64342,417326
1989,c) 10 to 19,528602,573354,7311369,7205101,47737,8.3,47005,8.2,1538534,598772,939762,8.3,21.4,1325998,580550,745448,8.1,18.4,212536,3,36.8,0,31332,31447,415840
1989,d) 20 to 49,319162,400818,9864044,9749492,28256,7,29016,7.2,1861735,684360,1177375,7,19.1,1632631,692689,939942,7.1,16.7,229104,2.4,33.4,0,15845,16241,469796
1989,e) 50 to 99,98856,172410,6919145,6869339,15744,9.2,13521,7.9,1267285,486125,781160,7.1,18.4,1167672,477338,690334,6.9,17,99613,1.4,34,0,4513,5500,304892
1989,f) 100 to 249,51010,153742,7786374,7733278,15345,10.1,11605,7.7,1406931,550788,856143,7.1,18.2,1300738,523609,777129,6.8,16.8,106193,1.4,33.6,0,1971,2813,289807
1989,g) 250 to 499,14617,89116,4999095,4965669,9535,10.9,6484,7.4,874582,351688,522894,7.1,17.6,807729,314008,493721,6.3,16.3,66853,1.3,32.6,0,454,727,149812
1989,h) 500 to 999,7010,79160,4655096,4614972,8128,10.5,4861,6.3,698609,237595,461014,5.1,15.1,618361,184452,433909,4,13.4,80248,1.7,26.8,0,92,730,59939
1989,i) 1000 to 2499,4545,96299,6445215,6381432,9494,10.1,6178,6.5,902405,323832,578573,5.1,14.1,774840,218743,556097,3.4,12.1,127565,2,24.2,0,40,169,54708
1989,j) 2500 to 4999,1698,84194,4662386,4574728,9771,12,5022,6.1,688205,247547,440658,5.4,15,512890,132068,380822,2.9,11.2,175315,3.8,22.4,0,9,206,22227
1989,k) 5000 to 9999,904,78347,4487845,4460473,7790,10.2,4622,6,667451,262877,404574,5.9,15,612708,169862,442846,3.8,13.7,54743,1.3,27.4,0,9,33,18709
1989,l) 10000+,1307,334803,21113310,20942266,38111,11.6,29083,8.8,3002731,1143692,1859039,5.5,14.3,2660643,731323,1929320,3.5,12.7,342088,1.6,25.4,0,15,91,0
1990,a) 1 to 4,2321255,2328958,5878785,5343110,418602,18.2,325790,14.2,2061678,798970,1262708,15,38.6,990328,602291,388037,11.3,18.5,1071350,20.1,37,0,257351,257383,484160
1990,b) 5 to 9,930412,951192,6353274,6145678,103454,11,76549,8.1,1563019,661703,901316,10.8,25.4,1147826,484015,663811,7.9,18.7,415193,6.7,37.4,0,61702,61771,400734
1990,c) 10 to 19,543939,587972,7428694,7299707,51394,8.8,40484,6.9,1548558,636094,912464,8.7,21.2,1290584,496828,793756,6.8,17.7,257974,3.5,35.4,0,30335,30446,402414
1990,d) 20 to 49,330942,412127,10020353,9925408,30394,7.4,24801,6.1,1819107,727532,1091575,7.3,18.3,1629217,593732,1035485,6,16.4,189890,1.9,32.8,0,15489,15783,456031
1990,e) 50 to 99,103192,175615,7023258,7006772,15612,9,11561,6.7,1194059,495372,698687,7.1,17,1161086,393642,767444,5.6,16.6,32973,0.4,33.2,0,4004,4791,268650
1990,f) 100 to 249,53629,159565,7981636,7969331,14482,9.2,10324,6.6,1295723,519898,775825,6.5,16.3,1271112,419925,851187,5.3,16,24611,0.3,32,0,1647,2220,243327
1990,g) 250 to 499,15270,92745,5116327,5117486,9039,9.9,6041,6.6,794650,319617,475033,6.2,15.5,796968,249654,547314,4.9,15.6,-2318,-0.1,31,0,325,603,110655
1990,h) 500 to 999,7179,80709,4768292,4756315,6885,8.6,5809,7.2,680781,238729,442052,5,14.3,656826,200649,456177,4.2,13.8,23955,0.5,27.6,0,90,223,58948
1990,i) 1000 to 2499,4620,101330,6619560,6574066,9892,9.9,6217,6.3,835888,275520,560368,4.2,12.7,744901,185940,558961,2.8,11.3,90987,1.4,22.6,0,20,20,31474
1990,j) 2500 to 4999,1636,85625,4746556,4735784,8129,9.7,5188,6.2,617160,202127,415033,4.3,13,595616,154525,441091,3.3,12.6,21544,0.4,25.2,0,6,41,19753
1990,k) 5000 to 9999,935,88638,4922386,4899389,6729,7.7,5652,6.4,608219,175896,432323,3.6,12.4,562225,138602,423623,2.8,11.5,45994,0.9,23,1,2,2,
1990,l) 10000+,1227,343698,21694279,21645287,29417,8.6,24548,7.2,2626094,806461,1819633,3.7,12.1,2528109,671224,1856885,3.1,11.7,97985,0.4,23.4,1,2,2,
1991,a) 1 to 4,2348334,2356221,5803522,5379533,393243,16.9,344553,14.8,1924907,738080,1186827,13.7,35.8,1076929,633630,443299,11.8,20,847978,15.8,40,0,251999,252138,475294
1991,b) 5 to 9,943093,963963,6191267,6156821,90647,9.5,78927,8.2,1348622,575086,773536,9.3,21.9,1279729,495118,784611,8,20.8,68893,1.1,41.6,0,60784,60906,394423
1991,c) 10 to 19,552657,600513,7240597,7312080,49086,8.2,41990,7,1341667,571852,769815,7.8,18.3,1484633,510731,973902,7,20.3,-142966,-2,36.6,0,30331,30491,403872
1991,d) 20 to 49,338767,430888,9867499,10026128,42078,9.9,30054,7.1,1747994,748191,999803,7.5,17.4,2065251,659753,1405498,6.6,20.6,-317257,-3.2,34.8,0,16647,17749,497413
1991,e) 50 to 99,104704,185518,6835772,6998163,22501,12.4,12965,7.2,1119627,527502,592125,7.5,16,1444408,445898,998510,6.4,20.6,-324781,-4.6,32,0,4511,5398,305161
1991,f) 100 to 249,54248,166076,7754708,7935202,18886,11.6,11657,7.2,1218040,569860,648180,7.2,15.3,1579028,490700,1088328,6.2,19.9,-360988,-4.6,30.6,0,1993,2886,296424
1991,g) 250 to 499,15552,96132,5010983,5114128,10470,11.1,7010,7.4,750090,345053,405037,6.7,14.7,956379,301551,654828,5.9,18.7,-206289,-4,29.4,0,423,1220,141387
1991,h) 500 to 999,7193,79979,4601517,4690809,7380,9.3,6916,8.7,594508,243279,351229,5.2,12.7,773092,230290,542802,4.9,16.5,-178584,-3.8,25.4,0,128,753,86465
1991,i) 1000 to 2499,4768,105119,6573149,6637738,9465,9.1,8403,8,763035,280333,482702,4.2,11.5,892214,262850,629364,4,13.4,-129179,-1.9,23,0,43,503,57126
1991,j) 2500 to 4999,1594,80926,4617025,4637112,7194,9,5671,7.1,568394,220258,348136,4.7,12.3,608570,187296,421274,4,13.1,-40176,-0.8,24.6,0,11,34,30959
1991,k) 5000 to 9999,947,88743,4722326,4762118,6618,7.4,6926,7.8,542972,172195,370777,3.6,11.4,622556,198278,424278,4.2,13.1,-79584,-1.7,22.8,1,1,1,
1991,l) 10000+,1246,362824,22186514,22306207,35289,9.8,28279,7.9,2689877,1005600,1684277,4.5,12.1,2929263,745241,2184022,3.3,13.1,-239386,-1,24.2,1,2,2,
1992,a) 1 to 4,2398283,2404730,5994829,5510133,408492,17.1,357055,14.9,2038853,756999,1281854,13.7,37,1069461,650526,418935,11.8,19.4,969392,17.6,38.8,0,275231,276024,510865
1992,b) 5 to 9,936541,954788,6294363,6180579,91061,9.6,82390,8.6,1439927,570531,869396,9.2,23.3,1212358,501867,710491,8.1,19.6,227569,3.7,39.2,0,61980,63049,401810
1992,c) 10 to 19,544706,595544,7319493,7285833,50271,8.4,48024,8.1,1459593,552350,907243,7.6,20,1392272,526045,866227,7.2,19.1,67321,0.9,38.2,0,30679,31982,407402
1992,d) 20 to 49,331092,431623,9838325,9856349,38416,9,32428,7.6,1814124,671793,1142331,6.8,18.4,1850171,655161,1195010,6.6,18.8,-36047,-0.4,36.8,0,16302,17660,483737
1992,e) 50 to 99,102304,192131,6876806,6891603,18901,10,12049,6.4,1219570,449576,769994,6.5,17.7,1249164,394437,854727,5.7,18.1,-29594,-0.4,35.4,0,3999,4857,270715
1992,f) 100 to 249,53017,173785,7790609,7810594,17663,10.3,11584,6.8,1343480,502245,841235,6.4,17.2,1383449,439791,943658,5.6,17.7,-39969,-0.5,34.4,0,1750,2777,260308
1992,g) 250 to 499,15231,98342,4971957,5006727,9160,9.4,6852,7.1,784288,320459,463829,6.4,15.7,853828,272388,581440,5.4,17.1,-69540,-1.4,31.4,0,404,705,136999
1992,h) 500 to 999,7116,81659,4609305,4627119,7922,9.8,5972,7.4,657276,250124,407152,5.4,14.2,692906,196224,496682,4.2,15,-35630,-0.8,28.4,0,100,762,65000
1992,i) 1000 to 2499,4730,109247,6641647,6654826,10750,9.9,8438,7.8,857480,279485,577995,4.2,12.9,883838,263874,619964,4,13.3,-26358,-0.4,25.8,0,29,391,41462
1992,j) 2500 to 4999,1634,79523,4697610,4707179,6421,8,7068,8.9,593193,191163,402030,4.1,12.6,612332,194181,418151,4.1,13,-19139,-0.4,25.2,0,10,138,33943
1992,k) 5000 to 9999,981,93117,4807937,4848171,6535,7,6741,7.2,583554,201637,381917,4.2,12,664022,170376,493646,3.5,13.7,-80468,-1.7,24,0,3,3,20499
1992,l) 10000+,1188,356456,21842436,22069911,27806,7.7,34145,9.5,2695139,990121,1705018,4.5,12.2,3150088,980375,2169713,4.4,14.3,-454949,-2.1,24.4,1,1,12,
1993,a) 1 to 4,2448847,2453552,6161787,5622643,410744,16.9,343174,14.1,2108683,760575,1348108,13.5,37.5,1030395,619136,411259,11,18.3,1078288,19.2,36.6,0,270919,271133,498043
1993,b) 5 to 9,947793,965951,6429466,6263399,90519,9.5,73021,7.6,1473578,579143,894435,9.2,23.5,1141444,460050,681394,7.3,18.2,332134,5.3,36.4,0,59628,59950,385703
1993,c) 10 to 19,544547,596682,7394974,7317143,40838,6.9,38702,6.5,1416191,518053,898138,7.1,19.4,1260528,462269,798259,6.3,17.2,155663,2.2,34.4,0,28468,28924,376220
1993,d) 20 to 49,327673,427291,9897535,9852096,22282,5.2,24730,5.8,1668674,569311,1099363,5.8,16.9,1577796,541576,1036220,5.5,16,90878,0.9,32,0,14140,14761,414948
1993,e) 50 to 99,100343,189877,6901097,6879040,8852,4.6,10445,5.5,1078994,328377,750617,4.8,15.7,1034880,325598,709282,4.7,15,44114,0.7,30,0,3263,3687,219793
1993,f) 100 to 249,52833,176126,7928251,7924479,9705,5.5,11254,6.4,1196497,356389,840108,4.5,15.1,1188953,380033,808920,4.8,15,7544,0.1,30,0,1353,2046,199380
1993,g) 250 to 499,15307,100110,5157282,5157423,7700,7.7,7952,7.9,815457,274771,540686,5.3,15.8,815738,253131,562607,4.9,15.8,-281,0,31.6,0,296,984,101712
1993,h) 500 to 999,7148,83466,4848387,4783426,6345,7.6,6285,7.5,794839,203766,591073,4.3,16.6,664918,177000,487918,3.7,13.9,129921,2.7,27.8,0,63,239,41119
1993,i) 1000 to 2499,4679,106588,6682424,6671763,7602,7.1,8587,8,814429,229692,584737,3.4,12.2,793107,225874,567233,3.4,11.9,21322,0.3,23.8,0,22,93,34152
1993,j) 2500 to 4999,1657,86673,5005629,5009211,6869,8,5893,6.8,576377,180829,395548,3.6,11.5,583541,173008,410533,3.5,11.6,-7164,-0.1,23,0,5,10,18904
1993,k) 5000 to 9999,893,86721,4927815,4934210,5510,6.3,6342,7.3,569420,167866,401554,3.4,11.5,582211,146083,436128,3,11.8,-12791,-0.3,23,1,1,217,
1993,l) 10000+,1217,352528,21914756,22027328,28502,8,38149,10.7,2795764,934631,1861133,4.2,12.7,3020907,909729,2111178,4.1,13.7,-225143,-1,25.4,0,,,
1994,a) 1 to 4,2491487,2497223,6086678,5624178,424367,17.2,349162,14.2,2002816,784866,1217950,14,35.6,1077815,635342,442473,11.3,19.2,925001,16.4,38.4,0,274343,274432,507193
1994,b) 5 to 9,962639,980704,6487859,6351797,91121,9.4,76123,7.8,1459201,581416,877785,9.2,23,1187077,479209,707868,7.5,18.7,272124,4.3,37.4,0,60463,60670,391534
1994,c) 10 to 19,553095,602094,7533056,7443647,44546,7.4,40518,6.7,1472371,548579,923792,7.4,19.8,1293552,481390,812162,6.5,17.4,178819,2.4,34.8,0,28517,28746,377614
1994,d) 20 to 49,333140,432055,10135886,10045351,28053,6.5,25613,5.9,1773694,636023,1137671,6.3,17.7,1592623,565060,1027563,5.6,15.9,181071,1.8,31.8,0,14309,14785,420415
1994,e) 50 to 99,102557,192073,7112175,7051690,11889,6.2,10292,5.4,1156609,401101,755508,5.7,16.4,1035638,339884,695754,4.8,14.7,120971,1.7,29.4,0,3271,3573,219549
1994,f) 100 to 249,54017,178235,8184781,8135471,10910,6.1,9565,5.4,1244909,426743,818166,5.2,15.3,1146288,384942,761346,4.7,14.1,98621,1.2,28.2,0,1406,1905,209801
1994,g) 250 to 499,15653,102816,5330714,5301082,8746,8.6,6369,6.3,844267,311520,532747,5.9,15.9,785003,259081,525922,4.9,14.8,59264,1.1,29.6,0,347,771,118627
1994,h) 500 to 999,7253,82990,4879270,4839419,7781,9.5,5488,6.7,672256,219839,452417,4.5,13.9,592554,162791,429763,3.4,12.2,79702,1.7,24.4,0,72,168,47695
1994,i) 1000 to 2499,4795,111446,6880669,6835969,10576,9.6,7872,7.2,855339,275483,579856,4,12.5,765939,217311,548628,3.2,11.2,89400,1.3,22.4,0,29,309,46462
1994,j) 2500 to 4999,1715,90563,5099204,5072466,7848,8.8,5497,6.2,585076,202073,383003,4,11.5,531600,159295,372305,3.1,10.5,53476,1,21,0,11,62,35939
1994,k) 5000 to 9999,953,90287,5027995,5025299,8058,9.1,5620,6.3,579211,186564,392647,3.7,11.5,573818,162488,411330,3.2,11.4,5393,0.1,22.8,0,3,3,22054
1994,l) 10000+,1253,361614,22186826,22293871,33633,9.4,30276,8.4,2668475,1008032,1660443,4.5,12,2882564,836168,2046396,3.8,12.9,-214089,-0.9,24,1,1,1,
1995,a) 1 to 4,2555836,2561510,6234037,5731963,438957,17.4,352304,13.9,2055120,810477,1244643,14.1,35.9,1050972,632349,418623,11,18.3,1004148,17.6,36.6,0,277769,277973,507299
1995,b) 5 to 9,971022,989042,6615645,6429212,94951,9.7,75263,7.7,1507849,606051,901798,9.4,23.5,1134982,474250,660732,7.4,17.7,372867,5.8,35.4,0,60282,60578,390870
1995,c) 10 to 19,559375,605795,7722380,7568255,45178,7.5,39991,6.6,1515193,565381,949812,7.5,20,1206943,474709,732234,6.3,15.9,308250,4.1,31.8,0,28725,29121,380322
1995,d) 20 to 49,339887,435941,10521476,10337356,27377,6.3,26018,6,1840222,638923,1201299,6.2,17.8,1471981,559614,912367,5.4,14.2,368241,3.6,28.4,0,14162,14756,414552
1995,e) 50 to 99,104614,191969,7368587,7255984,11401,6,10494,5.5,1190868,403659,787209,5.6,16.4,965662,347027,618635,4.8,13.3,225206,3.1,26.6,0,3319,3718,224495
1995,f) 100 to 249,55837,178569,8575513,8457018,11775,6.6,9777,5.5,1355370,468984,886386,5.5,16,1118379,389460,728919,4.6,13.2,236991,2.8,26.4,0,1392,1823,202203
1995,g) 250 to 499,16038,105488,5544697,5467435,9795,9.4,6692,6.4,890444,327249,563195,6,16.3,735919,239976,495943,4.4,13.5,154525,2.8,27,0,309,755,104912
1995,h) 500 to 999,7505,86393,5127726,5054794,7689,9,5202,6.1,742903,258877,484026,5.1,14.7,597040,168433,428607,3.3,11.8,145863,2.9,23.6,0,76,268,50493
1995,i) 1000 to 2499,4830,116394,7133716,7034830,11009,9.6,6981,6.1,924733,296087,628646,4.2,13.1,726960,194948,532012,2.8,10.3,197773,2.8,20.6,0,25,25,39625
1995,j) 2500 to 4999,1739,89202,5343774,5275519,9829,11.2,6399,7.3,658112,231043,427069,4.4,12.5,521602,138873,382729,2.6,9.9,136510,2.6,19.8,0,3,4,9971
1995,k) 5000 to 9999,977,91917,5126865,5051753,7682,8.5,5442,6,677413,241262,436151,4.8,13.4,527188,129374,397814,2.6,10.4,150225,3,20.8,1,1,1,
1995,l) 10000+,1341,384389,23171050,22992826,36361,9.5,30512,8,2868481,1053578,1814903,4.6,12.5,2512035,688126,1823909,3,10.9,356446,1.6,21.8,0,,,
1996,a) 1 to 4,2585887,2591564,6244319,5778918,436892,17.1,367437,14.3,2015623,806713,1208910,14,34.9,1084821,659071,425750,11.4,18.8,930802,16.1,37.6,0,287176,287189,524811
1996,b) 5 to 9,985296,1002674,6647628,6502917,94974,9.5,78285,7.9,1470384,606832,863552,9.3,22.6,1180961,493121,687840,7.6,18.2,289423,4.4,36.4,0,62709,62726,406229
1996,c) 10 to 19,571744,616159,7785092,7696457,45636,7.4,41455,6.7,1461019,567749,893270,7.4,19,1283748,494839,788909,6.4,16.7,177271,2.3,33.4,0,30133,30154,399574
1996,d) 20 to 49,351765,445252,10669678,10611234,28062,6.3,27013,6.1,1750417,651993,1098424,6.1,16.5,1633529,595657,1037872,5.6,15.4,116888,1.1,30.8,0,15087,15099,444185
1996,e) 50 to 99,109221,195146,7504872,7498904,11110,5.7,10841,5.6,1115118,401912,713206,5.4,14.9,1103181,373666,729515,5,14.7,11937,0.2,29.4,0,3527,3536,240093
1996,f) 100 to 249,58078,179101,8704809,8727221,10536,5.9,9956,5.6,1229231,433399,795832,5,14.1,1274055,422345,851710,4.8,14.6,-44824,-0.5,28.2,0,1536,1557,225395
1996,g) 250 to 499,16744,107622,5634795,5631444,10686,10.1,6640,6.3,868816,354429,514387,6.3,15.4,862113,268623,593490,4.8,15.3,6703,0.1,30.6,0,319,319,108078
1996,h) 500 to 999,7848,90918,5269004,5230979,8123,9.1,5701,6.4,743159,282524,460635,5.4,14.2,667109,185940,481169,3.6,12.8,76050,1.4,25.6,0,68,69,44429
1996,i) 1000 to 2499,4991,114868,7200584,7163064,10617,9.3,8121,7.1,919025,320861,598164,4.5,12.8,843985,235111,608874,3.3,11.8,75040,1,23.6,0,24,24,34868
1996,j) 2500 to 4999,1936,95381,5698515,5663556,7995,8.4,6695,7.1,702448,236193,466255,4.2,12.4,632529,173541,458988,3.1,11.2,69919,1.2,22.4,0,4,4,11826
1996,k) 5000 to 9999,1032,96044,5269072,5260649,8517,8.9,7761,8.1,667799,215124,452675,4.1,12.7,650954,189176,461778,3.6,12.4,16845,0.3,24.8,0,,,
1996,l) 10000+,1355,396412,23716182,23695837,38568,9.8,33645,8.5,3099462,1185442,1914020,5,13.1,3058772,937618,2121154,4,12.9,40690,0.2,25.8,1,2,2,
1997,a) 1 to 4,2627242,2632449,6389684,5888557,445501,17.1,376525,14.5,2097447,824732,1272715,14,35.6,1095192,674590,420602,11.5,18.6,1002255,17,37.2,0,293063,293063,535163
1997,b) 5 to 9,995063,1010642,6764610,6604962,95129,9.5,83741,8.3,1524740,606116,918624,9.2,23.1,1205443,519431,686012,7.9,18.3,319297,4.8,36.6,0,65323,65323,423855
1997,c) 10 to 19,580448,623750,7955380,7840832,49183,7.9,47001,7.5,1557938,582036,975902,7.4,19.9,1328842,537232,791610,6.9,16.9,229096,3,33.8,0,31636,31637,420572
1997,d) 20 to 49,358634,456987,11001830,10870374,36868,8.1,34064,7.5,2001405,700826,1300579,6.4,18.4,1738493,672853,1065640,6.2,16,262912,2.4,32,0,16348,16350,481403
1997,e) 50 to 99,112523,205187,7792193,7715700,20580,10.2,15461,7.6,1388485,486528,901957,6.3,18,1235499,450806,784693,5.8,16,152986,2,32,0,4153,4156,281154
1997,f) 100 to 249,59754,189699,8996241,8915104,22867,12.3,14971,8.1,1633467,618811,1014656,6.9,18.3,1471193,514436,956757,5.8,16.5,162274,1.8,33,0,1646,1646,241394
1997,g) 250 to 499,16938,111132,5763031,5704054,12637,11.6,7593,7,1010544,412934,597610,7.2,17.7,892590,317489,575101,5.6,15.6,117954,2.1,31.2,0,380,380,127684
1997,h) 500 to 999,7900,92201,5340348,5272232,10165,11.3,6516,7.2,858085,311871,546214,5.9,16.3,721853,225094,496759,4.3,13.7,136232,2.6,27.4,0,76,76,50454
1997,i) 1000 to 2499,5067,117372,7288452,7282863,13233,11.4,10508,9.1,1036259,354331,681928,4.9,14.2,1025081,331425,693656,4.6,14.1,11178,0.1,28.2,0,43,43,64336
1997,j) 2500 to 4999,1878,97133,5633399,5627896,9896,10.2,9012,9.3,809271,305405,503866,5.4,14.4,798267,254586,543681,4.5,14.2,11004,0.2,28.4,0,6,6,19561
1997,k) 5000 to 9999,997,105562,5502988,5485259,12196,11.6,11133,10.6,814889,301842,513047,5.5,14.9,779431,251108,528323,4.6,14.2,35458,0.7,28.4,0,3,3,24928
1997,l) 10000+,1288,399433,24756583,24615271,45641,11.4,46158,11.5,3784355,1370245,2414110,5.6,15.4,3501730,1243334,2258396,5.1,14.2,282625,1.2,28.4,1,1,1,
1998,a) 1 to 4,2638970,2642138,6369669,5913515,433199,16.5,387579,14.8,2039217,797874,1241343,13.5,34.5,1126908,694417,432491,11.7,19.1,912309,15.4,38.2,0,302724,302724,552165
1998,b) 5 to 9,1002917,1016903,6782965,6647051,91323,9,81499,8,1486317,587552,898765,8.8,22.4,1214489,517607,696882,7.8,18.3,271828,4.1,36.6,0,65362,65362,423581
1998,c) 10 to 19,586254,627966,8031136,7923157,44113,7,43156,6.9,1536418,574287,962131,7.2,19.4,1320459,525637,794822,6.6,16.7,215959,2.7,33.4,0,31540,31540,419199
1998,d) 20 to 49,364318,458935,11160857,11029972,26453,5.7,28155,6.1,1945119,694976,1250143,6.3,17.6,1683348,640071,1043277,5.8,15.3,261771,2.3,30.6,0,16196,16196,476121
1998,e) 50 to 99,114141,205005,7933636,7846358,10878,5.3,11433,5.6,1304468,454085,850383,5.8,16.6,1129912,398350,731562,5.1,14.4,174556,2.2,28.8,0,3896,3896,263677
1998,f) 100 to 249,61231,192197,9283605,9189347,13625,7.1,10933,5.7,1535878,575460,960418,6.3,16.7,1347361,459163,888198,5,14.7,188517,2,29.4,0,1637,1657,240482
1998,g) 250 to 499,17595,115083,6033691,5969176,11633,10.3,7796,6.9,1058915,427845,631070,7.2,17.7,929884,317534,612350,5.3,15.6,129031,2.1,31.2,0,403,403,135980
1998,h) 500 to 999,8180,95896,5510448,5463368,9598,10.1,7282,7.7,866132,318260,547872,5.8,15.9,771973,256822,515151,4.7,14.1,94159,1.8,28.2,0,109,109,73876
1998,i) 1000 to 2499,5144,124132,7496441,7399962,13033,10.7,8659,7.1,1088555,410347,678208,5.5,14.7,895596,286641,608955,3.9,12.1,192959,2.6,24.2,0,38,38,53438
1998,j) 2500 to 4999,1891,93303,5743788,5657437,10266,11.2,7412,8.1,814338,277229,537109,4.9,14.4,641636,198055,443581,3.5,11.3,172702,3.1,22.6,0,3,3,11871
1998,k) 5000 to 9999,1030,112104,5877020,5753744,12171,11.1,8254,7.5,897722,296636,601086,5.2,15.6,651172,176847,474325,3.1,11.3,246550,4.3,22.6,0,,,
1998,l) 10000+,1323,424662,26049642,25891957,49792,11.8,41645,9.9,3453900,1235003,2218897,4.8,13.3,3138530,1052026,2086504,4.1,12.1,315370,1.2,24.2,1,1,1,
1999,a) 1 to 4,2651228,2655397,6431505,5962877,420956,15.9,386687,14.6,2059393,781143,1278250,13.1,34.5,1122137,691741,430396,11.6,18.8,937256,15.7,37.6,0,297221,297221,541488
1999,b) 5 to 9,1005317,1018861,6819231,6684572,87758,8.6,80088,7.9,1473869,563602,910267,8.4,22,1204550,510884,693666,7.6,18,269319,4,36,0,63821,63821,413556
1999,c) 10 to 19,591416,630123,8098419,8011594,42692,6.8,42620,6.8,1486524,547948,938576,6.8,18.6,1312874,531602,781272,6.6,16.4,173650,2.2,32.8,0,31877,31877,422846
1999,d) 20 to 49,369348,460071,11314331,11226242,26659,5.8,28188,6.1,1853852,671037,1182815,6,16.5,1677673,664028,1013645,5.9,14.9,176179,1.6,29.8,0,16655,16655,491134
1999,e) 50 to 99,115888,203477,8099735,8037873,11474,5.6,11934,5.9,1248240,456927,791313,5.7,15.5,1124516,430957,693559,5.4,14,123724,1.5,28,0,4141,4141,279824
1999,f) 100 to 249,61899,193976,9434765,9378273,15350,8,11389,5.9,1481453,578570,902883,6.2,15.8,1368469,512275,856194,5.5,14.6,112984,1.2,29.2,0,1875,1875,278414
1999,g) 250 to 499,17847,115645,6145731,6094040,11782,10.4,7354,6.5,1005531,416654,588877,6.8,16.5,902149,312063,590086,5.1,14.8,103382,1.7,29.6,0,370,370,125048
1999,h) 500 to 999,8328,97577,5639204,5580857,9913,10.3,7386,7.7,885601,337254,548347,6,15.9,768907,241941,526966,4.3,13.8,116694,2.1,27.6,0,85,85,55466
1999,i) 1000 to 2499,5293,128597,7726461,7632345,15434,12.3,9442,7.5,1117859,420937,696922,5.5,14.6,929627,290532,639095,3.8,12.2,188232,2.4,24.4,0,34,34,48728
1999,j) 2500 to 4999,1939,96735,5793861,5766766,9543,10,7022,7.3,789339,296195,493144,5.1,13.7,735150,219299,515851,3.8,12.7,54189,1,25.4,0,4,4,14414
1999,k) 5000 to 9999,1198,116933,6253176,6180238,13804,12,9478,8.3,971537,389868,581669,6.3,15.7,825660,244395,581265,4,13.4,145877,2.3,26.8,1,2,2,
1999,l) 10000+,1429,456355,27307361,27287695,50084,11.1,41592,9.2,3733794,1353147,2380647,5,13.7,3694463,1250070,2444393,4.6,13.5,39331,0.2,27,0,,,
2000,a) 1 to 4,2638594,2643281,6423532,5970924,403906,15.3,398196,15.1,2035471,758330,1277141,12.7,34.1,1130254,708829,421425,11.9,18.9,905217,15.2,37.8,0,291771,291771,528949
2000,b) 5 to 9,1008992,1023395,6903358,6739530,89104,8.7,81134,8,1515689,571815,943874,8.5,22.5,1188032,516132,671900,7.7,17.6,327657,4.9,35.2,0,61964,61964,401529
2000,c) 10 to 19,599999,638682,8309903,8173185,44333,7,42590,6.7,1570893,563944,1006949,6.9,19.2,1297456,529829,767627,6.5,15.9,273437,3.3,31.8,0,30702,30702,407528
2000,d) 20 to 49,376817,465361,11670107,11497687,28430,6.1,26794,5.8,1977438,706667,1270771,6.1,17.2,1632597,639100,993497,5.6,14.2,344841,3,28.4,0,15763,15763,463806
2000,e) 50 to 99,118452,203543,8402805,8267778,11216,5.5,10917,5.4,1356649,480143,876506,5.8,16.4,1086594,410055,676539,5,13.1,270055,3.3,26.2,0,3886,3886,261430
2000,f) 100 to 249,62960,195467,9738582,9590262,16259,8.4,10639,5.5,1590975,579045,1011930,6,16.6,1294334,453143,841191,4.7,13.5,296641,3.1,27,0,1565,1578,231809
2000,g) 250 to 499,17992,116964,6256993,6157973,11544,10,7784,6.8,1050597,419533,631064,6.8,17.1,852557,293040,559517,4.8,13.8,198040,3.3,27.6,0,339,339,116092
2000,h) 500 to 999,8470,99475,5750926,5674934,9953,10.2,6909,7.1,911569,336493,575076,5.9,16.1,759586,247699,511887,4.4,13.4,151983,2.7,26.8,0,101,101,66661
2000,i) 1000 to 2499,5360,127927,7850458,7754103,13171,10.5,9275,7.4,1134232,405353,728879,5.2,14.6,941521,296909,644612,3.8,12.1,192711,2.5,24.2,0,29,29,42059
2000,j) 2500 to 4999,2033,98497,5936918,5892705,8982,9.2,8021,8.2,858529,306398,552131,5.2,14.6,770102,261014,509088,4.4,13.1,88427,1.5,26.2,0,11,11,38704
2000,k) 5000 to 9999,1099,115489,6048692,6000251,10831,9.4,11762,10.2,881977,302162,579815,5,14.7,785095,247786,537309,4.1,13.1,96882,1.6,26.2,1,2,2,
2000,l) 10000+,1561,490703,29314769,29108207,58567,12.1,48652,10,4395261,1630602,2764659,5.6,15.1,3982138,1462580,2519558,5,13.7,413123,1.4,27.4,1,1,1,
2001,a) 1 to 4,2642459,2647623,6309776,5929159,413177,15.7,417103,15.8,1944301,769371,1174930,13,32.8,1183067,743038,440029,12.5,20,761234,12.8,40,0,288020,288062,523352
2001,b) 5 to 9,1018033,1033473,6836724,6752857,89176,8.7,85398,8.3,1437099,568442,868657,8.4,21.3,1269365,543903,725462,8.1,18.8,167734,2.5,37.6,0,62393,62450,404839
2001,c) 10 to 19,611865,651235,8284679,8264615,44385,6.8,44740,6.9,1457800,551632,906168,6.7,17.6,1417671,557584,860087,6.7,17.2,40129,0.4,34.4,0,31054,31107,412426
2001,d) 20 to 49,387996,475139,11761929,11734640,29092,6.1,27659,5.8,1866891,690705,1176186,5.9,15.9,1812312,666510,1145802,5.7,15.4,54579,0.5,30.8,0,16053,16157,473858
2001,e) 50 to 99,122969,208094,8438679,8451978,12772,6.2,10922,5.3,1209421,447955,761466,5.3,14.3,1236018,422531,813487,5,14.6,-26597,-0.3,28.6,0,3971,4007,268841
2001,f) 100 to 249,65534,199229,9837405,9837284,16725,8.5,11479,5.8,1478344,594840,883504,6,15,1478101,469846,1008255,4.8,15,243,0,30,0,1616,1629,235395
2001,g) 250 to 499,18864,118598,6355026,6380353,10456,8.9,7919,6.8,939939,363165,576774,5.7,14.7,990593,312502,678091,4.9,15.5,-50654,-0.8,29.4,0,375,426,127636
2001,h) 500 to 999,8731,101085,5816960,5828327,8927,8.9,7175,7.2,803169,266465,536704,4.6,13.8,825902,240599,585303,4.1,14.2,-22733,-0.4,27.6,0,76,76,52626
2001,i) 1000 to 2499,5402,130523,7784575,7772133,13412,10.4,9726,7.6,1079501,403503,675998,5.2,13.9,1054616,308189,746427,4,13.6,24885,0.3,27.2,0,33,33,50528
2001,j) 2500 to 4999,2047,95786,6098595,6076777,10329,10.9,9046,9.5,866123,324462,541661,5.3,14.3,822487,255813,566674,4.2,13.5,43636,0.8,27,0,8,8,29297
2001,k) 5000 to 9999,1223,126810,6366297,6390142,14549,11.6,10984,8.8,946985,399055,547930,6.2,14.8,994676,337036,657640,5.3,15.6,-47691,-0.8,29.6,0,3,3,17044
2001,l) 10000+,1639,520935,30119352,30152720,58735,11.5,44275,8.6,4259633,1630163,2629470,5.4,14.1,4326369,1264616,3061753,4.2,14.3,-66736,-0.2,28.2,0,,,
2002,a) 1 to 4,2670142,2674988,6436935,5974812,464717,17.5,431383,16.2,2120595,878147,1242448,14.7,35.5,1196348,756604,439744,12.7,20,924247,15.5,40,0,284259,284341,514973
2002,b) 5 to 9,1015760,1028500,6749595,6673049,95219,9.3,86115,8.4,1463358,606578,856780,9.1,21.9,1310265,535340,774925,8,19.6,153093,2.3,39.2,0,61072,61194,396836
2002,c) 10 to 19,613885,650700,8206951,8188216,52126,8,49735,7.7,1566353,633444,932909,7.7,19.1,1528883,574523,954360,7,18.7,37470,0.4,37.4,0,30333,30484,404560
2002,d) 20 to 49,392323,480633,11582336,11634049,40461,8.5,36576,7.6,2044707,865601,1179106,7.4,17.6,2148132,755699,1392433,6.5,18.5,-103425,-0.9,35.2,0,16251,16512,477794
2002,e) 50 to 99,125122,213473,8245409,8346548,21587,10.2,17037,8.1,1415078,647951,767127,7.8,17,1617356,535996,1081360,6.4,19.4,-202278,-2.4,34,0,4226,4443,285727
2002,f) 100 to 249,67116,203666,9641831,9764769,20421,10.2,15119,7.5,1660984,803606,857378,8.2,17,1906859,618650,1288209,6.3,19.5,-245875,-2.5,34,0,1879,2117,278763
2002,g) 250 to 499,19244,123347,6190307,6271333,11247,9.2,8765,7.2,1015769,515385,500384,8.2,16.2,1177820,359818,818002,5.7,18.8,-162051,-2.6,32.4,0,374,466,128359
2002,h) 500 to 999,8790,100271,5626690,5727043,8611,8.6,8085,8.1,800124,321895,478229,5.6,14,1000830,270965,729865,4.7,17.5,-200706,-3.5,28,0,98,138,64194
2002,i) 1000 to 2499,5503,125505,7490856,7651347,10718,8.5,12412,9.8,1021301,370865,650436,4.8,13.3,1342283,450795,891488,5.9,17.5,-320982,-4.2,26.6,0,43,102,67210
2002,j) 2500 to 4999,2068,99917,5844283,5942877,8651,8.7,8840,8.8,775774,272030,503744,4.6,13.1,972962,306846,666116,5.2,16.4,-197188,-3.3,26.2,0,11,16,34159
2002,k) 5000 to 9999,1186,114349,6116209,6230421,11663,10.2,12224,10.7,843724,351073,492651,5.6,13.5,1072148,370312,701836,5.9,17.2,-228424,-3.7,27,0,5,26,37608
2002,l) 10000+,1510,537372,29696014,30293568,59897,11.1,65365,12.1,4283321,1721817,2561504,5.7,14.1,5478430,1859722,3618708,6.1,18.1,-1195109,-4,28.2,0,,,
2003,a) 1 to 4,2726801,2730252,6692358,6144552,479031,17.7,391360,14.5,2251403,880883,1370520,14.3,36.6,1155790,694694,461096,11.3,18.8,1095613,17.8,37.6,0,293012,293032,531367
2003,b) 5 to 9,1017708,1031292,6914251,6742053,90624,8.8,71147,6.9,1524022,581781,942241,8.6,22.6,1179626,456822,722804,6.8,17.5,344396,5.1,35,0,58409,58458,379238
2003,c) 10 to 19,613728,651143,8369379,8270682,43688,6.7,36574,5.6,1548560,552635,995925,6.7,18.7,1351166,468106,883060,5.7,16.3,197394,2.4,32.6,0,29530,29616,392753
2003,d) 20 to 49,387056,476974,11786368,11679829,26678,5.6,21409,4.5,1928260,656883,1271377,5.6,16.5,1715181,559649,1155532,4.8,14.7,213079,1.8,29.4,0,15476,15608,457787
2003,e) 50 to 99,120175,208114,8359184,8260669,10963,5.3,7520,3.6,1323316,436090,887226,5.3,16,1126286,350418,775868,4.2,13.6,197030,2.4,27.2,0,3964,4299,269369
2003,f) 100 to 249,64102,202061,9793410,9694398,10509,5.3,5945,3,1508320,498532,1009788,5.1,15.6,1310295,430122,880173,4.4,13.5,198025,2.1,27,0,2013,2194,305230
2003,g) 250 to 499,18547,123552,6270986,6258875,9822,8.1,4543,3.8,995809,403474,592335,6.4,15.9,971587,306493,665094,4.9,15.5,24222,0.4,31,0,524,740,179702
2003,h) 500 to 999,8524,104811,5679453,5644228,8274,8,4224,4.1,837767,308049,529718,5.5,14.8,767317,181631,585686,3.2,13.6,70450,1.2,27.2,0,94,210,64318
2003,i) 1000 to 2499,5305,124875,7545158,7528349,10122,8.3,4323,3.5,980914,350244,630670,4.7,13,947296,223792,723504,3,12.6,33618,0.4,25.2,0,46,366,73711
2003,j) 2500 to 4999,1982,103057,5875268,5888181,8401,8.3,5215,5.1,759227,247137,512090,4.2,12.9,785054,174044,611010,3,13.3,-25827,-0.4,25.8,0,9,606,30409
2003,k) 5000 to 9999,1087,115161,6014771,6030602,9623,8.5,5205,4.6,783412,296930,486482,4.9,13,815075,169192,645883,2.8,13.5,-31663,-0.5,26,1,1,1,
2003,l) 10000+,1537,543728,29108526,29222140,61579,11.5,40478,7.6,3698668,1470283,2228385,5,12.7,3925896,1097288,2828608,3.8,13.4,-227228,-0.7,25.4,1,2,2,
2004,a) 1 to 4,2773296,2777680,6752294,6214772,479895,17.5,391882,14.3,2203128,872856,1330272,14,35.4,1128084,695475,432609,11.2,18.2,1075044,17.2,36.4,0,293935,293967,534356
2004,b) 5 to 9,1031083,1044545,7017875,6838031,89610,8.6,71915,6.9,1514733,571130,943603,8.4,22.2,1155045,459644,695401,6.7,16.9,359688,5.3,33.8,0,59165,59179,382416
2004,c) 10 to 19,620330,657539,8488678,8372215,43570,6.7,36844,5.6,1540447,553358,987089,6.6,18.4,1307520,470848,836672,5.6,15.6,232927,2.8,31.2,0,29517,29579,393018
2004,d) 20 to 49,391189,478184,11862405,11783349,25377,5.3,22261,4.7,1832567,635613,1196954,5.4,15.6,1674455,567323,1107132,4.8,14.2,158112,1.4,28.4,0,15523,15721,458265
2004,e) 50 to 99,122924,209625,8474281,8424664,9545,4.6,7951,3.8,1209728,431286,778442,5.1,14.4,1110494,360112,750382,4.3,13.2,99234,1.2,26.4,0,3979,4286,272333
2004,f) 100 to 249,66359,203377,10023269,9981527,9248,4.6,6850,3.4,1334831,502321,832510,5,13.4,1251347,425018,826329,4.3,12.5,83484,0.9,25,0,1950,2432,291291
2004,g) 250 to 499,19369,127652,6573829,6540056,9617,7.7,4639,3.7,983148,405158,577990,6.2,15,915602,280731,634871,4.3,14,67546,1,28,0,498,601,168714
2004,h) 500 to 999,8620,104946,5735653,5720458,7577,7.3,4034,3.9,712726,213948,498778,3.7,12.5,682337,168332,514005,2.9,11.9,30389,0.6,23.8,0,100,409,67556
2004,i) 1000 to 2499,5407,128816,7663904,7617982,9350,7.4,4765,3.8,937667,304892,632775,4,12.3,845823,209795,636028,2.8,11.1,91844,1.2,22.2,0,30,36,44660
2004,j) 2500 to 4999,1936,107878,5953890,5921635,10209,9.7,5137,4.9,743050,244443,498607,4.1,12.5,678540,174950,503590,3,11.5,64510,1,23,0,8,8,25901
2004,k) 5000 to 9999,1112,112353,6405072,6384358,9782,8.9,6478,5.9,826281,255712,570569,4,12.9,784853,217940,566913,3.4,12.3,41428,0.6,24.6,0,4,4,25577
2004,l) 10000+,1444,544819,28756480,28800130,56309,10.4,50710,9.4,3796869,1280246,2516623,4.4,13.2,3884169,1315238,2568931,4.6,13.5,-87300,-0.3,26.4,0,3,3,46330
2005,a) 1 to 4,2824230,2829355,6677237,6212064,495068,17.7,396064,14.2,2125764,889555,1236209,14.3,34.2,1195417,697618,497799,11.2,19.2,930347,15,38.4,0,301659,301681,546365
2005,b) 5 to 9,1051210,1065935,6975297,6876491,92060,8.7,71894,6.8,1453218,589040,864178,8.6,21.1,1255606,457781,797825,6.7,18.3,197612,2.8,36.6,0,60912,60982,394319
2005,c) 10 to 19,635205,673376,8477026,8451594,46563,7,37126,5.5,1498092,591851,906241,7,17.7,1447228,471059,976169,5.6,17.1,50864,0.6,34.2,0,30452,30569,405921
2005,d) 20 to 49,400843,487843,11906235,11923183,27313,5.6,22426,4.6,1813572,690125,1123447,5.8,15.2,1847467,567545,1279922,4.8,15.5,-33895,-0.3,30.4,0,15902,16224,468293
2005,e) 50 to 99,126127,213258,8594253,8587926,10992,5.2,8060,3.8,1220580,442376,778204,5.2,14.2,1207926,364453,843473,4.2,14.1,12654,0.1,28.2,0,4115,4341,280901
2005,f) 100 to 249,67525,206280,10283235,10200626,12433,6.1,6650,3.3,1473741,556414,917327,5.5,14.4,1308522,432728,875794,4.2,12.8,165219,1.6,25.6,0,1973,2292,293478
2005,g) 250 to 499,19646,129143,6682066,6636964,11000,8.8,4062,3.2,1011403,405716,605687,6.1,15.2,921198,293005,628193,4.4,13.9,90205,1.3,27.8,0,553,687,190160
2005,h) 500 to 999,8693,108991,5858984,5783572,10842,10.3,3192,3,832043,311198,520845,5.4,14.4,681219,193784,487435,3.4,11.8,150824,2.6,23.6,0,147,191,103189
2005,i) 1000 to 2499,5438,134945,7897690,7839890,12815,9.7,6769,5.1,1015756,378384,637372,4.8,13,900156,286567,613589,3.7,11.5,115600,1.5,23,0,89,279,133767
2005,j) 2500 to 4999,1964,106478,6109085,6023600,10107,9.7,4865,4.7,816578,330283,486295,5.5,13.6,645609,199254,446355,3.3,10.7,170969,2.9,21.4,0,19,19,66059
2005,k) 5000 to 9999,1119,116007,6459204,6410840,9280,8.2,4810,4.2,843387,337059,506328,5.3,13.2,746658,174900,571758,2.7,11.6,96729,1.6,23.2,0,6,6,39372
2005,l) 10000+,1359,561532,29219771,29130757,62777,11.4,42292,7.7,3593373,1389457,2203916,4.8,12.3,3415346,951953,2463393,3.3,11.7,178027,0.6,23.4,1,3,3,
2006,a) 1 to 4,2866311,2872119,6853305,6362090,495173,17.3,444938,15.6,2198304,878552,1319752,13.8,34.6,1215873,768417,447456,12.1,19.1,982431,15.5,38.2,0,325799,325855,582427
2006,b) 5 to 9,1055605,1071573,7142480,6998761,90659,8.5,77616,7.3,1499928,582006,917922,8.3,21.4,1212489,495338,717151,7.1,17.3,287439,4.1,34.6,0,64359,64412,417278
2006,c) 10 to 19,633575,672999,8699046,8555291,48206,7.2,39323,5.9,1602524,601688,1000836,7,18.7,1315013,501443,813570,5.9,15.4,287511,3.3,30.8,0,31881,31997,423924
2006,d) 20 to 49,397323,489269,12237767,12045513,34304,7.1,23618,4.9,2040752,738585,1302167,6.1,16.9,1656244,607134,1049110,5,13.7,384508,3.2,27.4,0,16943,17195,503142
2006,e) 50 to 99,125503,216477,8747914,8635860,16804,7.9,8404,4,1350248,525724,824524,6.1,15.6,1126139,412509,713630,4.8,13,224109,2.6,26,0,4813,5010,328439
2006,f) 100 to 249,68337,211567,10495330,10359237,17894,8.7,6863,3.3,1588965,666858,922107,6.4,15.3,1316778,520747,796031,5,12.7,272187,2.6,25.4,0,2571,2856,388226
2006,g) 250 to 499,20007,135821,6859337,6769728,15397,11.8,4525,3.5,1126010,510407,615603,7.5,16.6,946792,332477,614315,4.9,14,179218,2.6,28,0,677,875,229241
2006,h) 500 to 999,8936,111288,6131379,6031531,9851,9.1,3988,3.7,892345,320645,571700,5.3,14.8,692649,202053,490596,3.3,11.5,199696,3.3,23,0,157,310,104580
2006,i) 1000 to 2499,5400,131841,8096056,7968142,11333,8.8,4995,3.9,1044577,344834,699743,4.3,13.1,788748,210404,578344,2.6,9.9,255829,3.2,19.8,0,46,238,66803
2006,j) 2500 to 4999,1978,111909,6227687,6137022,10629,9.8,4285,3.9,801026,289056,511970,4.7,13.1,619697,134566,485131,2.2,10.1,181329,3,20.2,0,6,6,21321
2006,k) 5000 to 9999,1063,120614,6514313,6425651,11185,9.5,5813,4.9,845820,275422,570398,4.3,13.2,668496,168438,500058,2.6,10.4,177324,2.8,20.8,0,3,3,15815
2006,l) 10000+,1377,590901,30610187,30260650,61956,10.7,37045,6.4,4038234,1459916,2578318,4.8,13.3,3339161,890246,2448915,2.9,11,699073,2.3,22,1,1,1,
2007,a) 1 to 4,2894987,2900203,6792310,6346028,470685,16.4,422440,14.7,2098575,832287,1266288,13.1,33.1,1206010,726727,479283,11.5,19,892565,14.1,38,0,317085,317716,560349
2007,b) 5 to 9,1061934,1074899,7010244,6960899,84898,7.9,77410,7.2,1382833,542294,840539,7.8,19.9,1284143,480725,803418,6.9,18.4,98690,1.5,36.8,0,61207,61832,397432
2007,c) 10 to 19,647469,683399,8617579,8614908,47475,6.9,46604,6.8,1504985,586504,918481,6.8,17.5,1499642,535808,963834,6.2,17.4,5343,0.1,34.8,0,32135,32915,426319
2007,d) 20 to 49,407831,498365,12185523,12166495,35532,7.1,34113,6.9,1987310,753214,1234096,6.2,16.3,1949253,690157,1259096,5.7,16,38057,0.3,32,0,16664,17772,489205
2007,e) 50 to 99,130432,224838,8837226,8844246,20225,9.1,16119,7.2,1434057,544204,889853,6.2,16.2,1448097,495599,952498,5.6,16.4,-14040,-0.2,32.4,0,4317,5060,293575
2007,f) 100 to 249,71346,222017,10542349,10576848,23808,10.9,14849,6.8,1743984,691708,1052276,6.5,16.5,1812981,584082,1228899,5.5,17.1,-68997,-0.6,33,0,1937,2649,286153
2007,g) 250 to 499,20660,138318,6932734,6931479,11621,8.6,5409,4,1053796,382084,671712,5.5,15.2,1051286,343117,708169,5,15.2,2510,0,30.4,0,497,977,170727
2007,h) 500 to 999,9265,113388,6205120,6162492,10064,9.1,3691,3.3,881072,271123,609949,4.4,14.3,795815,187797,608018,3,12.9,85257,1.4,25.8,0,82,341,55540
2007,i) 1000 to 2499,5642,136072,8323068,8205350,12727,9.6,5355,4,1162420,366989,795431,4.5,14.2,926983,225343,701640,2.7,11.3,235437,2.9,22.6,0,36,55,54525
2007,j) 2500 to 4999,2138,111433,6468159,6409813,9570,8.7,5980,5.5,864436,266394,598042,4.2,13.5,747743,182937,564806,2.9,11.7,116693,1.8,23.4,0,10,11,30498
2007,k) 5000 to 9999,1170,120401,6486690,6449039,12597,10.7,6733,5.7,840956,268093,572863,4.2,13,765653,183676,581977,2.8,11.9,75303,1.1,23.8,1,2,2,
2007,l) 10000+,1542,619496,31226018,31222470,72808,12,51363,8.4,4380116,1475797,2904319,4.7,14,4373020,1226544,3146476,3.9,14,7096,0,28,0,,,
2008,a) 1 to 4,2874061,2877951,6652761,6299079,436793,15.1,458463,15.8,1978126,759051,1219075,12.1,31.4,1270762,774559,496203,12.3,20.2,707364,11.2,40.4,0,349104,349130,604142
2008,b) 5 to 9,1051439,1064424,6891146,6900982,76602,7.2,74591,7,1287250,490872,796378,7.1,18.7,1306921,479970,826951,7,18.9,-19671,-0.2,37.4,0,63363,63389,411395
2008,c) 10 to 19,640156,676817,8500513,8546327,41997,6.2,39095,5.8,1379726,523352,856374,6.1,16.1,1471353,506621,964732,5.9,17.2,-91627,-1.1,32.2,0,33188,33273,440543
2008,d) 20 to 49,402417,495201,12078036,12092073,28293,5.7,22207,4.5,1760771,639582,1121189,5.3,14.6,1788845,595524,1193321,4.9,14.8,-28074,-0.2,29.2,0,17396,17523,513068
2008,e) 50 to 99,128232,223476,8752176,8774175,11772,5.3,7331,3.3,1163849,405701,758148,4.6,13.3,1207846,374804,833042,4.3,13.8,-43997,-0.5,26.6,0,4580,4691,312156
2008,f) 100 to 249,68864,213780,10457684,10424414,10626,5,5275,2.5,1375945,452718,923227,4.3,13.2,1309405,422657,886748,4.1,12.6,66540,0.6,25.2,0,2189,2316,325342
2008,g) 250 to 499,20117,138564,6858924,6847741,10845,8,3965,2.9,963311,362343,600968,5.3,14.1,940944,282912,658032,4.1,13.7,22367,0.4,27.4,0,569,760,195058
2008,h) 500 to 999,9351,117630,6257377,6219077,8223,7.1,3063,2.7,803323,256134,547189,4.1,12.9,726723,150617,576106,2.4,11.7,76600,1.2,23.4,0,103,233,70675
2008,i) 1000 to 2499,5675,138908,8275595,8234049,10911,8,5466,4,1013582,344799,668783,4.2,12.3,930489,192362,738127,2.3,11.3,83093,1,22.6,0,42,102,66000
2008,j) 2500 to 4999,2144,117571,6674911,6644027,9885,8.6,4948,4.3,795092,265734,529358,4,12,733325,163507,569818,2.5,11,61767,1,22,0,10,73,34819
2008,k) 5000 to 9999,1179,112906,6601929,6583899,9400,8.5,4975,4.5,762884,212883,550001,3.2,11.6,726823,157577,569246,2.4,11,36061,0.6,22,0,5,10,34362
2008,l) 10000+,1627,650345,31779633,31726359,58620,9.2,37648,5.9,4049470,1448479,2600991,4.6,12.8,3942922,857614,3085308,2.7,12.4,106548,0.4,24.8,1,1,1,
2009,a) 1 to 4,2757376,2762080,6317789,6098703,372933,13.2,495940,17.5,1781121,651790,1129331,10.7,29.2,1342948,830366,512582,13.6,22,438173,7.2,44,0,367572,367582,628970
2009,b) 5 to 9,1019602,1033187,6482629,6644573,63323,6.1,76998,7.4,1084326,405603,678723,6.1,16.3,1408214,492805,915409,7.4,21.2,-323888,-4.9,32.6,0,63653,63669,413388
2009,c) 10 to 19,623419,659849,7921571,8175966,35366,5.3,39195,5.9,1090012,444311,645701,5.4,13.3,1598801,497953,1100848,6.1,19.6,-508789,-6.3,26.6,0,32209,32300,427122
2009,d) 20 to 49,393987,483505,11143207,11535130,21712,4.5,22846,4.7,1292232,517863,774369,4.5,11.2,2076077,578739,1497338,5,18,-783845,-6.8,22.4,0,16412,16626,483196
2009,e) 50 to 99,125948,218086,8038694,8356426,8988,4.1,8169,3.8,817897,336248,481649,4,9.8,1453360,363857,1089503,4.4,17.4,-635463,-7.6,19.6,0,4116,4321,279201
2009,f) 100 to 249,69945,217266,9848784,10241751,8680,4,6412,3,927247,349629,577618,3.4,9.1,1713180,402304,1310876,3.9,16.7,-785933,-7.6,18.2,0,1909,2306,282299
2009,g) 250 to 499,20329,140834,6477521,6694931,10932,7.9,4726,3.4,750430,322310,428120,4.8,11.2,1185249,266510,918739,4,17.7,-434819,-6.5,22.4,0,468,761,161324
2009,h) 500 to 999,9251,118636,5857030,6032592,8557,7.3,4312,3.7,593142,206530,386612,3.4,9.8,944267,163388,780879,2.7,15.7,-351125,-5.9,19.6,0,89,231,61781
2009,i) 1000 to 2499,5760,141355,7901665,8099521,10689,7.7,5839,4.2,799815,300126,499689,3.7,9.9,1195526,230735,964791,2.8,14.8,-395711,-4.9,19.8,0,48,1009,75764
2009,j) 2500 to 4999,2191,115668,6362907,6508387,8729,7.7,4919,4.3,625358,226555,398803,3.5,9.6,916317,178929,737388,2.7,14.1,-290959,-4.5,19.2,0,13,111,40543
2009,k) 5000 to 9999,1146,119601,6390164,6527812,9894,8.4,6520,5.5,645676,234447,411229,3.6,9.9,920972,174004,746968,2.7,14.1,-275296,-4.2,19.8,1,2,2,
2009,l) 10000+,2130,641205,30592015,31245175,50276,7.9,47583,7.4,2997753,1059244,1938509,3.4,9.6,4304072,899846,3404226,2.9,13.8,-1306319,-4.2,19.2,0,,,
2010,a) 1 to 4,2764138,2769708,6354769,6073406,374727,13.4,438848,15.6,1761467,662513,1098954,10.9,29,1198741,737543,461198,12.1,19.7,562726,9.3,39.4,0,314813,314819,542611
2010,b) 5 to 9,986432,1001481,6446272,6483752,60449,6,66155,6.6,1084946,385902,699044,6,16.7,1159905,419965,739940,6.5,17.9,-74959,-1.2,33.4,0,53959,54008,349324
2010,c) 10 to 19,611820,650726,7923124,8030442,40456,6.2,34669,5.4,1159714,497337,662377,6.2,14.4,1374350,432706,941644,5.4,17.1,-214636,-2.7,28.8,0,27703,27811,366877
2010,d) 20 to 49,374011,465409,10816327,11047624,20531,4.4,20118,4.3,1253395,479596,773799,4.3,11.3,1715989,498488,1217501,4.5,15.5,-462594,-4.2,22.6,0,14055,14328,412722
2010,e) 50 to 99,117398,210684,7783461,7908553,9938,4.7,7548,3.6,886215,331534,554681,4.2,11.2,1136399,314628,821771,4,14.4,-250184,-3.2,22.4,0,3541,3725,242943
2010,f) 100 to 249,65591,216620,9565684,9708575,12920,6.1,6373,3,1098264,473878,624386,4.9,11.3,1384045,388522,995523,4,14.3,-285781,-3,22.6,0,1907,2275,283640
2010,g) 250 to 499,18982,142781,6256066,6323258,12421,9,3930,2.8,811736,357537,454199,5.7,12.8,946120,246644,699476,3.9,15,-134384,-2.2,25.6,0,474,631,162048
2010,h) 500 to 999,8845,120872,5837716,5875602,9467,8,3834,3.2,675640,240157,435483,4.1,11.5,751411,170004,581407,2.9,12.8,-75771,-1.3,23,0,123,248,83796
2010,i) 1000 to 2499,5425,143021,7763223,7828394,9639,6.9,5041,3.6,808373,287299,521074,3.7,10.3,938715,179067,759648,2.3,12,-130342,-1.7,20.6,0,47,154,66138
2010,j) 2500 to 4999,1953,113177,6053765,6139250,6974,6.2,5574,5,554542,167028,387514,2.7,9,725511,178651,546860,2.9,11.8,-170969,-2.8,18,0,14,51,50857
2010,k) 5000 to 9999,1040,116646,6298738,6355887,7820,6.7,6596,5.7,683255,232503,450752,3.7,10.7,797554,178445,619109,2.8,12.5,-114299,-1.8,21.4,0,6,6,35900
2010,l) 10000+,1329,627022,29693481,29958509,44914,7.2,41105,6.6,2869287,906289,1962998,3,9.6,3399345,744802,2654543,2.5,11.3,-530058,-1.7,19.2,0,,,
2011,a) 1 to 4,2773313,2779533,6384347,6070829,397275,14.2,424903,15.2,1780368,695579,1084789,11.5,29.3,1153331,715550,437781,11.8,19,627037,10.3,38,0,305326,305385,526645
2011,b) 5 to 9,958935,974559,6388001,6342219,64247,6.6,63480,6.5,1133998,408646,725352,6.4,17.9,1042433,402412,640021,6.3,16.4,91565,1.5,32.8,0,50930,51006,330058
2011,c) 10 to 19,610620,651947,8038292,8134589,36298,5.6,36961,5.7,1220978,446782,774196,5.5,15,1413571,461255,952316,5.7,17.4,-192593,-2.4,30,0,28426,28588,375347
2011,d) 20 to 49,361037,454375,10933293,10893754,22024,4.9,19505,4.3,1431208,505753,925455,4.6,13.1,1352129,479732,872397,4.4,12.4,79079,0.7,24.8,0,13374,13732,394735
2011,e) 50 to 99,111889,206091,7730336,7682604,10599,5.2,7005,3.4,957813,336882,620931,4.4,12.5,862349,299573,562776,3.9,11.2,95464,1.3,22.4,0,3413,3792,231803
2011,f) 100 to 249,63728,215899,9621388,9647640,11063,5.2,6667,3.1,1151595,396532,755063,4.1,11.9,1204099,372783,831316,3.9,12.5,-52504,-0.6,23.8,0,1843,2425,274851
2011,g) 250 to 499,18265,140015,6333322,6263208,8842,6.4,4238,3.1,832922,279150,553772,4.5,13.3,692693,217590,475103,3.5,11.1,140229,2.2,22.2,0,395,542,134656
2011,h) 500 to 999,8625,122219,5955127,5877496,7213,6,3349,2.8,706029,193583,512446,3.3,12,550768,128576,422192,2.2,9.4,155261,2.6,18.8,0,84,114,59002
2011,i) 1000 to 2499,5395,147650,8051330,7949648,8326,5.7,4046,2.8,908935,233810,675125,2.9,11.4,705571,148541,557030,1.9,8.9,203364,2.5,17.8,0,35,39,54641
2011,j) 2500 to 4999,1943,121210,6175811,6176523,7011,5.8,4561,3.8,585251,148804,436447,2.4,9.5,586676,143200,443476,2.3,9.5,-1425,0,19,0,10,10,36602
2011,k) 5000 to 9999,1054,111024,6359383,6286056,7311,6.6,5339,4.9,681552,187335,494217,3,10.8,534897,135287,399610,2.2,8.5,146655,2.3,17,1,2,2,
2011,l) 10000+,1222,629398,30151058,29901530,51949,8.4,33667,5.4,3454780,997011,2457769,3.3,11.6,2955724,676724,2279000,2.3,9.9,499056,1.7,19.8,0,,,
2012,a) 1 to 4,2832968,2837718,6535717,6127820,418188,14.9,380400,13.5,1858428,734063,1124365,12,30.3,1042634,641237,401397,10.5,17,815794,13.3,34,0,270891,271551,470150
2012,b) 5 to 9,980654,992924,6592820,6489814,67687,6.8,63048,6.4,1201544,433107,768437,6.7,18.5,995532,385966,609566,5.9,15.3,206012,3.2,30.6,0,47866,48476,310585
2012,c) 10 to 19,592734,628898,8042775,7980797,37392,5.9,40079,6.4,1306296,459639,846657,5.8,16.4,1182339,443695,738644,5.6,14.8,123957,1.6,29.6,0,25507,26327,339252
2012,d) 20 to 49,368056,458438,11266515,11114769,29696,6.5,30760,6.7,1759483,608349,1151134,5.5,15.8,1455990,582589,873401,5.2,13.1,303493,2.7,26.2,0,13022,14091,386176
2012,e) 50 to 99,116223,209617,8063903,7960857,15915,7.6,14697,7,1264821,427913,836908,5.4,15.9,1058729,398673,660056,5,13.3,206092,2.6,26.6,0,3280,3879,221141
2012,f) 100 to 249,63690,215430,9729636,9621558,18106,8.5,13439,6.3,1523539,513603,1009936,5.3,15.8,1307382,448474,858908,4.7,13.6,216157,2.2,27.2,0,1371,1857,202343
2012,g) 250 to 499,18757,137601,6520710,6416634,7853,5.8,4918,3.6,947706,287343,660363,4.5,14.8,739554,246741,492813,3.8,11.5,208152,3.3,23,0,354,588,119046
2012,h) 500 to 999,9008,122530,6161270,6076794,7103,5.9,4605,3.8,786413,196701,589712,3.2,12.9,617461,152158,465303,2.5,10.2,168952,2.7,20.4,0,66,161,45348
2012,i) 1000 to 2499,5485,146080,8264005,8126736,8458,5.9,5321,3.7,983042,230773,752269,2.8,12.1,708505,159971,548534,2,8.7,274537,3.4,17.4,0,24,62,33358
2012,j) 2500 to 4999,2042,120809,6428299,6365142,6302,5.3,4489,3.7,733740,169494,564246,2.7,11.5,607427,151382,456045,2.4,9.5,126313,2,19,0,12,25,40843
2012,k) 5000 to 9999,1052,114635,6401519,6365849,6273,5.5,4642,4.1,683176,146821,536355,2.3,10.7,611837,131751,480086,2.1,9.6,71339,1.1,19.2,1,2,17,
2012,l) 10000+,1249,640431,30753968,30659757,51034,8.1,37680,5.9,3305377,876046,2429331,2.9,10.8,3116954,774102,2342852,2.5,10.2,188423,0.6,20.4,0,3,15,45988
2013,a) 1 to 4,2849069,2852407,6516403,6158790,405924,14.3,401121,14.2,1802255,704809,1097446,11.4,29.3,1087028,675717,411311,11,17.7,715227,11.6,35.4,0,274510,274691,474611
2013,b) 5 to 9,990132,1001275,6611682,6556571,62693,6.3,61225,6.1,1142101,405211,736890,6.2,17.4,1031878,393722,638156,6,15.7,110223,1.7,31.4,0,48026,48234,312626
2013,c) 10 to 19,593028,627889,8058550,8003011,33372,5.3,31507,5,1211870,430398,781472,5.4,15.1,1100791,405984,694807,5.1,13.8,111079,1.3,27.6,0,25124,25444,334759
2013,d) 20 to 49,374983,466215,11436812,11336647,21851,4.7,18430,4,1551791,538824,1012967,4.8,13.7,1351460,486276,865184,4.3,11.9,200331,1.8,23.8,0,13413,13991,397980
2013,e) 50 to 99,117176,210960,8154476,8095792,9211,4.4,6868,3.3,1036137,333394,702743,4.1,12.8,918769,328746,590023,4.1,11.3,117368,1.5,22.6,0,3836,4136,260518
2013,f) 100 to 249,63804,212012,9873555,9777878,9321,4.4,6183,2.9,1237856,346114,891742,3.5,12.7,1046502,384642,661860,3.9,10.7,191354,2,21.4,0,1923,2382,289332
2013,g) 250 to 499,19095,139733,6642479,6564563,7345,5.3,3358,2.4,831635,246987,584648,3.8,12.7,675803,224275,451528,3.4,10.3,155832,2.4,20.6,0,430,599,147381
2013,h) 500 to 999,9264,123608,6387577,6301318,6894,5.7,3054,2.5,807674,198628,609046,3.2,12.8,635157,147426,487731,2.3,10.1,172517,2.7,20.2,0,103,212,69309
2013,i) 1000 to 2499,5729,147549,8418555,8324640,7915,5.4,4680,3.2,967609,226110,741499,2.7,11.6,779779,177545,602234,2.1,9.4,187830,2.2,18.8,0,41,46,63654
2013,j) 2500 to 4999,2194,124478,6525644,6469365,7877,6.4,5188,4.2,741968,188133,553835,2.9,11.5,629410,140545,488865,2.2,9.7,112558,1.8,19.4,0,11,11,37041
2013,k) 5000 to 9999,1138,117665,6590929,6533809,7872,6.8,5436,4.7,736491,181264,555227,2.8,11.3,622252,138072,484180,2.1,9.5,114239,1.8,19,0,3,3,21301
2013,l) 10000+,1450,650566,31977714,31684722,51857,8.1,37862,5.9,3581400,1100316,2481084,3.5,11.3,2995415,687513,2307902,2.2,9.5,585985,1.8,19,0,,,
2014,a) 1 to 4,2867751,2871223,6539307,6161646,433186,15.2,402519,14.1,1836470,745594,1090876,12.1,29.8,1081147,673428,407719,10.9,17.5,755323,12.3,35,0,297984,298155,508221
2014,b) 5 to 9,991035,1001879,6669154,6575861,65235,6.5,60752,6.1,1191432,423050,768382,6.4,18.1,1004845,388760,616085,5.9,15.3,186587,2.8,30.6,0,49026,49229,317944
2014,c) 10 to 19,598112,629821,8153107,8084305,32488,5.2,32641,5.2,1230066,427849,802217,5.3,15.2,1092461,412389,680072,5.1,13.5,137605,1.7,27,0,25090,25429,333073
2014,d) 20 to 49,380472,464463,11599565,11517012,19327,4.2,20689,4.4,1524459,513916,1010543,4.5,13.2,1359352,511735,847617,4.4,11.8,165107,1.4,23.6,0,13553,14130,398432
2014,e) 50 to 99,118603,209462,8220695,8158709,9790,4.7,7662,3.7,1012077,364157,647920,4.5,12.4,888105,332556,555549,4.1,10.9,123972,1.5,21.8,0,3573,3941,242714
2014,f) 100 to 249,65384,214977,10034356,9936484,11483,5.4,6235,2.9,1216489,412468,804021,4.2,12.2,1020744,386160,634584,3.9,10.3,195745,1.9,20.6,0,1734,2077,259355
2014,g) 250 to 499,19626,139783,6781042,6706915,7521,5.5,2875,2.1,832854,260626,572228,3.9,12.4,684599,243820,440779,3.6,10.2,148255,2.2,20.4,0,451,559,153327
2014,h) 500 to 999,9606,124365,6505240,6412151,8692,7.2,2810,2.3,860780,262861,597919,4.1,13.4,674601,153134,521467,2.4,10.5,186179,2.9,21,0,97,117,64788
2014,i) 1000 to 2499,5874,148959,8464474,8340246,10428,7.2,4058,2.8,1043998,299994,744004,3.6,12.5,795542,172772,622770,2.1,9.5,248456,3,19,0,40,44,59342
2014,j) 2500 to 4999,2191,128838,6746136,6662346,7959,6.3,4271,3.4,789403,222736,566667,3.3,11.8,621823,124726,497097,1.9,9.3,167580,2.5,18.6,1,2,2,
2014,k) 5000 to 9999,1206,120738,6812869,6756714,7159,6,4049,3.4,797624,208228,589396,3.1,11.8,685315,144473,540842,2.1,10.1,112309,1.7,20.2,1,2,2,
2014,l) 10000+,1546,666818,32576965,32441287,56649,8.7,28381,4.3,3664336,1122512,2541824,3.5,11.3,3392980,797651,2595329,2.5,10.5,271356,0.8,21,1,1,1,
2015,a) 1 to 4,2891660,2895292,6597595,6200036,440149,15.3,399662,13.9,1876559,751853,1124706,12.1,30.3,1081440,674037,407403,10.9,17.4,795119,12.9,34.8,,,,
2015,b) 5 to 9,996872,1007527,6696922,6613885,67009,6.7,63382,6.3,1192990,432014,760976,6.5,18,1026915,406327,620588,6.1,15.5,166075,2.5,31,,,,
2015,c) 10 to 19,605295,635853,8284077,8207619,33063,5.2,33492,5.3,1251738,436817,814921,5.3,15.3,1098821,427653,671168,5.2,13.4,152917,1.9,26.8,,,,
2015,d) 20 to 49,387783,469453,11881910,11785691,20232,4.3,21237,4.5,1565295,541115,1024180,4.6,13.3,1372857,550768,822089,4.7,11.6,192438,1.7,23.2,,,,
2015,e) 50 to 99,120473,208600,8429019,8345893,9309,4.5,8461,4.1,1079915,372023,707892,4.5,12.9,913662,370777,542885,4.4,10.9,166253,2,21.8,,,,
2015,f) 100 to 249,66898,214020,10333354,10219313,12973,6.1,7720,3.7,1314050,461344,852706,4.5,12.9,1085968,426151,659817,4.2,10.6,228082,2.3,21.2,,,,
2015,g) 250 to 499,19995,142601,6924287,6858668,9179,6.6,3900,2.8,865576,268862,596714,3.9,12.6,734337,245469,488868,3.6,10.7,131239,1.9,21.4,,,,
2015,h) 500 to 999,9723,125103,6582113,6497809,8659,7.1,3507,2.9,846570,265564,581006,4.1,13,677962,170522,507440,2.6,10.4,168608,2.6,20.8,,,,
2015,i) 1000 to 2499,5878,152913,8729315,8597059,10771,7.2,4718,3.1,1094826,336188,758638,3.9,12.7,830315,202847,627468,2.4,9.7,264511,3,19.4,,,,
2015,j) 2500 to 4999,2202,128668,6924253,6826047,7357,5.8,4112,3.2,823433,221976,601457,3.3,12.1,627021,130370,496651,1.9,9.2,196412,2.9,18.4,,,,
2015,k) 5000 to 9999,1159,124093,6752562,6716655,8300,6.8,4155,3.4,741796,186873,554923,2.8,11,669981,163031,506950,2.4,10,71815,1,20,,,,
2015,l) 10000+,1599,681974,33502044,33223128,58377,8.7,41142,6.1,4098061,1362293,2735768,4.1,12.3,3540228,797679,2742549,2.4,10.7,557833,1.6,21.4,,,,
2016,a) 1 to 4,2920613,2924690,6613411,6218084,452824,15.6,403864,13.9,1876582,776265,1100317,12.5,30.2,1085928,677867,408061,10.9,17.5,790654,12.7,35,,,,
2016,b) 5 to 9,1003616,1014447,6756084,6661888,69375,6.9,63891,6.3,1229230,447332,781898,6.7,18.5,1040838,409604,631234,6.1,15.6,188392,2.9,31.2,,,,
2016,c) 10 to 19,614698,644296,8413093,8329872,35019,5.4,34258,5.3,1291890,458209,833681,5.5,15.5,1125447,436544,688903,5.2,13.5,166443,2,27,,,,
2016,d) 20 to 49,397467,476095,12161516,12073400,20749,4.4,21925,4.6,1606319,556323,1049996,4.6,13.3,1430086,562900,867186,4.7,11.8,176233,1.5,23.6,,,,
2016,e) 50 to 99,123336,210035,8545383,8504502,10681,5.1,8717,4.2,1060259,382749,677510,4.5,12.5,978497,382874,595623,4.5,11.5,81762,1,23,,,,
2016,f) 100 to 249,68194,216764,10444172,10374416,11985,5.6,7338,3.4,1261949,428388,833561,4.1,12.2,1122437,427607,694830,4.1,10.8,139512,1.4,21.6,,,,
2016,g) 250 to 499,20664,144255,7126690,7068398,8710,6.1,4712,3.3,875504,282159,593345,4,12.4,758920,250654,508266,3.5,10.7,116584,1.7,21.4,,,,
2016,h) 500 to 999,9984,128826,6766857,6669036,8639,6.8,3470,2.7,892208,305967,586241,4.6,13.4,696565,163418,533147,2.5,10.4,195643,3,20.8,,,,
2016,i) 1000 to 2499,6012,156861,8880958,8781863,10633,6.9,5834,3.8,1070934,348110,722824,4,12.2,872744,187130,685614,2.1,9.9,198190,2.3,19.8,,,,
2016,j) 2500 to 4999,2223,131365,6998508,6922903,7780,6,3825,3,773162,220216,552946,3.2,11.2,621952,124769,497183,1.8,9,151210,2.2,18,,,,
2016,k) 5000 to 9999,1222,128879,7092548,7021291,8818,7,4239,3.3,769678,224263,545415,3.2,11,627164,117695,509469,1.7,8.9,142514,2.1,17.8,,,,
2016,l) 10000+,1491,709940,34432115,34143247,59765,8.6,27724,4,3745176,1316235,2428941,3.9,11,3167439,782603,2384836,2.3,9.3,577737,1.7,18.6,,,,
