year2,sic1,firms,estabs,emp,denom,estabs_entry,estabs_entry_rate,estabs_exit,estabs_exit_rate,job_creation,job_creation_births,job_creation_continuers,job_creation_rate_births,job_creation_rate,job_destruction,job_destruction_deaths,job_destruction_continuers,job_destruction_rate_deaths,job_destruction_rate,net_job_creation,net_job_creation_rate,reallocation_rate,firmdeath_firms,firmdeath_estabs,firmdeath_emp,d_flag
1977,07,35945,36976,275551,253803,7306,19.8,7083,19.2,105857,60750,45107,23.9,41.7,62360,28458,33902,11.2,24.6,43497,17.1,49.2,4996,5006,19331,0
1977,10,19363,25448,800256,770048,4347,17.5,3193,12.8,184197,75432,108765,9.8,23.9,123781,50050,73731,6.5,16.1,60416,7.8,32.2,1949,1958,20198,0
1977,15,383365,388916,3398401,3299285,81821,21.7,56837,15,981095,365576,615519,11.1,29.7,782864,261504,521360,7.9,23.7,198231,6,47.4,38150,38173,174431,0
1977,20,259987,316750,19326182,18853860,38800,12.4,31186,10,2725261,779366,1945895,4.1,14.5,1780616,544425,1236191,2.9,9.4,944645,5.1,18.8,21326,21409,252009,0
1977,40,121029,163437,4303510,4107418,24749,15.5,17462,10.9,980625,257679,722946,6.3,23.9,588441,139602,448839,3.4,14.3,392184,9.6,28.6,11998,12059,74049,0
1977,50,275205,367735,4758252,4613991,55677,15.4,41893,11.6,1086152,465285,620867,10.1,23.5,797631,365454,432177,7.9,17.3,288521,6.2,34.6,22749,22973,163079,0
1977,52,939857,1240959,13582593,13188542,231929,19,189237,15.5,3497552,1911207,1586345,14.5,26.5,2709450,1321361,1388089,10,20.5,788102,6,41,129237,130349,792166,0
1977,60,297792,388356,4519241,4397619,49182,12.8,39293,10.2,797990,294453,503537,6.7,18.1,554746,190313,364433,4.3,12.6,243244,5.5,25.2,25909,26023,97715,0
1977,70,1118349,1225215,15127827,14503051,203938,17.1,139824,11.7,3560787,1649154,1911633,11.4,24.6,2311236,1008461,1302775,7,15.9,1249551,8.7,31.8,94622,95017,631985,0
1978,07,37026,38046,259192,267230,7303,19.5,6144,16.4,82655,31556,51099,11.8,30.9,98730,35982,62748,13.5,36.9,-16075,-6,61.8,3817,3827,15971,0
1978,10,19538,25647,785872,792426,4017,15.7,3655,14.3,167583,56094,111489,7.1,21.1,180692,63522,117170,8,22.8,-13109,-1.7,42.2,1991,2000,18635,0
1978,15,410065,415537,3861717,3625943,91975,22.9,64182,16,1273933,420881,853052,11.6,35.1,802386,323076,479310,8.9,22.1,471547,13,44.2,43397,43415,201030,0
1978,20,262302,318601,20090985,19711521,37094,11.7,34910,11,2754691,628470,2126221,3.2,14,1995764,762264,1233500,3.9,10.1,758927,3.9,20.2,22477,22547,277131,0
1978,40,123279,166667,4352271,4326613,23990,14.5,20384,12.4,806468,216294,590174,5,18.6,755151,179856,575295,4.2,17.5,51317,1.1,35,13256,13326,84346,0
1978,50,278452,372447,4981210,4868687,43589,11.8,38442,10.4,1044178,311321,732857,6.4,21.4,819131,351440,467691,7.2,16.8,225047,4.6,33.6,22151,22374,121930,0
1978,52,922929,1231000,14267291,13917290,186559,15.1,194182,15.7,3417814,1519759,1898055,10.9,24.6,2717812,1248197,1469615,9,19.5,700002,5.1,39,129433,130369,662880,0
1978,60,303082,396916,4770805,4638385,50464,12.9,41110,10.5,830502,253150,577352,5.5,17.9,565662,232657,333005,5,12.2,264840,5.7,24.4,27498,27571,108590,0
1978,70,1146097,1257821,16301010,15685188,181821,14.6,145956,11.8,3684533,1118577,2565956,7.1,23.5,2452889,1086099,1366790,6.9,15.6,1231644,7.9,31.2,96604,97027,632901,0
1979,07,39344,40330,272566,265506,7772,19.8,5327,13.6,85788,37582,48206,14.2,32.3,71667,26114,45553,9.8,27,14121,5.3,54,3182,3201,14288,0
1979,10,21003,27201,915281,851857,4261,16.1,2706,10.2,237574,63829,173745,7.5,27.9,110726,40789,69937,4.8,13,126848,14.9,26,1105,1111,9545,0
1979,15,434077,439530,4307692,4082377,88549,20.7,61823,14.5,1355623,433564,922059,10.6,33.2,904992,308549,596443,7.6,22.2,450631,11,44.4,40521,40537,180446,0
1979,20,269021,326022,20856441,20468652,38784,12,30419,9.4,2840082,729893,2110189,3.6,13.9,2064504,758782,1305722,3.7,10.1,775578,3.8,20.2,18697,18832,228287,0
1979,40,129399,172633,4618074,4483772,24747,14.6,18199,10.7,850532,200207,650325,4.5,19,581927,167386,414541,3.7,13,268605,6,26,11110,11207,68084,0
1979,50,288911,383886,5192536,5084679,45158,11.9,32819,8.7,983182,333840,649342,6.6,19.3,767468,283475,483993,5.6,15.1,215714,4.2,30.2,17214,17405,108408,0
1979,52,937995,1257586,15010117,14627670,190173,15.3,158961,12.8,3357933,1627662,1730271,11.1,23,2593039,1026410,1566629,7,17.7,764894,5.3,35.4,100194,100700,535911,0
1979,60,313058,414052,5090192,4929102,54414,13.4,36219,8.9,903044,314016,589028,6.4,18.3,580865,188251,392614,3.8,11.8,322179,6.5,23.6,22791,22861,80003,0
1979,70,1197433,1315080,17753732,17037042,187926,14.6,125419,9.8,3829373,1257879,2571494,7.4,22.5,2395993,839431,1556562,4.9,14.1,1433380,8.4,28.2,78611,79036,442528,0
1980,07,40011,41007,276847,273794,6953,17.1,5824,14.3,73124,29385,43739,10.7,26.7,67018,24652,42366,9,24.5,6106,2.2,49,4150,4151,16570,0
1980,10,21621,27884,945510,928304,4395,16,3387,12.3,186073,61661,124412,6.6,20,151660,49304,102356,5.3,16.3,34413,3.7,32.6,2315,2335,25216,0
1980,15,421353,426609,4169443,4220272,71784,16.6,77810,18,1076579,338891,737688,8,25.5,1178237,381952,796285,9.1,27.9,-101658,-2.4,51,58772,58784,271430,0
1980,20,270337,327602,20690281,20749459,35652,10.9,32503,9.9,2518055,700767,1817288,3.4,12.1,2636411,783785,1852626,3.8,12.7,-118356,-0.6,24.2,23174,23283,271081,0
1980,40,130157,174000,4669315,4641205,22303,12.9,19704,11.4,809449,176115,633334,3.8,17.4,753229,152438,600791,3.3,16.2,56220,1.2,32.4,14578,14662,82118,0
1980,50,292240,387865,5287711,5233033,41674,10.8,35666,9.2,893613,330076,563537,6.3,17.1,784259,283662,500597,5.4,15,109354,2.1,30,22141,22292,122788,0
1980,52,924309,1250918,14956873,14957973,170047,13.6,168742,13.5,2971294,1503307,1467987,10.1,19.9,2973493,1125939,1847554,7.5,19.9,-2199,0,39.8,118853,119679,668545,0
1980,60,313401,416918,5227080,5151979,47202,11.4,41968,10.1,798740,272856,525884,5.3,15.5,648539,228864,419675,4.4,12.6,150201,2.9,25.2,29188,29302,111218,0
1980,70,1224477,1345942,18526759,18128877,180293,13.6,138750,10.4,3391201,1154576,2236625,6.4,18.7,2595437,917478,1677959,5.1,14.3,795764,4.4,28.6,98465,98876,554609,0
1981,07,40480,41438,285668,281502,7141,17.3,6637,16.1,81876,35673,46203,12.7,29.1,73543,35865,37678,12.7,26.1,8333,3,52.2,4306,4314,21029,0
1981,10,24382,30694,1055417,1003629,6343,21.7,3796,13,258791,88236,170555,8.8,25.8,155215,63706,91509,6.3,15.5,103576,10.3,31,2270,2274,27142,0
1981,15,395706,400847,3982426,4075792,59847,14.5,81141,19.6,1023553,373945,649608,9.2,25.1,1210287,418573,791714,10.3,29.7,-186734,-4.6,50.2,55882,55901,255327,0
1981,20,268491,325395,19982147,20332285,35503,10.9,37610,11.5,2412797,870988,1541809,4.3,11.9,3113074,1036743,2076331,5.1,15.3,-700277,-3.4,23.8,23048,23138,302925,0
1981,40,126641,170247,4731488,4675559,21702,12.7,22240,13,889515,192562,696953,4.1,19,777656,214206,563450,4.6,16.6,111859,2.4,33.2,14070,14156,85031,0
1981,50,295609,388736,5305248,5300007,45207,11.6,44970,11.6,950821,390915,559906,7.4,17.9,940340,384942,555398,7.3,17.7,10481,0.2,35.4,22258,22440,129043,0
1981,52,902107,1218445,14718724,14841216,166431,13.5,197811,16,2845651,1496331,1349320,10.1,19.2,3090635,1417842,1672793,9.6,20.8,-244984,-1.6,38.4,115152,115961,650692,0
1981,60,306781,411934,5382538,5289485,46283,11.2,48391,11.7,884274,353898,530376,6.7,16.7,698167,255964,442203,4.8,13.2,186107,3.5,26.4,29900,29994,106262,0
1981,70,1234928,1353473,18095208,17801861,189180,14.1,166744,12.4,3436596,1416381,2020215,8,19.3,2849901,1209895,1640006,6.8,16,586695,3.3,32,99082,99504,555510,0
1982,07,42052,43170,312507,298466,7798,18.4,5536,13.1,97044,43544,53500,14.6,32.5,68961,25931,43030,8.7,23.1,28083,9.4,46.2,3091,3091,13743,0
1982,10,27274,33923,1114449,1084571,7637,23.6,4052,12.5,285953,102545,183408,9.5,26.4,226197,78971,147226,7.3,20.9,59756,5.5,41.8,2300,2303,29108,0
1982,15,375337,381306,3741208,3835430,57916,14.8,69598,17.8,997322,371489,625833,9.7,26,1185766,349118,836648,9.1,30.9,-188444,-4.9,52,39544,39549,199045,0
1982,20,271758,330226,19102495,19528315,38093,11.6,31618,9.6,2149456,745268,1404188,3.8,11,3001096,732172,2268924,3.7,15.4,-851640,-4.4,22,17827,17884,222471,0
1982,40,130158,176507,4814970,4765781,25843,14.9,18389,10.6,635300,250782,384518,5.3,13.3,536922,157607,379315,3.3,11.3,98378,2,22.6,10748,10773,72428,0
1982,50,305528,406037,5374278,5338747,54343,13.7,36173,9.1,1033098,465573,567525,8.7,19.4,962036,339705,622331,6.4,18,71062,1.4,36,18393,18460,111845,0
1982,52,905598,1268226,15330587,15022879,209938,16.9,154171,12.4,3527790,2048499,1479291,13.6,23.5,2912374,1111455,1800919,7.4,19.4,615416,4.1,38.8,90877,91091,531630,0
1982,60,299226,405234,5422336,5393544,48208,11.8,45183,11.1,830052,325738,504314,6,15.4,772468,243947,528521,4.5,14.3,57584,1.1,28.6,24562,24637,101153,0
1982,70,1282176,1426077,19269308,18684397,230193,16.5,140492,10.1,4084081,1873305,2210776,10,21.9,2914258,1013421,1900837,5.4,15.6,1169823,6.3,31.2,82499,82614,498993,0
1983,07,44334,45501,312373,311706,7540,17,5399,12.2,80598,33626,46972,10.8,25.9,79263,27594,51669,8.9,25.4,1335,0.5,50.8,3371,3373,15809,0
1983,10,26431,32948,896121,999778,4643,13.9,5717,17.1,146162,65357,80805,6.5,14.6,353475,85100,268375,8.5,35.4,-207313,-20.8,29.2,3848,3854,40412,0
1983,15,375369,381225,3572938,3655673,55771,14.6,58297,15.3,921488,276873,644615,7.6,25.2,1086960,309104,777856,8.5,29.7,-165472,-4.5,50.4,37479,37488,192274,0
1983,20,271508,328993,17974642,18530940,30979,9.4,33107,10,1977444,581082,1396362,3.1,10.7,3090041,758472,2331569,4.1,16.7,-1112597,-6,21.4,21433,21510,251336,0
1983,40,131963,176517,4603869,4568141,24376,13.8,20767,11.8,835951,469450,366501,10.3,18.3,764495,227027,537468,5,16.7,71456,1.6,33.4,13438,13510,85974,0
1983,50,308370,407052,5179106,5274536,41432,10.2,41273,10.2,842745,294514,548231,5.6,16,1033605,333634,699971,6.3,19.6,-190860,-3.6,32,23771,23953,129468,0
1983,52,914887,1278766,15184461,15260746,163401,12.8,160019,12.6,2986800,1403130,1583670,9.2,19.6,3139371,1199137,1940234,7.9,20.6,-152571,-1,39.2,102694,103750,596509,0
1983,60,308673,417335,5499822,5463088,47443,11.5,42432,10.3,909217,347253,561964,6.4,16.6,835751,308047,527704,5.6,15.3,73466,1.3,30.6,25104,25198,115133,0
1983,70,1341469,1488478,19493400,19396814,195120,13.4,147329,10.1,3454234,1253644,2200590,6.5,17.8,3261062,986509,2274553,5.1,16.8,193172,1,33.6,97464,97813,535218,0
1984,07,47632,48790,350005,331248,8770,18.6,5481,11.6,102701,39215,63486,11.8,31,65187,24381,40806,7.4,19.7,37514,11.3,39.4,3317,3321,14615,0
1984,10,26102,32835,881295,888573,4816,14.6,4897,14.9,169866,56907,112959,6.4,19.1,184421,62676,121745,7.1,20.8,-14555,-1.7,38.2,3155,3156,25165,0
1984,15,403410,409224,4068533,3825078,77486,19.6,50915,12.9,1319305,400103,919202,10.5,34.5,832395,261009,571386,6.8,21.8,486910,12.7,43.6,32043,32057,169023,0
1984,20,278361,335554,19168497,18588913,36443,11,30054,9,3021597,743282,2278315,4,16.3,1862431,666605,1195826,3.6,10,1159166,6.3,20,18674,18769,185989,0
1984,40,136710,185240,4768821,4684707,27545,15.2,19966,11,789394,309598,479796,6.6,16.9,621166,184854,436312,3.9,13.3,168228,3.6,26.6,12226,12351,79345,0
1984,50,316165,415425,5505873,5352579,47202,11.5,38941,9.5,1048626,364833,683793,6.8,19.6,742038,286235,455803,5.3,13.9,306588,5.7,27.8,21282,21417,115050,0
1984,52,923250,1292985,16083964,15634219,174205,13.6,160671,12.5,3335627,1515535,1820092,9.7,21.3,2436137,1080749,1355388,6.9,15.6,899490,5.7,31.2,99627,100242,533398,0
1984,60,319622,431055,5814264,5650627,54077,12.8,40568,9.6,1070813,423446,647367,7.5,19,743539,246750,496789,4.4,13.2,327274,5.8,26.4,23695,23786,107239,0
1984,70,1419433,1571591,20743996,20104831,232330,15.2,152224,10,4023520,1524965,2498555,7.6,20,2745189,963463,1781726,4.8,13.7,1278331,6.3,27.4,95436,95810,524745,0
1985,07,51428,52666,381546,365171,9907,19.5,5861,11.6,112237,43813,68424,12,30.7,79487,28496,50991,7.8,21.8,32750,8.9,43.6,3867,3867,18466,0
1985,10,26462,33087,861278,871211,4636,14.1,4392,13.3,148786,48592,100194,5.6,17.1,168652,57821,110831,6.6,19.4,-19866,-2.3,34.2,2747,2760,22618,0
1985,15,429885,435709,4438504,4252320,81790,19.3,56607,13.4,1394196,447682,946514,10.5,32.8,1021830,342325,679505,8.1,24,372366,8.8,48,37615,37624,217697,0
1985,20,286081,342986,19207663,19186818,38174,11.3,30839,9.1,2407765,682167,1725598,3.6,12.5,2366075,875444,1490631,4.6,12.3,41690,0.2,24.6,19787,19875,262907,0
1985,40,144786,194835,4915297,4850360,27592,14.4,21196,11.1,756981,249671,507310,5.1,15.6,627107,227757,399350,4.7,12.9,129874,2.7,25.8,13404,13641,103696,0
1985,50,323008,423237,5639461,5571770,48714,11.6,40552,9.7,996872,349060,647812,6.3,17.9,861489,357885,503604,6.4,15.5,135383,2.4,31,23417,23557,146022,0
1985,52,928282,1301624,16769029,16425112,179006,13.8,169607,13.1,3434839,1605002,1829837,9.8,20.9,2747005,1295309,1451696,7.9,16.7,687834,4.2,33.4,106676,107712,628140,0
1985,60,331333,446405,6012507,5892612,58432,13.3,44050,10,1088883,387330,701553,6.6,18.5,849093,316800,532293,5.4,14.4,239790,4.1,28.8,26755,26905,143989,0
1985,70,1488717,1646283,22670014,22141236,225297,14,157570,9.8,4244737,1551144,2693593,7,19.2,3187180,1195083,1992097,5.4,14.4,1057557,4.8,28.8,102812,103241,656828,0
1986,07,54842,56039,411420,395782,10502,19.3,6725,12.4,118753,46958,71795,11.9,30,87476,33833,53643,8.5,22.1,31277,7.9,44.2,4387,4389,20636,0
1986,10,25452,31728,781421,820999,3879,12,5094,15.7,129393,50740,78653,6.2,15.8,208549,65645,142904,8,25.4,-79156,-9.6,31.6,3412,3413,26950,0
1986,15,449039,454673,4670815,4549633,84871,19.1,63390,14.2,1391200,479160,912040,10.5,30.6,1148837,380372,768465,8.4,25.3,242363,5.3,50.6,43303,43315,246040,0
1986,20,287531,344367,18992603,19086400,38672,11.3,36226,10.5,2425030,828883,1596147,4.3,12.7,2612623,934774,1677849,4.9,13.7,-187593,-1,25.4,24494,24592,346085,0
1986,40,148695,200623,5021446,4965611,30344,15.3,23744,12,833757,291865,541892,5.9,16.8,722087,227160,494927,4.6,14.5,111670,2.3,29,15050,15194,107302,0
1986,50,330729,431103,5800547,5716032,51902,12.2,42769,10,1060701,418656,642045,7.3,18.6,891671,335869,555802,5.9,15.6,169030,3,31.2,25329,25402,145773,0
1986,52,939065,1324548,17471155,17106753,194000,14.8,166847,12.7,3714956,1867892,1847064,10.9,21.7,2986151,1258299,1727852,7.4,17.5,728805,4.2,35,109119,109865,694331,0
1986,60,338664,457613,6338192,6164542,59366,13.1,46631,10.3,1219244,446462,772782,7.2,19.8,871944,336621,535323,5.5,14.1,347300,5.7,28.2,28840,28901,148980,0
1986,70,1545330,1709543,23979284,23326417,238176,14.2,167618,10,4591677,1812969,2778708,7.8,19.7,3285943,1160306,2125637,5,14.1,1305734,5.6,28.2,110153,110402,655015,0
1987,07,59010,60231,436444,422964,11554,19.9,6809,11.7,121056,48886,72170,11.6,28.6,94095,36811,57284,8.7,22.2,26961,6.4,44.4,4712,4717,23204,0
1987,10,22754,28499,661439,719429,3438,11.4,6268,20.8,108209,42545,65664,5.9,15,224191,88242,135949,12.3,31.2,-115982,-16.2,30,3954,3988,33196,0
1987,15,472107,478239,4793973,4721981,91227,19.6,62620,13.4,1381832,462338,919494,9.8,29.3,1237849,427078,810771,9,26.2,143983,3.1,52.4,45092,45147,267444,0
1987,20,289364,345800,18569701,18759597,39150,11.3,36009,10.4,2191002,635512,1555490,3.4,11.7,2570794,919162,1651632,4.9,13.7,-379792,-2,23.4,23399,23540,280924,0
1987,40,153002,209213,5107877,5060134,36311,17.7,26512,12.9,1016797,469096,547701,9.3,20.1,921311,362979,558332,7.2,18.2,95486,1.9,36.4,16586,16870,171260,0
1987,50,333858,437462,5812817,5803278,56840,13.1,49347,11.3,1086813,407639,679174,7,18.7,1067736,444826,622910,7.7,18.4,19077,0.3,36.8,27004,27377,168617,0
1987,52,946383,1358926,18131824,17829319,218894,16.3,181509,13.5,4024757,2059770,1964987,11.6,22.6,3419747,1559752,1859995,8.7,19.2,605010,3.4,38.4,113925,115662,751412,0
1987,60,346814,467965,6557717,6442528,65357,14.1,52478,11.3,1214030,451303,762727,7,18.8,983653,381067,602586,5.9,15.3,230377,3.5,30.6,32353,32549,167040,0
1987,70,1593405,1779207,25579979,25158908,260467,14.9,184510,10.6,4782041,1860936,2921105,7.4,19,3939899,1541639,2398260,6.1,15.7,842142,3.3,31.4,122044,122830,829790,0
1988,07,61524,62640,466805,448894,10750,17.5,7775,12.7,130822,50145,80677,11.2,29.1,95000,37712,57288,8.4,21.2,35822,7.9,42.4,5310,5310,25106,0
1988,10,22228,27640,651148,655736,3517,12.5,4282,15.3,129607,42645,86962,6.5,19.8,138783,55637,83146,8.5,21.2,-9176,-1.4,39.6,2602,2602,16286,0
1988,15,479117,485178,4887340,4833280,81704,17,70786,14.7,1315171,428656,886515,8.9,27.2,1207051,394562,812489,8.2,25,108120,2.2,50,52322,52322,275553,0
1988,20,293370,349815,19047118,18784887,38337,11,33540,9.6,2696186,850584,1845602,4.5,14.4,2171723,780128,1391595,4.2,11.6,524463,2.8,23.2,22858,22858,234291,0
1988,40,151344,207596,5258963,5142690,29626,14.3,27209,13.2,910591,324288,586303,6.3,17.7,678046,261689,416357,5.1,13.2,232545,4.5,26.4,17125,17128,119489,0
1988,50,336832,441324,5961745,5882348,48840,11.1,43899,10,1111706,374945,736761,6.4,18.9,952912,374430,578482,6.4,16.2,158794,2.7,32.4,26557,26559,153673,0
1988,52,940680,1364163,18530977,18311911,187821,13.8,178632,13.1,3867515,1813344,2054171,9.9,21.1,3429382,1466531,1962851,8,18.7,438133,2.4,37.4,115149,115153,691798,0
1988,60,346701,482886,6617389,6561381,70147,14.8,52054,11,1267312,558094,709218,8.5,19.3,1155296,408313,746983,6.2,17.6,112016,1.7,35.2,32088,32088,171285,0
1988,70,1602672,1799975,25993151,25364110,230347,12.9,194192,10.9,5119071,1881248,3237823,7.4,20.2,3860991,1471957,2389034,5.8,15.2,1258080,5,30.4,133923,133932,736730,0
1989,07,64146,65339,509415,488451,11103,17.4,8379,13.1,147817,53461,94356,10.9,30.3,105889,40753,65136,8.3,21.7,41928,8.6,43.4,5128,5136,23388,0
1989,10,21414,26899,634264,642581,3112,11.4,3872,14.2,116452,45971,70481,7.2,18.1,133085,54329,78756,8.5,20.7,-16633,-2.6,36.2,2514,2523,21338.5,0
1989,15,482595,488621,4977026,4930523,78809,16.2,74595,15.3,1322354,404974,917380,8.2,26.8,1229348,430085,799263,8.7,24.9,93006,1.9,49.8,49721,49743,272043,0
1989,20,293253,351590,19400792,19241568,37337,10.6,36351,10.4,2554087,766398,1787689,4,13.3,2235640,780039,1455601,4.1,11.6,318447,1.7,23.2,23812,24008,339358.5,0
1989,40,152617,212464,5414430,5342671,30488,14.5,25969,12.4,957087,330861,626226,6.2,17.9,813568,301074,512494,5.6,15.2,143519,2.7,30.4,16150,16361,127582.5,0
1989,50,338938,446829,6147922,6060684,49360,11.1,44329,10,1101426,384648,716778,6.3,18.2,926949,385482,541467,6.4,15.3,174477,2.9,30.6,25790,26024,164498,0
1989,52,931454,1374282,19258554,18936628,180545,13.2,173128,12.6,3907762,1884264,2023498,10,20.6,3263909,1330600,1933309,7,17.2,643853,3.4,34.4,109576,111535,722161.5,0
1989,60,347149,484657,6760947,6681765,60893,12.6,58720,12.1,1236122,489781,746341,7.3,18.5,1077759,421237,656522,6.3,16.1,158363,2.4,32.2,31264,31448,190930,0
1989,70,1616946,1829496,27312317,26656556,226901,12.5,197942,10.9,5232644,1887130,3345514,7.1,19.6,3921123,1540798,2380325,5.8,14.7,1311521,4.9,29.4,128490,129279,853317,0
1990,07,69277,70478,543660,520967,12697,18.7,6889,10.2,155749,63040,92709,12.1,29.9,110363,34164,76199,6.6,21.2,45386,8.7,42.4,4840,4853,23380,0
1990,10,21190,26617,646434,640038,3142,11.7,3277,12.3,114090,35739,78351,5.6,17.8,101298,38356,62942,6,15.8,12792,2,31.6,2162,2180,18297,0
1990,15,497414,503382,5132315,5040427,86073,17.4,65445,13.2,1382635,447930,934705,8.9,27.4,1198859,373869,824990,7.4,23.8,183776,3.6,47.6,48872,48901,281082,0
1990,20,297922,357220,19145088,19272678,38689,10.9,31395,8.9,2062371,634722,1427649,3.3,10.7,2317551,643412,1674139,3.3,12,-255180,-1.3,21.4,22774,22874,286742,0
1990,40,156765,217538,5562196,5486928,30225,14.1,23842,11.1,875438,284806,590632,5.2,16,724903,254441,470462,4.6,13.2,150535,2.8,26.4,15468,15540,113617,0
1990,50,346333,457378,6325407,6232020,51655,11.4,39086,8.6,1069221,385017,684204,6.2,17.2,882447,311461,570986,5,14.2,186774,3,28.4,24533,24678,153099,0
1990,52,937897,1390311,19634690,19431062,179612,13,157272,11.4,3617120,1704789,1912331,8.8,18.6,3209863,1250006,1959857,6.4,16.5,407257,2.1,33,104045,105107,706826,0
1990,60,353855,495468,6875645,6806030,61059,12.5,47526,9.7,1202073,474110,727963,7,17.7,1062844,367027,695817,5.4,15.6,139229,2.1,31.2,28693,28936,164152,0
1990,70,1665476,1889775,28687855,27988060,240876,13,168228,9,5166217,1827763,3338454,6.5,18.5,3766627,1318259,2448368,4.7,13.5,1399590,5,27,119760,120216,774504,0
1991,07,72252,73495,596080,567860,10875,15.1,7774,10.8,181879,49767,132112,8.8,32,125438,36536,88902,6.4,22.1,56441,9.9,44.2,4907,4910,23340,0
1991,10,21325,26743,647482,647606,3174,11.9,3153,11.8,108396,42349,66047,6.5,16.7,108644,39205,69439,6.1,16.8,-248,-0.1,33.4,1959,1962,16805,0
1991,15,491820,497821,4592824,4861914,71653,14.3,75820,15.1,987601,328650,658951,6.8,20.3,1525781,420012,1105769,8.6,31.4,-538180,-11.1,40.6,50294,50332,283649,0
1991,20,298096,357630,18291276,18700101,34129,9.5,33770,9.4,1820945,571672,1249273,3.1,9.7,2638595,744948,1893647,4,14.1,-817650,-4.4,19.4,23188,23405,315197,0
1991,40,159010,226271,5583202,5566325,34810,15.7,25938,11.7,961517,410741,550776,7.4,17.3,927763,298727,629036,5.4,16.7,33754,0.6,33.4,15357,15572,123058,0
1991,50,351836,464776,6222716,6272822,50349,10.9,43028,9.3,951159,364419,586740,5.8,15.2,1051371,357667,693704,5.7,16.8,-100212,-1.6,30.4,24945,25253,165803,0
1991,52,942127,1398030,19402191,19518534,171731,12.3,164148,11.8,3315792,1624647,1691145,8.3,17,3548479,1311330,2237149,6.7,18.2,-232687,-1.2,34,100495,103376,716997,0
1991,60,353354,525398,6866475,6864336,82964,16.3,53041,10.4,1457482,809785,647697,11.8,21.2,1453204,478248,974956,7,21.2,4278,0,42.4,29716,29967,233013,0
1991,70,1709792,1946732,29202525,28956430,233172,12.2,176678,9.2,4824946,1795259,3029687,6.2,16.7,4332756,1474651,2858105,5.1,15,492190,1.7,30,116297,117304,861106,0
1992,07,74385,75685,576315,568792,11224,15.1,8140,10.9,147975,48696,99279,8.6,26,132928,57373,75555,10.1,23.4,15047,2.6,46.8,5483,5490,24023,0
1992,10,20395,25601,598428,621839,2693,10.3,3617,13.8,96776,36547,60229,5.9,15.6,143597,50205,93392,8.1,23.1,-46821,-7.5,31.2,2289,2302,18910,0
1992,15,487232,493272,4453954,4508400,75319,15.2,71890,14.5,1095607,323166,772441,7.2,24.3,1204498,349665,854833,7.8,26.7,-108891,-2.4,48.6,50993,51022,248674,0
1992,20,294846,353481,18039154,18155155,32212,9.1,34291,9.6,2007111,525847,1481264,2.9,11.1,2239114,672938,1566176,3.7,12.3,-232003,-1.2,22.2,24183,24345,281984,0
1992,40,160601,233732,5494976,5529383,35902,15.6,26703,11.6,883108,346609,536499,6.3,16,951922,294991,656931,5.3,17.2,-68814,-1.2,32,16347,16482,117048,0
1992,50,352610,464756,6148160,6184074,49042,10.5,47752,10.3,1041768,346101,695667,5.6,16.8,1113596,407756,705840,6.6,18,-71828,-1.2,33.6,27581,28613,167485,0
1992,52,935256,1394172,19336925,19363936,175661,12.6,176624,12.6,3391794,1591519,1800275,8.2,17.5,3445816,1347679,2098137,7,17.8,-54022,-0.3,35,106963,110826,696627,0
1992,60,355110,538619,6773908,6794596,68857,12.9,52521,9.9,1296722,506089,790633,7.4,19.1,1338098,445026,893072,6.5,19.7,-41376,-0.6,38.2,28500,29289,178740,0
1992,70,1734745,1991620,30263358,29722695,242488,12.3,191208,9.7,5525606,2011909,3513697,6.8,18.6,4444282,1619612,2824670,5.4,15,1081324,3.6,30,128495,129991,952687,0
1993,07,76292,77552,591861,582041,10466,13.7,8109,10.6,152708,45003,107705,7.7,26.2,133068,42869,90199,7.4,22.9,19640,3.3,45.8,5514,5516,26341,0
1993,10,19782,24921,551041,574722,2618,10.4,3216,12.7,89544,31542,58002,5.5,15.6,136908,50834,86074,8.8,23.8,-47364,-8.2,31.2,2074,2081,16780,0
1993,15,496337,502167,4485548,4464218,78230,15.7,66106,13.3,1141524,329184,812340,7.4,25.6,1098865,325783,773082,7.3,24.6,42659,1,49.2,48228,48247,239619,0
1993,20,297124,355216,18018391,18041389,33587,9.5,31191,8.8,1996320,494519,1501801,2.7,11.1,2042316,583054,1459262,3.2,11.3,-45996,-0.2,22.2,22508,22599,239019,0
1993,40,166098,238685,5568754,5534215,31579,13.4,26198,11.1,843041,262012,581029,4.7,15.2,773964,257458,516506,4.7,14,69077,1.2,28,15826,16001,101865,0
1993,50,356280,467194,6166502,6154999,45927,9.9,42283,9.1,961409,288292,673117,4.7,15.6,938405,316494,621911,5.1,15.2,23004,0.4,30.4,26814,27123,151522,0
1993,52,941347,1390544,19845878,19593490,157822,11.3,159530,11.5,3588172,1471976,2116196,7.5,18.3,3083397,1212565,1870832,6.2,15.7,504775,2.6,31.4,101028,102723,615561,0
1993,60,362106,540649,6698611,6704337,58681,10.9,53851,10,1205146,449115,756031,6.7,18,1216599,490834,725765,7.3,18.1,-11453,-0.1,36,26840,27615,126767,0
1993,70,1770200,2028634,31322699,30792630,226558,11.3,184050,9.2,5331025,1731760,3599265,5.6,17.3,4270887,1393596,2877291,4.5,13.9,1060138,3.4,27.8,129505,130139,779245,0
1994,07,79032,80345,581480,583972,11441,14.5,8149,10.3,145956,47147,98809,8.1,25,150939,42896,108043,7.3,25.8,-4983,-0.8,50,5686,5686,24656,0
1994,10,19337,24456,546882,549512,2425,9.8,2881,11.7,87581,31038,56543,5.6,15.9,92841,31751,61090,5.8,16.9,-5260,-1,31.8,1893,1900,13623,0
1994,15,511280,517267,4660579,4565648,82820,16.2,64775,12.7,1210428,360873,849555,7.9,26.5,1020567,317306,703261,6.9,22.4,189861,4.1,44.8,47394,47399,234167,0
1994,20,298595,357330,18018901,18019332,34139,9.6,31108,8.7,1983874,529402,1454472,2.9,11,1984737,609479,1375258,3.4,11,-863,0,22,22560,22663,259732,0
1994,40,172087,246656,5671502,5618837,34720,14.3,26110,10.8,845172,293559,551613,5.2,15,739843,251441,488402,4.5,13.2,105329,1.8,26.4,16516,16669,106681,0
1994,50,359596,471243,6244248,6201068,47741,10.2,42353,9,974099,301158,672941,4.9,15.7,887740,322301,565439,5.2,14.3,86359,1.4,28.6,27135,27473,153779,0
1994,52,942830,1397835,20167356,19996725,166478,11.9,155735,11.2,3523974,1685527,1838447,8.4,17.6,3182712,1198503,1984209,6,15.9,341262,1.7,31.8,102978,103998,626202,0
1994,60,372409,557033,6884086,6787183,68822,12.5,51559,9.4,1291312,521151,770161,7.7,19,1097507,413232,684275,6.1,16.2,193805,2.8,32.4,26422,26679,116417,0
1994,70,1803745,2069932,32169961,31697840,238942,11.7,189725,9.3,5251814,1812384,3439430,5.7,16.6,4307572,1496052,2811520,4.7,13.6,944242,3,27.2,132306,132958,872085,0
1995,07,83044,84424,613963,597220,12726,15.5,8220,10,146956,48549,98407,8.1,24.6,113470,34951,78519,5.9,19,33486,5.6,38,5796,5796,23554,0
1995,10,18892,23851,545573,546310,2267,9.4,2747,11.4,94035,27189,66846,5,17.2,95508,34914,60594,6.4,17.5,-1473,-0.3,34.4,1775,1788,14423,0
1995,15,531161,537238,4972545,4810040,87886,16.7,64520,12.2,1253162,373894,879268,7.8,26.1,928153,303536,624617,6.3,19.3,325009,6.8,38.6,47998,48004,230024,0
1995,20,301198,360813,18535450,18275916,34356,9.6,29997,8.4,2180887,533202,1647685,2.9,11.9,1661818,509442,1152376,2.8,9.1,519069,2.8,18.2,22073,22125,228342,0
1995,40,179508,255265,5885625,5775914,36282,14.5,26833,10.7,941342,324549,616793,5.6,16.3,721919,239512,482407,4.1,12.5,219423,3.8,25,16935,17038,108169,0
1995,50,365947,479064,6511580,6374914,50021,10.5,40859,8.6,1070676,331248,739428,5.2,16.8,797343,290696,506647,4.6,12.5,273333,4.3,25,26133,26369,143076,0
1995,52,948350,1406356,20953573,20546089,170362,12.2,157745,11.3,3794883,1792900,2001983,8.7,18.5,2979915,1239912,1740003,6,14.5,814968,4,29,101089,102290,612963,0
1995,60,376334,567887,6835245,6839323,66303,11.8,52277,9.3,1065909,431481,634428,6.3,15.6,1074066,349230,724836,5.1,15.7,-8157,-0.1,31.2,28932,29425,133241,0
1995,70,1844100,2121708,33631756,32891080,251801,12,191877,9.2,5678823,2038559,3640264,6.2,17.3,4197471,1434946,2762525,4.4,12.8,1481352,4.5,25.6,135465,136187,836275,0
1996,07,85666,87158,655814,635966,11973,14,8915,10.4,147379,50083,97296,7.9,23.2,107682,38013,69669,6,16.9,39697,6.3,33.8,6210,6210,24928,0
1996,10,18354,23290,527860,536897,2224,9.4,2733,11.6,77285,22426,54859,4.2,14.4,95358,36253,59105,6.8,17.8,-18073,-3.4,28.8,1780,1781,16440,0
1996,15,541120,547195,5130108,5052076,81579,15,69140,12.8,1185724,356690,829034,7.1,23.5,1029660,324671,704989,6.4,20.4,156064,3.1,40.8,50501,50501,238599,0
1996,20,302231,362191,18445513,18520461,32773,9.1,31378,8.7,1912135,537114,1375021,2.9,10.3,2062032,612087,1449945,3.3,11.1,-149897,-0.8,20.6,22544,22547,239317,0
1996,40,184507,260951,5986620,5936677,37281,14.4,30981,12,984983,364249,620734,6.1,16.6,885097,331347,553750,5.6,14.9,99886,1.7,29.8,18670,18673,114302,0
1996,50,370549,485416,6577346,6548634,51611,10.7,44828,9.3,1021034,340016,681018,5.2,15.6,963610,356772,606838,5.4,14.7,57424,0.9,29.4,27908,27913,159967,0
1996,52,953769,1417740,21350360,21148427,171547,12.2,158018,11.2,3692516,1783797,1908719,8.4,17.5,3288650,1281772,2006878,6.1,15.6,403866,1.9,31.2,103729,103760,647475,0
1996,60,383884,576538,6989480,6914505,64108,11.2,53516,9.4,1181363,451306,730057,6.5,17.1,1031413,371458,659955,5.4,14.9,149950,2.2,29.8,28232,28236,120096,0
1996,70,1883981,2170659,34681324,34167395,258620,12.1,204041,9.5,5840082,2157490,3682592,6.3,17.1,4812225,1676335,3135890,4.9,14.1,1027857,3,28.2,141023,141058,896538,0
1997,07,88688,90398,701547,679548,12800,14.4,9263,10.4,167148,52728,114420,7.8,24.6,123150,45569,77581,6.7,18.1,43998,6.5,36.2,6437,6437,30017,0
1997,10,18184,23079,525657,528405,2483,10.7,2676,11.5,102241,33892,68349,6.4,19.3,107736,43514,64222,8.2,20.4,-5495,-1.1,38.6,1561,1561,17784,0
1997,15,554776,560785,5424991,5273873,83858,15.1,68019,12.3,1309152,378428,930724,7.2,24.8,1006916,341469,665447,6.5,19.1,302236,5.7,38.2,49818,49818,241550,0
1997,20,302074,361244,18519338,18480252,32171,8.9,32587,9,2105250,495599,1609651,2.7,11.4,2027079,723510,1303569,3.9,11,78171,0.4,22,22584,22584,246660,0
1997,40,187195,266027,6145262,6068123,38364,14.5,33462,12.7,1079581,394305,685276,6.5,17.8,925304,346611,578693,5.7,15.2,154277,2.6,30.4,19912,19914,134354,0
1997,50,371218,486774,6720936,6651637,49743,10.2,48620,10,1163408,351604,811804,5.3,17.5,1024810,404391,620419,6.1,15.4,138598,2.1,30.8,28664,28665,168022,0
1997,52,951883,1423849,21773294,21573606,182749,12.8,178439,12.5,4111886,1929397,2182489,8.9,19.1,3712512,1483914,2228598,6.9,17.2,399374,1.9,34.4,106550,106550,677375,0
1997,60,391832,594362,7197466,7095563,82826,14.1,64988,11.1,1553935,666402,887533,9.4,21.9,1350130,606098,744032,8.5,19,203805,2.9,38,28923,28923,154336,0
1997,70,1919729,2235026,36176080,35471948,288902,13.1,224629,10.2,6924241,2573322,4350919,7.3,19.5,5515976,1997308,3518668,5.6,15.6,1408265,3.9,31.2,148229,148232,1014271,0
1998,07,90752,92524,713013,707111,12442,13.6,9968,10.9,151152,52162,98990,7.4,21.4,139348,46663,92685,6.6,19.7,11804,1.7,39.4,6943,6943,29444,0
1998,10,17826,22609,518046,521753,2218,9.7,2623,11.5,94792,29262,65530,5.6,18.2,102206,39843,62363,7.6,19.6,-7414,-1.4,36.4,1551,1551,17556,0
1998,15,561601,567885,5602033,5507073,80699,14.3,71032,12.6,1263051,369348,893703,6.7,22.9,1073131,351920,721211,6.4,19.5,189920,3.4,39,51696,51696,254345,0
1998,20,300791,360666,18723465,18618213,31743,8.8,31687,8.8,2103216,526461,1576755,2.8,11.3,1892713,595009,1297704,3.2,10.2,210503,1.1,20.4,22598,22598,244347,0
1998,40,188821,273623,6304998,6225600,40549,15,32342,12,1068563,404815,663748,6.5,17.2,909768,365283,544485,5.9,14.6,158795,2.6,29.2,20576,20576,148141,0
1998,50,366677,482282,6830103,6775586,43590,9,47058,9.7,1074514,305689,768825,4.5,15.9,965480,370816,594664,5.5,14.2,109034,1.7,28.4,29988,29988,174611,0
1998,52,945180,1417818,22088335,21921654,158233,11.1,161215,11.3,3707122,1603429,2103693,7.3,16.9,3373760,1378738,1995022,6.3,15.4,333362,1.5,30.8,105382,105382,660909,0
1998,60,397698,601773,7305430,7253413,72669,12.2,64160,10.7,1375651,511322,864329,7,19,1271617,534374,737243,7.4,17.5,104034,1.5,35,30217,30237,147109,0
1998,70,1948824,2274815,37617744,36869773,269612,12,223718,9.9,6619187,2277335,4341852,6.2,18,5123246,1840524,3282722,5,13.9,1495941,4.1,27.8,152958,152958,986224,0
1999,07,93234,95092,769049,739185,12656,13.5,9880,10.5,179206,50516,128690,6.8,24.2,119477,45219,74258,6.1,16.2,59729,8,32.4,6784,6784,31952,0
1999,10,16800,21664,478736,497931,1918,8.7,2744,12.4,65174,20100,45074,4,13.1,103565,33576,69989,6.7,20.8,-38391,-7.7,26.2,1695,1695,13668,0
1999,15,572343,578905,5965608,5780240,80159,14,68085,11.9,1385708,377539,1008169,6.5,24,1014972,359745,655227,6.2,17.6,370736,6.4,35.2,48992,48992,256471,0
1999,20,296135,356831,18387655,18549085,29204,8.1,32574,9.1,1838690,495505,1343185,2.7,9.9,2161549,655736,1505813,3.5,11.7,-322859,-1.8,19.8,22954,22954,262645,0
1999,40,190887,277560,6491292,6401732,38901,14.1,34904,12.7,1123439,442067,681372,6.9,17.5,944318,397689,546629,6.2,14.8,179121,2.7,29.6,20697,20697,133378,0
1999,50,360442,477162,6946041,6883721,41692,8.7,45938,9.6,1084073,341276,742797,5,15.7,959432,376350,583082,5.5,13.9,124641,1.8,27.8,29377,29377,170206,0
1999,52,937309,1411628,22432722,22259107,151883,10.7,156571,11.1,3674135,1634391,2039744,7.3,16.5,3326905,1313029,2013876,5.9,14.9,347230,1.6,29.8,101769,101769,644522,0
1999,60,404546,617850,7496542,7399465,80307,13.2,63519,10.4,1490917,607060,883857,8.2,20.1,1296763,573340,723423,7.7,17.5,194154,2.6,35,31093,31093,144112,0
1999,70,1966813,2306434,39066140,38530238,262375,11.5,228755,10,6663670,2300418,4363252,6,17.3,5591866,2141223,3450643,5.6,14.5,1071804,2.8,29,152724,152724,1025918,0
2000,07,95769,97605,794136,774933,12986,13.5,10497,10.9,177518,56113,121405,7.2,22.9,139111,57777,81334,7.5,18,38407,4.9,36,6899,6899,36824,0
2000,10,16589,21572,468443,472920,2126,9.8,2236,10.3,79108,22177,56931,4.7,16.7,88062,26413,61649,5.6,18.6,-8954,-1.9,33.4,1363,1363,9555,0
2000,15,576433,583389,6330954,6147850,75648,13,71532,12.3,1440252,368748,1071504,6,23.4,1074044,365282,708762,5.9,17.5,366208,5.9,35,49509,49509,256115,0
2000,20,291728,353225,18280775,18334487,29466,8.3,33229,9.4,2041890,554891,1486999,3,11.1,2149315,722069,1427246,3.9,11.7,-107425,-0.6,22.2,22365,22365,243157,0
2000,40,190307,279829,6754141,6620068,39498,14.2,37276,13.4,1199167,462860,736307,7,18.1,931020,398335,532685,6,14.1,268147,4,28.2,21077,21077,130668,0
2000,50,354613,470306,7027373,6986283,40535,8.6,47378,10,1124528,352190,772338,5,16.1,1042348,452576,589772,6.5,14.9,82180,1.2,29.8,27827,27827,186677,0
2000,52,933598,1414229,23027541,22731838,154485,10.9,152922,10.8,3865547,1694429,2171118,7.5,17,3274141,1355075,1919066,6,14.4,591406,2.6,28.8,96503,96516,605911,0
2000,60,407340,623642,7583608,7542370,75836,12.2,70488,11.4,1411676,572727,838949,7.6,18.7,1329200,523707,805493,6.9,17.6,82476,1.1,35.2,31656,31656,141107,0
2000,70,1978440,2327589,40912021,39994137,257372,11.1,236802,10.2,7303233,2463671,4839562,6.2,18.3,5467467,2158397,3309070,5.4,13.7,1835766,4.6,27.4,148935,148935,983223,0
2001,07,97457,99664,834303,814982,12839,13,11362,11.5,186020,71281,114739,8.7,22.8,147377,57329,90048,7,18.1,38643,4.7,36.2,6874,6874,32789,0
2001,10,16794,21776,488645,479519,2197,10.1,2178,10,87244,24634,62610,5.1,18.2,68991,24654,44337,5.1,14.4,18253,3.8,28.8,1211,1211,9107,0
2001,15,574585,581929,6372618,6364656,71320,12.2,77465,13.3,1282790,365467,917323,5.7,20.2,1266867,427595,839272,6.7,19.9,15923,0.3,39.8,49562,49564,266142,0
2001,20,287031,348513,17763714,18041082,27284,7.8,33628,9.6,1757377,488137,1269240,2.7,9.7,2312114,662426,1649688,3.7,12.8,-554737,-3.1,19.4,21747,21749,234567,0
2001,40,189139,287567,6819436,6796879,44011,15.5,37911,13.4,1135619,498754,636865,7.3,16.7,1090507,402171,688336,5.9,16,45112,0.7,32,20776,20782,136315,0
2001,50,347210,465044,7073602,7059572,41065,8.8,48373,10.3,1103025,385595,717430,5.5,15.6,1074965,397705,677260,5.6,15.2,28060,0.4,30.4,27699,27731,165418,0
2001,52,930169,1414037,23081185,23082070,151232,10.7,157693,11.2,3549486,1584772,1964714,6.9,15.4,3551256,1350353,2200903,5.9,15.4,-1770,0,30.8,95748,95884,615107,0
2001,60,412449,635141,7967081,7797636,78301,12.4,70198,11.2,1655202,691971,963231,8.9,21.2,1316313,566892,749421,7.3,16.9,338889,4.3,33.8,31769,31777,149672,0
2001,70,1997204,2356154,41680165,41402979,259823,11.1,246199,10.5,6795196,2326056,4469140,5.6,16.4,6240824,2219027,4021797,5.4,15.1,554372,1.3,30.2,148232,148386,986725,0
2002,07,98777,101647,868401,861032,14703,14.5,14764,14.5,188428,70598,117830,8.2,21.9,173690,72059,101631,8.4,20.2,14738,1.7,40.4,6738,6741,31912,0
2002,10,17081,22217,479125,487702,2467,11.1,2492,11.2,86233,33976,52257,7,17.7,103387,39140,64247,8,21.2,-17154,-3.5,35.4,1174,1174,10441,0
2002,15,571044,578933,6210614,6307204,76958,13.2,81877,14.1,1238868,387303,851565,6.1,19.6,1432049,430162,1001887,6.8,22.7,-193181,-3.1,39.2,47811,47826,259016,0
2002,20,282435,341848,16259789,17037776,28927,8.3,38127,11,1613139,604805,1008334,3.5,9.5,3169113,937082,2232031,5.5,18.6,-1555974,-9.1,19,22624,22719,283911,0
2002,40,189432,291090,6671716,6788203,43435,14.9,44513,15.3,1167773,610427,557346,9,17.2,1400747,474409,926338,7,20.6,-232974,-3.4,34.4,20977,21024,132828,0
2002,50,348345,464313,6911996,6999468,49656,10.6,55502,11.9,1203814,497772,706042,7.1,17.2,1378760,529683,849077,7.6,19.7,-174946,-2.5,34.4,26634,26755,166977,0
2002,52,946959,1439853,23417537,23371391,181562,12.7,171353,11.9,4059713,1944564,2115149,8.3,17.4,3967423,1467370,2500053,6.3,17,92290,0.4,34,94498,94886,603201,0
2002,60,427973,660482,8387094,8256176,87496,13.4,73765,11.3,1725652,758489,967163,9.2,20.9,1463817,562972,900845,6.8,17.7,261835,3.2,35.4,30077,30122,140648,0
2002,70,2049703,2435650,42351910,42400163,309487,12.8,268955,11.1,7547600,2910247,4637353,6.9,17.8,7644106,2881532,4762574,6.8,18,-96506,-0.2,35.6,148125,148592,1061249,0
2003,07,99748,102736,887329,870841,14749,14.5,11577,11.4,181333,64639,116694,7.4,20.8,148356,46442,101914,5.3,17,32977,3.8,34,6639,6639,28546,0
2003,10,16647,21486,449667,458184,2040,9.5,1940,9,72654,25946,46708,5.7,15.9,89690,28376,61314,6.2,19.6,-17036,-3.7,31.8,1267,1277,11616,0
2003,15,555411,563294,6068286,6117363,64941,11.4,71928,12.6,1189145,301028,888117,4.9,19.4,1287299,363821,923478,5.9,21,-98154,-1.6,38.8,48636,48638,252491,0
2003,20,276349,333693,15645435,15856035,25919,7.7,29120,8.7,1594778,462279,1132499,2.9,10.1,2015977,549761,1466216,3.5,12.7,-421199,-2.6,20.2,21557,21667,266093,0
2003,40,187656,290099,6566306,6476433,40311,14,35125,12.2,1189575,544899,644676,8.4,18.4,1009828,384648,625180,5.9,15.6,179747,2.8,31.2,20818,20864,126206,0
2003,50,345534,457903,6887248,6845646,40652,8.9,38685,8.4,1029441,318197,711244,4.6,15,946238,303326,642912,4.4,13.8,83203,1.2,27.6,26027,26179,169770,0
2003,52,953915,1447750,23913125,23497780,164785,11.5,128515,9,3909157,1678449,2230708,7.1,16.6,3078467,1023580,2054887,4.4,13.1,830690,3.5,26.2,94242,94521,641297,0
2003,60,439838,683104,8392678,8348663,93059,13.9,59471,8.9,1582734,654699,928035,7.8,19,1494705,529475,965230,6.3,17.9,88029,1.1,35.8,30861,30929,151913,0
2003,70,2097434,2480928,43136734,42527413,299459,12.2,215602,8.8,7119716,2392446,4727270,5.6,16.7,5901073,1843164,4057909,4.3,13.9,1218643,2.8,27.8,147814,149141,1054215,0
2004,07,102974,106047,934951,909348,15589,14.9,11479,11,193953,63928,130025,7,21.3,142746,52563,90183,5.8,15.7,51207,5.6,31.4,6782,6782,33137,0
2004,10,16927,21616,467241,456773,2091,9.7,1758,8.2,80930,28567,52363,6.3,17.7,59995,21206,38789,4.6,13.1,20935,4.6,26.2,1022,1024,8567,0
2004,15,544138,551693,6134457,6079240,61275,11,67756,12.2,1227776,265983,961793,4.4,20.2,1117342,347473,769869,5.7,18.4,110434,1.8,36.8,47634,47639,255195,0
2004,20,272485,328789,15200310,15343805,25615,7.8,27248,8.2,1508964,411660,1097304,2.7,9.8,1795954,527701,1268253,3.4,11.7,-286990,-1.9,19.6,19937,19989,251998,0
2004,40,187888,290587,6531257,6536074,38264,13.2,34254,11.8,1057424,383069,674355,5.9,16.2,1067060,383154,683906,5.9,16.3,-9636,-0.1,32.4,19169,19219,127113,0
2004,50,343958,456998,6919688,6872810,40191,8.8,37156,8.1,991026,318826,672200,4.6,14.4,897270,308982,588288,4.5,13.1,93756,1.3,26.2,24838,24967,149631,0
2004,52,963329,1454547,24475568,24084231,160122,11.1,136677,9.5,3936379,1567767,2368612,6.5,16.3,3153705,1171913,1981792,4.9,13.1,782674,3.2,26.2,95922,96574,651189,0
2004,60,453994,694379,8457308,8392069,86178,12.6,67403,9.8,1534396,620255,914141,7.4,18.3,1403918,570746,833172,6.8,16.7,130478,1.6,33.4,30810,30909,155294,0
2004,70,2161061,2553499,43987750,43395274,310080,12.3,214633,8.5,6821205,2399437,4421768,5.5,15.7,5636255,1892776,3743479,4.4,13,1184950,2.7,26,145385,145851,1024729,0
2005,07,106317,109499,953740,943015,15831,14.7,11775,10.9,185357,66988,118369,7.1,19.7,163907,49926,113981,5.3,17.4,21450,2.3,34.8,7086,7086,32190,0
2005,10,17502,22308,483740,473752,2435,11.1,1585,7.2,84897,27782,57115,5.9,17.9,64921,21006,43915,4.4,13.7,19976,4.2,27.4,1022,1022,11672,0
2005,15,530435,538070,6072412,6093484,57300,10.5,67582,12.4,1161940,282068,879872,4.6,19.1,1204084,362653,841431,6,19.8,-42144,-0.7,38.2,49079,49084,266677,0
2005,20,270910,326558,15098610,15099096,25464,7.8,25200,7.7,1586126,423124,1163002,2.8,10.5,1587098,460817,1126281,3.1,10.5,-972,0,21,18690,18730,234302,0
2005,40,190765,293600,6508702,6512535,37756,13,32287,11.1,960350,391678,568672,6,14.7,968017,325244,642773,5,14.9,-7667,-0.2,29.4,18591,18749,140487,0
2005,50,343382,459683,6954076,6918124,42050,9.2,35976,7.9,987769,343815,643954,5,14.3,915866,295535,620331,4.3,13.2,71903,1.1,26.4,24866,24939,153355,0
2005,52,977074,1478187,24779574,24534829,172240,11.8,132289,9.1,3874365,1846348,2028017,7.5,15.8,3384874,1054024,2330850,4.3,13.8,489491,2,27.6,100909,101439,740130,0
2005,60,471386,718666,8427140,8407771,101835,14.5,70344,10,1488008,706622,781386,8.4,17.7,1449269,608310,840959,7.2,17.2,38739,0.5,34.4,33018,33142,178301,0
2005,70,2239423,2643802,45111341,44425653,327515,12.6,216260,8.3,7065696,2614414,4451282,5.9,15.9,5694319,1833621,3860698,4.1,12.8,1371377,3.1,25.6,149428,149875,1130609,0
2006,07,110405,113947,1015045,983326,17874,16,12849,11.5,225980,83881,142099,8.5,23,162542,68887,93655,7,16.5,63438,6.5,33,7966,7968,50607,0
2006,10,18412,23593,545965,513720,3187,13.9,1749,7.6,123076,47456,75620,9.2,24,58586,26096,32490,5.1,11.4,64490,12.6,22.8,1081,1083,12389,0
2006,15,524221,532127,6353967,6205217,57712,10.8,61185,11.4,1301310,281208,1020102,4.5,21,1003810,307248,696562,5,16.2,297500,4.8,32.4,43046,43111,222034,0
2006,20,268586,325111,15052486,15029056,26516,8.2,25803,7.9,1596109,450640,1145469,3,10.6,1549248,467657,1081591,3.1,10.3,46861,0.3,20.6,18853,18897,246076,0
2006,40,192682,298415,6599025,6533283,40877,13.9,32210,10.9,1021352,403406,617946,6.2,15.6,889867,294067,595800,4.5,13.6,131485,2,27.2,19270,19319,132307,0
2006,50,341543,461949,7030548,6975873,43174,9.4,37887,8.2,1012595,335031,677564,4.8,14.5,903245,327315,575930,4.7,12.9,109350,1.6,25.8,24884,24974,177165,0
2006,52,969710,1483628,25423476,25019103,168944,11.4,148292,10,4074543,1882761,2191782,7.5,16.3,3265798,1136191,2129607,4.5,13.1,808745,3.2,26.2,109996,110417,761276,0
2006,60,482903,744360,8682094,8530958,104134,14.3,71258,9.8,1583182,694109,889073,8.1,18.6,1280909,533878,747031,6.3,15,302273,3.6,30,38146,38275,207056,0
2006,70,2284023,2709586,46975310,45909964,343927,12.9,254477,9.5,7743541,2791908,4951633,6.1,16.9,5612850,2009170,3603680,4.4,12.2,2130691,4.7,24.4,171052,171691,1241236,0
2007,07,113693,117489,1031582,1023716,16579,14.3,13433,11.6,196407,69413,126994,6.8,19.2,180675,57480,123195,5.6,17.6,15732,1.6,35.2,7800,7805,33519,0
2007,10,19403,24739,703183,623241,3285,13.6,2071,8.6,243128,72390,170738,11.6,39,83243,36309,46934,5.8,13.4,159885,25.6,26.8,1126,1132,16784,0
2007,15,512749,520437,6113342,6228400,49234,9.4,61001,11.6,1035070,218591,816479,3.5,16.6,1265186,310961,954225,5,20.3,-230116,-3.7,33.2,42585,42623,208728,0
2007,20,266987,322262,14721613,14844605,23968,7.4,25697,8,1500049,398314,1101735,2.7,10.1,1746033,502197,1243836,3.4,11.8,-245984,-1.7,20.2,17622,17709,218649,0
2007,40,195096,303057,6716839,6644532,41224,13.7,35184,11.7,1132130,442031,690099,6.7,17,987515,368761,618754,5.5,14.9,144615,2.1,29.8,18902,19090,111567,0
2007,50,340025,461639,7001209,7001049,41951,9.1,41182,8.9,1078763,353596,725167,5.1,15.4,1078444,374970,703474,5.4,15.4,319,0,30.8,23792,24261,147477,0
2007,52,977124,1507373,25549053,25427381,181486,12.2,153140,10.3,4218262,1891879,2326383,7.4,16.6,3974919,1256259,2718660,4.9,15.6,243343,1,31.2,102580,104538,717168,0
2007,60,487866,762924,8684724,8655330,102758,13.7,79616,10.6,1631335,690644,940691,8,18.8,1572549,607745,964804,7,18.2,58786,0.6,36.4,41516,42120,190586,0
2007,70,2339993,2775724,47928063,47384682,335718,12.2,266420,9.7,7865188,2606690,5258498,5.5,16.6,6778426,2275750,4502676,4.8,14.3,1086762,2.3,28.6,168742,170473,1097834,0
2008,07,115337,119301,1031553,1029785,16051,13.6,14001,11.8,178255,64991,113264,6.3,17.3,174719,55948,118771,5.4,17,3536,0.3,34,8500,8502,37051,0
2008,10,19888,25601,642882,671489,3067,12.2,2030,8.1,119285,42500,76785,6.3,17.8,176498,30650,145848,4.6,26.3,-57213,-8.5,35.6,1388,1389,15649,0
2008,15,486301,494116,5814638,5957146,41589,8.2,65811,13,946753,195528,751225,3.3,15.9,1231768,280604,951164,4.7,20.7,-285015,-4.8,31.8,46360,46366,205087,0
2008,20,261622,316319,14348103,14486976,21361,6.7,25195,7.9,1343307,352552,990755,2.4,9.3,1621054,410058,1210996,2.8,11.2,-277747,-1.9,18.6,18866,18916,217384,0
2008,40,192469,301067,6714142,6692787,35834,11.9,33805,11.3,921776,299323,622453,4.5,13.8,879067,257049,622018,3.8,13.1,42709,0.7,26.2,20561,20614,118328,0
2008,50,335012,457233,6963692,6959708,36464,8,36372,8,950368,293594,656774,4.2,13.7,942400,291589,650811,4.2,13.5,7968,0.2,27,24797,24882,161512,0
2008,52,970628,1506278,25717762,25519877,153144,10.2,137016,9.1,3822163,1598034,2224129,6.3,15,3426394,1053362,2373032,4.1,13.4,395769,1.6,26.8,107367,107637,758034,0
2008,60,470026,750157,8513197,8544086,81099,10.8,82928,11,1348019,562665,785354,6.6,15.8,1409797,494857,914940,5.8,16.5,-61778,-0.7,31.6,51215,51355,240942,0
2008,70,2355183,2799955,48695303,48174763,306099,11,261001,9.4,7302238,2518252,4783986,5.2,15.2,6261158,2030476,4230682,4.2,13,1041080,2.2,26,185010,185287,1236224,0
2009,07,112731,116982,974993,1000878,13293,11.3,15003,12.7,142115,53010,89105,5.3,14.2,193884,58526,135358,5.8,19.4,-51769,-5.2,28.4,8604,8604,36403,0
2009,10,19942,25814,633959,637988,2743,10.7,2365,9.2,107201,36104,71097,5.7,16.8,115258,29813,85445,4.7,18.1,-8057,-1.3,33.6,1506,1506,13852,0
2009,15,434988,442682,4879632,5334378,31006,6.6,76370,16.3,595398,140852,454546,2.6,11.2,1504889,302035,1202854,5.7,28.2,-909491,-17,22.4,50977,50986,210082,0
2009,20,250053,302768,12837447,13535767,17614,5.7,28334,9.2,975323,296057,679266,2.2,7.2,2371963,482512,1889451,3.6,17.5,-1396640,-10.3,14.4,19954,19983,221370,0
2009,40,184043,291912,6360605,6516209,30673,10.4,36536,12.4,716387,289181,427206,4.4,11,1027595,275860,751735,4.2,15.8,-311208,-4.8,22,21111,21277,116997,0
2009,50,322569,445478,6573054,6754435,31530,7,39797,8.8,708932,240633,468299,3.6,10.5,1071694,293797,777897,4.3,15.9,-362762,-5.4,21,26164,26209,150013,0
2009,52,946227,1480475,24459148,24958600,135680,9.1,144283,9.7,2917249,1392005,1525244,5.6,11.7,3916153,1095015,2821138,4.4,15.7,-998904,-4,23.4,108725,109653,740868,0
2009,60,443977,720129,8094874,8275095,64892,8.9,85789,11.7,1067744,435789,631955,5.3,12.9,1428187,479469,948718,5.8,17.3,-360443,-4.4,25.8,49062,49837,208494,0
2009,70,2317159,2761237,47061687,47752647,264177,9.5,283281,10.2,5793129,1936782,3856347,4.1,12.1,7175050,1988763,5186287,4.2,15,-1381921,-2.9,24.2,191644,191975,1135703,0
2010,07,112837,117270,987237,981206,13384,11.4,13056,11.1,168701,53508,115193,5.5,17.2,156638,50986,105652,5.2,16,12063,1.2,32,7199,7199,30833,0
2010,10,19414,25467,610561,620556,2340,9.1,2490,9.7,95391,34847,60544,5.6,15.4,115381,30282,85099,4.9,18.6,-19990,-3.2,30.8,1552,1552,16913,0
2010,15,402649,410301,4343628,4604824,33664,7.9,63791,15,642974,147051,495923,3.2,14,1165365,257758,907607,5.6,25.3,-522391,-11.3,28,39738,39744,174130,0
2010,20,240475,291485,11996035,12360684,16663,5.6,25707,8.7,963390,245393,717997,2,7.8,1692689,391378,1301311,3.2,13.7,-729299,-5.9,15.6,18258,18302,196733,0
2010,40,179566,286627,6146295,6237698,28600,9.9,31527,10.9,696204,251242,444962,4,11.2,879011,285085,593926,4.6,14.1,-182807,-2.9,22.4,17905,17954,110185,0
2010,50,315136,438090,6294651,6417341,31583,7.2,36022,8.2,682611,227339,455272,3.5,10.6,927991,249903,678088,3.9,14.5,-245380,-3.9,21.2,23278,23376,133211,0
2010,52,941271,1474340,24018148,24142572,131486,8.9,125879,8.6,2793299,1250151,1543148,5.2,11.6,3042147,913720,2128427,3.8,12.6,-248848,-1,23.2,92120,92810,644605,0
2010,60,437560,708138,7769427,7908334,65046,9.2,70198,9.9,1054191,411913,642278,5.2,13.3,1332004,434421,897583,5.5,16.8,-277813,-3.5,26.6,36681,36801,156244,0
2010,70,2306277,2759207,47054454,46950837,270306,9.8,258204,9.4,6167071,2193499,3973572,4.7,13.1,5959837,1788142,4171695,3.8,12.7,207234,0.4,25.4,170963,171293,1096752,0
2011,07,112575,117190,982700,984475,13678,11.7,13538,11.5,157805,53133,104672,5.4,16,161354,49290,112064,5,16.4,-3549,-0.4,32,7497,7497,30458,0
2011,10,19742,26022,664771,636812,2833,11,2177,8.5,136267,36870,99397,5.8,21.4,80349,23244,57105,3.7,12.6,55918,8.8,25.2,1424,1437,13920,0
2011,15,380622,388556,4122371,4227376,35914,9,55529,13.9,678698,133228,545470,3.2,16.1,888708,227307,661401,5.4,21,-210010,-4.9,32.2,34733,34755,154091,0
2011,20,235673,285970,12015926,11978511,18078,6.3,22128,7.7,1178421,247080,931341,2.1,9.8,1103592,356519,747073,3,9.2,74829,0.6,18.4,15632,15699,177016,0
2011,40,180918,289236,6226974,6173794,34974,12.2,29068,10.2,795517,287192,508325,4.7,12.9,689157,223210,465947,3.6,11.2,106360,1.7,22.4,16916,16959,93366,0
2011,50,310433,434784,6303801,6289266,32097,7.4,33101,7.6,739704,207175,532529,3.3,11.8,710636,223007,487629,3.5,11.3,29068,0.5,22.6,21673,21774,126886,0
2011,52,935740,1476890,24367283,24136938,138282,9.4,125986,8.6,3108947,1285140,1823807,5.3,12.9,2648256,893468,1754788,3.7,11,460691,1.9,22,92264,93018,619239,0
2011,60,430363,699581,7706370,7720243,63090,9,66494,9.5,1027419,379656,647763,4.9,13.3,1055167,374914,680253,4.9,13.7,-27748,-0.4,26.6,35005,35187,154164,0
2011,70,2307758,2765852,47972602,47417367,275876,10,251742,9.1,6576906,1980439,4596467,4.2,13.9,5466437,1732224,3734213,3.7,11.5,1110469,2.4,23,168294,168767,1026999,0
2012,07,117523,122312,1032151,1008878,16177,13.5,11814,9.9,189962,59257,130705,5.9,18.8,143416,48440,94976,4.8,14.2,46546,4.6,28.4,6753,6761,29121,0
2012,10,20573,27057,749008,706006,3212,12.1,2143,8.1,174460,51060,123400,7.2,24.7,88455,31054,57401,4.4,12.5,86005,12.2,25,1268,1280,13281,0
2012,15,377723,385217,4153090,4139615,38107,9.9,43736,11.3,730621,137002,593619,3.3,17.6,703670,206928,496742,5,17,26951,0.6,34,27290,27312,129034,0
2012,20,233785,283032,12108192,12041184,17257,6.1,20124,7.1,1196561,222232,974329,1.8,9.9,1062544,298916,763628,2.5,8.8,134017,1.1,17.6,13522,13613,147535,0
2012,40,184974,292329,6331535,6272213,32705,11.3,28890,10,826262,273475,552787,4.4,13.2,707620,241975,465645,3.9,11.3,118642,1.9,22.6,15520,15661,88578,0
2012,50,309715,432491,6386838,6341388,33680,7.8,36037,8.3,884677,230488,654189,3.6,14,793777,262866,530911,4.1,12.5,90900,1.5,25,19941,20338,115942,0
2012,52,950404,1490395,25001012,24643142,147641,10,132175,8.9,3582423,1417161,2165262,5.8,14.5,2866683,999956,1866727,4.1,11.6,715740,2.9,23.2,83792,85379,566177,0
2012,60,434811,711722,7812923,7737850,73965,10.5,60396,8.6,1178874,421536,757338,5.4,15.2,1028728,369406,659322,4.8,13.3,150146,1.9,26.6,29926,30407,133916,0
2012,70,2351296,2808639,49237718,48567613,293936,10.6,254623,9.1,7081683,2069881,5011802,4.3,14.6,5741472,1946263,3795209,4,11.8,1340211,2.8,23.6,154801,156384,967945,0
2013,07,117996,122863,1052081,1044574,13698,11.2,14189,11.6,166363,53189,113174,5.1,15.9,151349,56300,95049,5.4,14.5,15014,1.4,29,7068,7074,33899,0
2013,10,20686,27206,773591,759479,2751,10.2,2563,9.5,142422,39283,103139,5.2,18.8,114198,32834,81364,4.3,15,28224,3.8,30,1617,1617,16526,0
2013,15,371075,378473,4200701,4181803,33327,8.7,44168,11.6,700542,121231,579311,2.9,16.8,662747,181758,480989,4.3,15.8,37795,1,31.6,26132,26152,123456,0
2013,20,230110,278812,12189484,12128328,14985,5.3,19363,6.9,1118838,206639,912199,1.7,9.2,996527,259316,737211,2.1,8.2,122311,1,16.4,13615,13660,151906,0
2013,40,186697,296190,6442365,6377313,33484,11.4,29613,10.1,895396,301359,594037,4.7,14,765292,291392,473900,4.6,12,130104,2,24,15968,16082,96347,0
2013,50,306479,428967,6515668,6440834,29515,6.9,31735,7.4,880217,246076,634141,3.8,13.7,730550,242668,487882,3.8,11.3,149667,2.4,22.6,20696,20946,131024,0
2013,52,943276,1484521,25343603,25098646,120088,8.1,117923,8,3168225,1063611,2104614,4.2,12.6,2678311,884503,1793808,3.5,10.7,489914,1.9,21.4,84002,84727,591384,0
2013,60,442541,715375,7926039,7858688,66241,9.3,60817,8.6,1074611,371538,703073,4.7,13.7,939910,324464,615446,4.1,12,134701,1.7,24,29434,29688,137149,0
2013,70,2380008,2840367,50279112,49702031,278441,9.9,253322,9,6672358,1956614,4715744,3.9,13.4,5518196,1813365,3704831,3.6,11.1,1154162,2.3,22.2,162701,163427,1089729,0
2014,07,120126,125083,1086810,1068745,15473,12.5,13138,10.6,184815,63842,120973,6,17.3,148685,54522,94163,5.1,13.9,36130,3.4,27.8,7689,7693,34477,0
2014,10,21007,27596,794689,781376,3025,11.1,2448,9,151624,57363,94261,7.3,19.4,124998,47038,77960,6,16,26626,3.4,32,1596,1599,18300,0
2014,15,367762,375259,4295956,4240572,36648,9.7,39343,10.4,727362,144098,583264,3.4,17.2,616593,163816,452777,3.9,14.5,110769,2.7,29,25780,25788,113243,0
2014,20,226983,274756,12205372,12158407,15879,5.7,18693,6.8,1169869,231871,937998,1.9,9.6,1075940,280737,795203,2.3,8.8,93929,0.8,17.6,13578,13607,147631,0
2014,40,187941,303107,6500152,6434518,36691,12.3,26722,9,824453,269043,555410,4.2,12.8,693185,201349,491836,3.1,10.8,131268,2,21.6,17124,17250,94967,0
2014,50,302967,426372,6581466,6530167,31959,7.5,32028,7.5,797480,211066,586414,3.2,12.2,694883,232026,462857,3.6,10.6,102597,1.6,21.2,21202,21374,121444,0
2014,52,910047,1443553,25375862,25295108,89300,6.1,117835,8.1,2657203,699762,1957441,2.8,10.5,2495695,854790,1640905,3.4,9.9,161508,0.6,19.8,85122,85864,550362,0
2014,60,446842,721201,7949967,7920352,69233,9.7,56085,7.8,1089373,393326,696047,5,13.8,1030144,340111,690033,4.3,13,59229,0.8,26,31557,31732,135060,0
2014,70,2401304,2865915,50967479,50431720,297161,10.4,255286,9,7031185,2208650,4822535,4.4,13.9,5959666,1985235,3974431,3.9,11.8,1071519,2.1,23.6,177114,177821,1084925,0
