year2,msa,firms,estabs,emp,denom,estabs_entry,estabs_entry_rate,estabs_exit,estabs_exit_rate,job_creation,job_creation_births,job_creation_continuers,job_creation_rate_births,job_creation_rate,job_destruction,job_destruction_deaths,job_destruction_continuers,job_destruction_rate_deaths,job_destruction_rate,net_job_creation,net_job_creation_rate,reallocation_rate,d_flag,firmdeath_firms,firmdeath_estabs,firmdeath_emp
1977,10180,2773,3018,39928,38265,520,17.6,385,13,10328,3573,6755,9.3,27,7002,3230,3772,8.4,18.3,3326,8.7,36.6,0,265,265,2383
1978,10180,2711,2973,39704,39739,507,16.9,512,17.1,8581,3181,5400,8,21.6,8651,2970,5681,7.5,21.8,-70,-0.2,43.2,0,284,284,1321
1979,10180,3007,3304,42592,41221,579,18.4,273,8.7,10000,4436,5564,10.8,24.3,7257,1885,5372,4.6,17.6,2743,6.7,35.2,1,2,2,
1980,10180,3094,3413,45583,44035,547,16.3,417,12.4,10639,4175,6464,9.5,24.2,7543,2701,4842,6.1,17.1,3096,7.1,34.2,0,307,307,1706
1981,10180,3153,3479,46821,45591,592,17.2,498,14.5,10770,4575,6195,10,23.6,8310,4052,4258,8.9,18.2,2460,5.4,36.4,0,308,308,1605
1982,10180,3301,3680,53369,50091,671,18.7,428,12,13759,6458,7301,12.9,27.5,7202,2903,4299,5.8,14.4,6557,13.1,28.8,0,264,264,1510
1983,10180,3259,3617,49789,51438,472,12.9,560,15.4,10193,4827,5366,9.4,19.8,13490,4616,8874,9,26.2,-3297,-6.4,39.6,0,391,393,3168
1984,10180,3324,3711,51574,50704,556,15.2,464,12.7,12032,5601,6431,11,23.7,10292,3338,6954,6.6,20.3,1740,3.4,40.6,0,317,317,1902
1985,10180,3334,3717,48952,50416,509,13.7,499,13.4,8417,3543,4874,7,16.7,11345,4457,6888,8.8,22.5,-2928,-5.8,33.4,0,348,348,2936
1986,10180,3311,3700,49694,49307,507,13.7,508,13.7,10490,4490,6000,9.1,21.3,9716,2913,6803,5.9,19.7,774,1.6,39.4,0,361,361,1908
1987,10180,3166,3598,44498,47067,475,13,543,14.9,6912,3271,3641,6.9,14.7,12049,4489,7560,9.5,25.6,-5137,-10.9,29.4,0,372,372,2427
1988,10180,3120,3567,43812,44041,424,11.8,442,12.3,7539,3082,4457,7,17.1,7997,2967,5030,6.7,18.2,-458,-1.1,34.2,0,302,302,1617
1989,10180,3072,3523,43692,43728,375,10.6,414,11.7,6537,2351,4186,5.4,14.9,6608,2589,4019,5.9,15.1,-71,-0.2,29.8,0,260,265,1576
1990,10180,3017,3466,43793,43761,400,11.4,426,12.2,6890,2658,4232,6.1,15.7,6825,2613,4212,6,15.6,65,0.1,31.2,0,307,313,1500
1991,10180,3075,3515,44714,44256,448,12.8,399,11.4,9268,5211,4057,11.8,20.9,8352,3825,4527,8.6,18.9,916,2,37.8,0,240,241,2169
1992,10180,3093,3553,46748,45734,420,11.9,379,10.7,9210,2976,6234,6.5,20.1,7181,2443,4738,5.3,15.7,2029,4.4,31.4,0,246,246,1341
1993,10180,3110,3558,46653,46554,364,10.2,345,9.7,7101,2399,4702,5.2,15.3,6903,2130,4773,4.6,14.8,198,0.5,29.6,0,221,224,1246
1994,10180,3177,3628,46755,46677,427,11.9,348,9.7,7233,2930,4303,6.3,15.5,7076,2531,4545,5.4,15.2,157,0.3,30.4,0,236,236,1480
1995,10180,3187,3624,48771,47874,428,11.8,410,11.3,8521,2640,5881,5.5,17.8,6726,2105,4621,4.4,14,1795,3.8,28,0,278,282,1227
1996,10180,3223,3663,50810,49776,396,10.9,353,9.7,8993,3116,5877,6.3,18.1,6924,2495,4429,5,13.9,2069,4.2,27.8,0,245,245,1151
1997,10180,3199,3684,50936,50868,431,11.7,397,10.8,8709,3310,5399,6.5,17.1,8572,2380,6192,4.7,16.9,137,0.2,33.8,0,272,272,1278
1998,10180,3179,3682,52238,51500,406,11,385,10.5,8591,3285,5306,6.4,16.7,7114,2724,4390,5.3,13.8,1477,2.9,27.6,0,255,255,1305
1999,10180,3150,3664,51605,52111,388,10.6,406,11,7459,3048,4411,5.8,14.3,8470,2865,5605,5.5,16.3,-1011,-2,28.6,0,263,263,1364
2000,10180,3146,3657,52973,52344,363,9.9,385,10.5,8646,2739,5907,5.2,16.5,7387,2843,4544,5.4,14.1,1259,2.4,28.2,0,224,224,1481
2001,10180,3164,3679,52864,53000,351,9.5,372,10.1,6731,2951,3780,5.6,12.7,7002,2753,4249,5.2,13.2,-271,-0.5,25.4,0,217,217,1007
2002,10180,3085,3572,53484,53112,370,10.2,467,12.9,9536,2774,6762,5.2,18,8792,3735,5057,7,16.6,744,1.4,33.2,0,247,248,1351
2003,10180,3055,3537,56988,54969,331,9.4,302,8.5,9752,2468,7284,4.5,17.7,5713,1578,4135,2.9,10.4,4039,7.3,20.8,0,201,201,1027
2004,10180,3069,3543,55376,55895,340,9.6,294,8.3,7305,2002,5303,3.6,13.1,8343,1577,6766,2.8,14.9,-1038,-1.8,26.2,0,202,202,1002
2005,10180,3132,3635,55339,55331,394,11,284,7.9,7224,2501,4723,4.5,13.1,7208,2139,5069,3.9,13,16,0.1,26,0,203,203,1021
2006,10180,3115,3657,58306,56634,400,11,350,9.6,9852,4696,5156,8.3,17.4,6507,2270,4237,4,11.5,3345,5.9,23,0,238,238,1628
2007,10180,3105,3649,57803,57975,345,9.5,342,9.4,8328,2897,5431,5,14.4,8671,2860,5811,4.9,15,-343,-0.6,28.8,0,225,226,1880
2008,10180,3075,3636,58672,57773,312,8.6,273,7.5,8509,2628,5881,4.5,14.7,6711,1758,4953,3,11.6,1798,3.1,23.2,0,210,210,1455
2009,10180,3071,3611,56797,57702,294,8.1,298,8.2,6496,2035,4461,3.5,11.3,8305,2175,6130,3.8,14.4,-1809,-3.1,22.6,0,191,191,1017
2010,10180,3083,3620,56193,56280,306,8.5,277,7.7,7225,2678,4547,4.8,12.8,7399,1785,5614,3.2,13.1,-174,-0.3,25.6,0,189,189,1188
2011,10180,3037,3576,55531,55768,271,7.6,286,8,6020,2055,3965,3.7,10.8,6493,1396,5097,2.5,11.6,-473,-0.8,21.6,0,208,208,970
2012,10180,3074,3614,57333,56275,307,8.6,272,7.6,7887,2344,5543,4.2,14,5771,1786,3985,3.2,10.3,2116,3.7,20.6,0,178,182,1168
2013,10180,3076,3610,57921,57674,277,7.7,274,7.6,7063,2187,4876,3.8,12.2,6569,2385,4184,4.1,11.4,494,0.8,22.8,0,193,193,1557
2014,10180,3073,3613,58793,58227,286,7.9,257,7.1,7142,2427,4715,4.2,12.3,6009,2107,3902,3.6,10.3,1133,2,20.6,0,187,188,1586
1977,10420,9601,11321,230995,227574,1730,15.6,1244,11.2,36975,14004,22971,6.2,16.2,30132,9649,20483,4.2,13.2,6843,3,26.4,0,781,784,5068
1978,10420,9861,11651,243022,237025,1546,13.5,1214,10.6,37259,11541,25718,4.9,15.7,25264,8131,17133,3.4,10.7,11995,5,21.4,0,805,807,3962
1979,10420,10089,11914,250764,246787,1535,13,1231,10.4,38629,12942,25687,5.2,15.7,30674,10972,19702,4.4,12.4,7955,3.3,24.8,0,823,824,4983
1980,10420,10020,11886,247446,249074,1254,10.5,1245,10.5,38676,17406,21270,7,15.5,41932,15222,26710,6.1,16.8,-3256,-1.3,31,0,839,839,4564
1981,10420,9784,11575,222152,232606,1249,10.7,1487,12.7,26406,10606,15800,4.6,11.4,47313,16433,30880,7.1,20.3,-20907,-8.9,22.8,0,794,799,5647
1982,10420,9802,11713,225988,223893,1483,12.7,1224,10.5,40009,13724,26285,6.1,17.9,35818,11245,24573,5,16,4191,1.9,32,0,634,634,3729
1983,10420,9917,11785,224161,225059,1158,9.9,1143,9.7,36327,12476,23851,5.5,16.1,38123,8317,29806,3.7,16.9,-1796,-0.8,32.2,0,680,683,3854
1984,10420,10259,12094,228366,226489,1428,12,1140,9.5,38535,12266,26269,5.4,17,34781,9551,25230,4.2,15.4,3754,1.6,30.8,0,676,679,3521
1985,10420,10470,12313,219386,219588,1455,11.9,1206,9.9,35181,10041,25140,4.6,16,35584,16549,19035,7.5,16.2,-403,-0.2,32,0,763,764,4914
1986,10420,10819,12662,225961,222619,1586,12.7,1205,9.7,41281,18571,22710,8.3,18.5,34597,10543,24054,4.7,15.5,6684,3,31,0,730,731,4837
1987,10420,11097,13062,231000,229199,1798,14,1347,10.5,41575,15993,25582,7,18.1,37973,16168,21805,7.1,16.6,3602,1.5,33.2,0,824,827,5128
1988,10420,11334,13306,255781,243445,1593,12.1,1340,10.2,57519,27945,29574,11.5,23.6,32847,10969,21878,4.5,13.5,24672,10.1,27,0,810,810,4608
1989,10420,11427,13553,261225,258710,1543,11.5,1300,9.7,42209,17247,24962,6.7,16.3,37178,9137,28041,3.5,14.4,5031,1.9,28.8,0,849,853,4759
1990,10420,11935,14108,266223,264570,1711,12.4,1188,8.6,40560,14864,25696,5.6,15.3,37253,10965,26288,4.1,14.1,3307,1.2,28.2,0,771,772,5312
1991,10420,11939,14181,252260,259229,1578,11.2,1513,10.7,33224,13215,20009,5.1,12.8,47162,14656,32506,5.7,18.2,-13938,-5.4,25.6,0,1023,1027,9026
1992,10420,12065,14338,261377,257115,1560,10.9,1363,9.6,45932,12243,33689,4.8,17.9,37408,10515,26893,4.1,14.5,8524,3.4,29,0,848,856,5675
1993,10420,12247,14485,279687,270481,1497,10.4,1303,9,51786,14666,37120,5.4,19.1,33373,13474,19899,5,12.3,18413,6.8,24.6,0,845,850,5771
1994,10420,12437,14685,265787,259611,1581,10.8,1323,9.1,42718,14530,28188,5.6,16.5,30366,10219,20147,3.9,11.7,12352,4.8,23.4,0,841,844,4795
1995,10420,12781,15054,280151,272977,1706,11.5,1297,8.7,45197,15135,30062,5.5,16.6,30849,9580,21269,3.5,11.3,14348,5.3,22.6,0,810,817,5520
1996,10420,13058,15321,280742,280931,1616,10.6,1345,8.9,43630,16876,26754,6,15.5,44010,14752,29258,5.3,15.7,-380,-0.2,31,0,858,858,5438
1997,10420,13157,15492,278101,279378,1684,10.9,1524,9.9,40883,15499,25384,5.5,14.6,43437,14659,28778,5.2,15.5,-2554,-0.9,29.2,0,896,896,5505
1998,10420,13258,15646,285210,281522,1581,10.2,1394,9,44297,16371,27926,5.8,15.7,36920,12981,23939,4.6,13.1,7377,2.6,26.2,0,913,913,5836
1999,10420,13322,15812,285694,285415,1547,9.8,1361,8.7,41476,16236,25240,5.7,14.5,40918,13586,27332,4.8,14.3,558,0.2,28.6,0,871,871,6469
2000,10420,13302,15839,299148,292573,1513,9.6,1481,9.4,50908,16436,34472,5.6,17.4,37758,12697,25061,4.3,12.9,13150,4.5,25.8,0,871,871,5200
2001,10420,13338,15987,297191,298501,1510,9.5,1454,9.1,41545,15661,25884,5.2,13.9,44165,12751,31414,4.3,14.8,-2620,-0.9,27.8,0,863,867,5343
2002,10420,13129,15833,284911,289887,1664,10.5,1794,11.3,42104,16595,25509,5.7,14.5,52056,16055,36001,5.5,18,-9952,-3.5,29,0,901,902,5635
2003,10420,13198,15913,293271,288338,1596,10.1,1280,8.1,44716,15175,29541,5.3,15.5,34850,10381,24469,3.6,12.1,9866,3.4,24.2,0,852,852,4838
2004,10420,13149,15886,294939,293147,1498,9.4,1349,8.5,39819,13642,26177,4.7,13.6,36235,10229,26006,3.5,12.4,3584,1.2,24.8,0,862,865,6096
2005,10420,13124,15925,293305,292888,1504,9.5,1333,8.4,41705,13136,28569,4.5,14.2,40871,15364,25507,5.2,14,834,0.2,28,0,871,871,9526
2006,10420,12944,15808,296162,293756,1465,9.3,1455,9.2,41470,14219,27251,4.8,14.1,36658,11370,25288,3.9,12.5,4812,1.6,25,0,917,917,6225
2007,10420,12938,15830,294105,293152,1532,9.7,1465,9.3,43658,16242,27416,5.5,14.9,41752,12150,29602,4.1,14.2,1906,0.7,28.4,0,850,855,6478
2008,10420,12733,15645,292589,292735,1313,8.4,1383,8.8,38810,12158,26652,4.2,13.3,39101,10759,28342,3.7,13.4,-291,-0.1,26.6,0,939,939,7355
2009,10420,12335,15214,278113,283955,1153,7.5,1447,9.4,33612,11552,22060,4.1,11.8,45295,11556,33739,4.1,16,-11683,-4.2,23.6,0,961,965,6980
2010,10420,11986,14877,268754,272784,1101,7.3,1302,8.7,29443,9970,19473,3.7,10.8,37502,10240,27262,3.8,13.7,-8059,-2.9,21.6,0,800,804,6448
2011,10420,11939,14833,276729,272171,1183,8,1137,7.7,35476,10418,25058,3.8,13,26360,6940,19420,2.5,9.7,9116,3.3,19.4,0,744,753,4702
2012,10420,11988,14924,281008,278659,1244,8.4,1173,7.9,36387,9739,26648,3.5,13.1,31688,11372,20316,4.1,11.4,4699,1.7,22.8,0,707,711,5132
2013,10420,11951,14835,285387,284274,1123,7.6,1162,7.8,31226,8472,22754,3,11,28999,9834,19165,3.5,10.2,2227,0.8,20.4,0,704,706,5086
2014,10420,11913,14837,285975,284942,1208,8.2,1095,7.4,35844,13020,22824,4.6,12.6,33778,12064,21714,4.2,11.9,2066,0.7,23.8,0,738,739,4825
1977,10500,2281,2483,33241,32566,446,18.4,333,13.7,6015,3204,2811,9.8,18.5,4664,1978,2686,6.1,14.3,1351,4.2,28.6,0,234,234,1396
1978,10500,2357,2570,35244,34242,367,14.5,279,11,6524,2448,4076,7.1,19.1,4519,1954,2565,5.7,13.2,2005,5.9,26.4,0,189,190,997
1979,10500,2415,2636,38257,36740,381,14.6,308,11.8,7536,2550,4986,6.9,20.5,4501,1920,2581,5.2,12.3,3035,8.2,24.6,0,212,212,948
1980,10500,2412,2653,40625,39404,342,12.9,306,11.6,8039,3675,4364,9.3,20.4,5597,1902,3695,4.8,14.2,2442,6.2,28.4,0,222,222,1187
1981,10500,2352,2579,40827,40473,303,11.6,347,13.3,7005,2236,4769,5.5,17.3,6297,1935,4362,4.8,15.6,708,1.7,31.2,0,219,219,900
1982,10500,2325,2588,40824,40637,349,13.5,316,12.2,6309,2316,3993,5.7,15.5,5935,1950,3985,4.8,14.6,374,0.9,29.2,0,171,171,879
1983,10500,2403,2682,38976,39591,357,13.6,282,10.7,6033,3091,2942,7.8,15.2,7262,2734,4528,6.9,18.3,-1229,-3.1,30.4,0,191,191,1288
1984,10500,2424,2711,40965,39987,328,12.2,305,11.3,6864,2284,4580,5.7,17.2,4908,1998,2910,5,12.3,1956,4.9,24.6,0,205,207,965
1985,10500,2477,2779,44444,43007,357,13,298,10.9,8174,2991,5183,7,19,5299,1818,3481,4.2,12.3,2875,6.7,24.6,0,199,200,1053
1986,10500,2485,2796,40698,42526,378,13.6,345,12.4,7103,3010,4093,7.1,16.7,10758,6470,4288,15.2,25.3,-3655,-8.6,33.4,0,209,209,2232
1987,10500,2539,2862,41961,41320,427,15.1,353,12.5,7634,3384,4250,8.2,18.5,6351,2372,3979,5.7,15.4,1283,3.1,30.8,0,216,218,1326
1988,10500,2480,2824,41361,41359,332,11.7,344,12.1,5958,2169,3789,5.2,14.4,5953,2097,3856,5.1,14.4,5,0,28.8,0,220,220,973
1989,10500,2496,2845,43049,42217,316,11.2,302,10.7,7355,2806,4549,6.6,17.4,5690,2529,3161,6,13.5,1665,3.9,27,0,196,196,1010
1990,10500,2479,2831,43652,43291,288,10.2,277,9.8,6173,2337,3836,5.4,14.3,5451,1578,3873,3.6,12.6,722,1.7,25.2,0,189,189,907
1991,10500,2493,2856,40870,42119,279,9.8,255,9,5727,2408,3319,5.7,13.6,8224,3357,4867,8,19.5,-2497,-5.9,27.2,0,149,149,1274
1992,10500,2547,2906,42139,41514,359,12.4,309,10.7,7412,2684,4728,6.5,17.9,6162,2387,3775,5.7,14.8,1250,3.1,29.6,0,176,178,1091
1993,10500,2596,2962,43221,42662,332,11.3,272,9.3,8133,4204,3929,9.9,19.1,7014,2654,4360,6.2,16.4,1119,2.7,32.8,0,177,178,1041
1994,10500,2601,2965,45398,44196,310,10.5,294,9.9,7855,3085,4770,7,17.8,5450,2244,3206,5.1,12.3,2405,5.5,24.6,0,176,177,929
1995,10500,2677,3023,44433,44857,367,12.3,286,9.6,8055,2813,5242,6.3,18,8902,4751,4151,10.6,19.8,-847,-1.8,36,0,172,172,2965
1996,10500,2696,3049,46504,45929,336,11.1,310,10.2,8253,2672,5581,5.8,18,7102,2093,5009,4.6,15.5,1151,2.5,31,0,205,205,1050
1997,10500,2710,3087,48476,47600,364,11.8,337,11,8675,2640,6035,5.5,18.2,6922,2540,4382,5.3,14.5,1753,3.7,29,0,214,214,1179
1998,10500,2669,3039,49359,48875,305,10,337,11,8415,2889,5526,5.9,17.2,7447,3147,4300,6.4,15.2,968,2,30.4,0,210,210,1488
1999,10500,2603,2971,49373,50582,300,10,365,12.1,7033,2734,4299,5.4,13.9,9451,4951,4500,9.8,18.7,-2418,-4.8,27.8,0,212,212,1581
2000,10500,2588,2968,51674,50517,290,9.8,308,10.4,8091,3706,4385,7.3,16,5777,2092,3685,4.1,11.4,2314,4.6,22.8,0,191,191,752
2001,10500,2562,2965,50315,51117,336,11.3,373,12.5,6950,2893,4057,5.7,13.6,8553,3438,5115,6.7,16.7,-1603,-3.1,27.2,0,222,222,1727
2002,10500,2611,3038,50369,50158,405,13.5,310,10.4,7869,3431,4438,6.8,15.7,7447,2304,5143,4.6,14.8,422,0.9,29.6,0,161,161,941
2003,10500,2678,3101,52261,51097,396,13,279,9.1,9095,4553,4542,8.9,17.8,6766,1864,4902,3.6,13.2,2329,4.6,26.4,0,195,195,1185
2004,10500,2689,3090,51583,51729,288,9.3,264,8.6,7371,1893,5478,3.7,14.2,7663,3583,4080,6.9,14.8,-292,-0.6,28.4,0,173,173,2214
2005,10500,2742,3169,51670,51502,356,11.4,248,7.9,6855,2657,4198,5.2,13.3,6518,1929,4589,3.7,12.7,337,0.6,25.4,0,180,180,1530
2006,10500,2721,3194,51899,51347,322,10.1,263,8.3,6511,2516,3995,4.9,12.7,5406,1509,3897,2.9,10.5,1105,2.2,21,0,185,185,1125
2007,10500,2697,3188,50873,51326,283,8.9,278,8.7,6546,2345,4201,4.6,12.8,7452,2652,4800,5.2,14.5,-906,-1.7,25.6,0,167,170,998
2008,10500,2706,3200,50443,50388,314,9.9,278,8.7,5920,2085,3835,4.1,11.7,5809,1634,4175,3.2,11.5,111,0.2,23,0,221,221,1251
2009,10500,2658,3143,48038,48987,225,7.1,252,8,4754,1578,3176,3.2,9.7,6651,1649,5002,3.4,13.6,-1897,-3.9,19.4,0,162,164,962
2010,10500,2605,3090,45371,46583,220,7.1,248,8,4771,1952,2819,4.2,10.2,7195,2492,4703,5.3,15.4,-2424,-5.2,20.4,0,166,166,823
2011,10500,2558,3039,44983,45174,204,6.7,246,8,5005,2134,2871,4.7,11.1,5387,2246,3141,5,11.9,-382,-0.8,22.2,0,174,174,1583
2012,10500,2507,2994,47031,45990,224,7.4,269,8.9,7318,2962,4356,6.4,15.9,5235,1852,3383,4,11.4,2083,4.5,22.8,0,168,169,1199
2013,10500,2477,2959,47063,46942,216,7.3,237,8,5731,2305,3426,4.9,12.2,5489,1844,3645,3.9,11.7,242,0.5,23.4,0,161,163,800
2014,10500,2435,2924,47622,47255,221,7.5,231,7.9,5393,1851,3542,3.9,11.4,4658,1558,3100,3.3,9.9,735,1.5,19.8,0,155,156,724
1977,10580,11273,12899,210130,205366,1719,13.5,1445,11.3,37984,15475,22509,7.5,18.5,28456,10270,18186,5,13.9,9528,4.6,27.8,0,917,918,5187
1978,10580,11449,13110,218761,214128,1562,12,1341,10.3,37226,10611,26615,5,17.4,27960,9648,18312,4.5,13.1,9266,4.3,26.2,0,898,900,4680
1979,10580,11567,13277,223698,221056,1538,11.7,1312,9.9,33866,10292,23574,4.7,15.3,28582,9807,18775,4.4,12.9,5284,2.4,25.8,0,904,906,3811
1980,10580,11543,13238,225515,224429,1392,10.5,1372,10.4,31190,10274,20916,4.6,13.9,29018,9514,19504,4.2,12.9,2172,1,25.8,0,941,942,4547
1981,10580,11248,12938,228363,225007,1394,10.7,1584,12.1,38947,12545,26402,5.6,17.3,32234,11815,20419,5.3,14.3,6713,3,28.6,0,942,947,5813
1982,10580,11384,13223,225888,226715,1653,12.6,1274,9.7,31678,12857,18821,5.7,14,33332,8461,24871,3.7,14.7,-1654,-0.7,28,0,712,712,3581
1983,10580,11749,13587,225821,225448,1412,10.5,1159,8.6,31468,10675,20793,4.7,14,30721,8602,22119,3.8,13.6,747,0.4,27.2,0,767,768,3869
1984,10580,12238,14192,241376,233353,1869,13.5,1286,9.3,41495,16629,24866,7.1,17.8,25449,9233,16216,4,10.9,16046,6.9,21.8,0,830,832,4711
1985,10580,12772,14882,245966,243478,1902,13.1,1294,8.9,37034,13776,23258,5.7,15.2,32058,11536,20522,4.7,13.2,4976,2,26.4,0,858,860,5769
1986,10580,13148,15285,261743,253454,1946,12.9,1483,9.8,49273,16166,33107,6.4,19.4,32695,14270,18425,5.6,12.9,16578,6.5,25.8,0,948,954,7574
1987,10580,13611,15919,273930,269595,2228,14.3,1553,9.9,48702,15686,33016,5.8,18.1,40031,12520,27511,4.6,14.8,8671,3.3,29.6,0,994,994,6413
1988,10580,13754,16145,267669,268913,2137,13.3,1806,11.3,47281,15952,31329,5.9,17.6,49770,25589,24181,9.5,18.5,-2489,-0.9,35.2,0,1145,1145,5857
1989,10580,14128,16742,283102,275524,2137,13,1553,9.4,50651,20086,30565,7.3,18.4,35496,11066,24430,4,12.9,15155,5.5,25.8,0,1020,1034,6085
1990,10580,14185,16873,287385,284939,1816,10.8,1561,9.3,41554,13211,28343,4.6,14.6,36661,12528,24133,4.4,12.9,4893,1.7,25.8,0,1044,1055,6098
1991,10580,14255,17091,279469,283528,1923,11.3,1690,10,36931,15376,21555,5.4,13,45049,12171,32878,4.3,15.9,-8118,-2.9,26,0,1011,1017,6818
1992,10580,14010,16929,280427,279325,1732,10.2,1780,10.4,41738,13076,28662,4.7,14.9,39534,12918,26616,4.6,14.2,2204,0.7,28.4,0,1143,1153,6397
1993,10580,13844,16744,286035,282725,1559,9.3,1659,9.9,42950,13013,29937,4.6,15.2,36330,11409,24921,4,12.8,6620,2.4,25.6,0,1068,1075,5123
1994,10580,13873,16808,290219,287992,1712,10.2,1581,9.4,37871,14660,23211,5.1,13.2,33416,10803,22613,3.8,11.6,4455,1.6,23.2,0,1031,1034,4797
1995,10580,14194,17177,293595,292147,1890,11.1,1514,8.9,42834,16528,26306,5.7,14.7,39937,10550,29387,3.6,13.7,2897,1,27.4,0,972,983,4858
1996,10580,14137,17122,295955,294685,1717,10,1745,10.2,42980,16489,26491,5.6,14.6,40440,13287,27153,4.5,13.7,2540,0.9,27.4,0,1093,1093,6874
1997,10580,14211,17135,297846,297222,1792,10.5,1800,10.5,46425,15679,30746,5.3,15.6,45176,15813,29363,5.3,15.2,1249,0.4,30.4,0,1038,1038,5589
1998,10580,14280,17169,302976,300256,1727,10.1,1647,9.6,50215,18025,32190,6,16.7,44774,14972,29802,5,14.9,5441,1.8,29.8,0,1014,1014,5736
1999,10580,14218,17246,310069,306401,1619,9.4,1519,8.8,43537,17506,26031,5.7,14.2,36201,10758,25443,3.5,11.8,7336,2.4,23.6,0,964,964,4692
2000,10580,14303,17369,314336,311784,1710,9.9,1614,9.3,44734,15167,29567,4.9,14.3,39630,15803,23827,5.1,12.7,5104,1.6,25.4,0,957,957,5304
2001,10580,14450,17622,316506,316466,1749,10,1645,9.4,43357,17182,26175,5.4,13.7,43277,14080,29197,4.4,13.7,80,0,27.4,0,947,947,5052
2002,10580,14474,17753,317832,316850,1989,11.3,1841,10.4,48634,19728,28906,6.2,15.3,46670,16604,30066,5.2,14.7,1964,0.6,29.4,0,894,895,5218
2003,10580,14632,17947,326388,320202,1714,9.6,1273,7.2,48357,17997,30360,5.6,15.1,35985,10700,25285,3.3,11.2,12372,3.9,22.4,0,817,817,5970
2004,10580,14931,18325,333834,329491,1906,10.5,1400,7.7,42821,12613,30208,3.8,13,34135,8029,26106,2.4,10.4,8686,2.6,20.8,0,907,907,4130
2005,10580,15118,18638,336473,334651,1909,10.3,1463,7.9,42161,15141,27020,4.5,12.6,38516,11509,27007,3.4,11.5,3645,1.1,23,0,954,954,6583
2006,10580,15378,19004,341866,338151,2107,11.2,1568,8.4,43840,16600,27240,4.9,13,36409,10836,25573,3.2,10.8,7431,2.2,21.6,0,1045,1056,5179
2007,10580,15453,19147,337531,338803,1924,10.1,1707,9,42333,13951,28382,4.1,12.5,44876,13468,31408,4,13.2,-2543,-0.7,25,0,1038,1047,6369
2008,10580,15459,19177,336627,336085,1762,9.2,1519,8,43661,15950,27711,4.7,13,42577,14213,28364,4.2,12.7,1084,0.3,25.4,0,1035,1035,5857
2009,10580,15248,18948,328240,331476,1525,8,1657,8.7,31129,10089,21040,3,9.4,37600,9707,27893,2.9,11.3,-6471,-1.9,18.8,0,1086,1088,5649
2010,10580,15216,19008,321952,324575,1654,8.7,1485,7.8,34602,13052,21550,4,10.7,39847,9997,29850,3.1,12.3,-5245,-1.6,21.4,0,943,943,6151
2011,10580,15097,18869,324078,322461,1586,8.4,1596,8.4,36612,11893,24719,3.7,11.4,33377,10009,23368,3.1,10.4,3235,1,20.8,0,1028,1038,5922
2012,10580,15250,18997,328867,325938,1743,9.2,1587,8.4,40238,10237,30001,3.1,12.3,34379,10418,23961,3.2,10.5,5859,1.8,21,0,963,978,4749
2013,10580,15276,19012,334691,331491,1639,8.6,1606,8.5,40727,13494,27233,4.1,12.3,34327,10396,23931,3.1,10.4,6400,1.9,20.8,0,999,1000,5190
2014,10580,15263,19031,336492,334616,1749,9.2,1592,8.4,37592,12450,25142,3.7,11.2,33839,9458,24381,2.8,10.1,3753,1.1,20.2,0,1073,1075,5921
1977,10740,8421,9512,125119,122059,2049,22.2,1424,15.5,28972,14296,14676,11.7,23.7,22851,10303,12548,8.4,18.7,6121,5,37.4,0,1039,1043,6293
1978,10740,8071,9228,139254,131761,1593,17,1761,18.8,35646,11160,24486,8.5,27.1,20659,11291,9368,8.6,15.7,14987,11.4,31.4,0,1118,1118,6102
1979,10740,9065,10280,157019,148505,1868,19.1,895,9.2,37370,15535,21835,10.5,25.2,20342,6831,13511,4.6,13.7,17028,11.5,27.4,1,9,9,
1980,10740,9275,10522,158901,157716,1758,16.9,1412,13.6,31534,12453,19081,7.9,20,29164,10984,18180,7,18.5,2370,1.5,37,0,1014,1017,6615
1981,10740,9108,10328,155416,156696,1599,15.3,1680,16.1,31199,14500,16699,9.3,19.9,33758,12819,20939,8.2,21.5,-2559,-1.6,39.8,0,1087,1093,7025
1982,10740,9304,10694,155980,156570,1781,16.9,1320,12.5,28958,13429,15529,8.6,18.5,30138,11926,18212,7.6,19.2,-1180,-0.7,37,0,745,745,5153
1983,10740,9697,11084,155637,153788,1567,14.4,1282,11.8,31620,14382,17238,9.4,20.6,27921,9443,18478,6.1,18.2,3699,2.4,36.4,0,833,834,5096
1984,10740,10129,11516,170077,163456,1812,16,1377,12.2,37957,16109,21848,9.9,23.2,24714,8277,16437,5.1,15.1,13243,8.1,30.2,0,902,904,4806
1985,10740,10558,11946,180440,175838,1890,16.1,1438,12.3,39562,14698,24864,8.4,22.5,30358,14178,16180,8.1,17.3,9204,5.2,34.6,0,936,943,6636
1986,10740,11044,12533,185366,182641,2133,17.4,1466,12,37607,17017,20590,9.3,20.6,32156,10320,21836,5.7,17.6,5451,3,35.2,0,937,937,6279
1987,10740,11503,13154,195955,192443,2289,17.8,1606,12.5,41163,19174,21989,10,21.4,34139,12355,21784,6.4,17.7,7024,3.7,35.4,0,1056,1060,6838
1988,10740,11326,13104,197406,196118,1842,14,1804,13.7,39103,14720,24383,7.5,19.9,36526,15133,21393,7.7,18.6,2577,1.3,37.2,0,1233,1233,8096
1989,10740,11355,13207,200593,199031,1860,14.1,1774,13.5,36866,14584,22282,7.3,18.5,33741,12693,21048,6.4,17,3125,1.5,34,0,1184,1191,7582
1990,10740,11492,13361,208309,204162,1808,13.6,1554,11.7,38467,14570,23897,7.1,18.8,30172,11842,18330,5.8,14.8,8295,4,29.6,0,1039,1040,6787
1991,10740,11785,13727,214739,211483,1923,14.2,1557,11.5,42262,19738,22524,9.3,20,35749,13013,22736,6.2,16.9,6513,3.1,33.8,0,950,955,6881
1992,10740,11999,14028,223750,218217,2009,14.5,1605,11.6,48729,17576,31153,8.1,22.3,37663,14088,23575,6.5,17.3,11066,5,34.6,0,999,1019,7042
1993,10740,12401,14375,231164,227378,1854,13.1,1510,10.6,42821,13840,28981,6.1,18.8,35248,10772,24476,4.7,15.5,7573,3.3,31,0,975,976,5325
1994,10740,12780,14859,243124,237152,2051,14,1520,10.4,46956,16746,30210,7.1,19.8,35011,13052,21959,5.5,14.8,11945,5,29.6,0,1041,1045,6188
1995,10740,13165,15326,259154,250935,2095,13.9,1543,10.2,47659,17459,30200,7,19,31221,12400,18821,4.9,12.4,16438,6.6,24.8,0,1047,1050,6146
1996,10740,13458,15738,265881,263047,2088,13.4,1643,10.6,46429,18308,28121,7,17.7,40760,14159,26601,5.4,15.5,5669,2.2,31,0,1063,1065,8149
1997,10740,13510,15988,269333,267694,2272,14.3,1987,12.5,49414,19392,30022,7.2,18.5,46136,15621,30515,5.8,17.2,3278,1.3,34.4,0,1207,1207,7019
1998,10740,13504,16018,272248,269714,1962,12.3,1874,11.7,46622,18897,27725,7,17.3,41553,16118,25435,6,15.4,5069,1.9,30.8,0,1178,1178,8460
1999,10740,13448,16168,279267,277954,2036,12.7,1876,11.7,44825,19782,25043,7.1,16.1,42199,13503,28696,4.9,15.2,2626,0.9,30.4,0,1182,1182,6359
2000,10740,13335,16191,284292,281500,1972,12.2,1946,12,48264,19091,29173,6.8,17.1,42680,16559,26121,5.9,15.2,5584,1.9,30.4,0,1150,1150,6545
2001,10740,13399,16349,286052,285849,2047,12.6,2036,12.5,52265,21292,30973,7.4,18.3,51859,18425,33434,6.4,18.1,406,0.2,36.2,0,1065,1065,7215
2002,10740,13514,16456,281399,281765,2217,13.5,2105,12.8,52695,23946,28749,8.5,18.7,53427,20560,32867,7.3,19,-732,-0.3,37.4,0,1011,1012,8295
2003,10740,13665,16646,292792,286464,2041,12.4,1544,9.4,50930,20228,30702,7.1,17.8,38273,14488,23785,5.1,13.4,12657,4.4,26.8,0,1004,1005,6760
2004,10740,13880,16853,295391,292384,1952,11.7,1568,9.4,46814,15884,30930,5.4,16,40800,14915,25885,5.1,14,6014,2,28,0,1010,1010,6730
2005,10740,14115,17181,305303,299403,1970,11.6,1474,8.7,51109,15453,35656,5.2,17.1,39309,10267,29042,3.4,13.1,11800,4,26.2,0,1016,1019,6005
2006,10740,14457,17677,325472,314450,2201,12.7,1573,9,58386,21164,37222,6.7,18.6,36342,12634,23708,4,11.6,22044,7,23.2,0,1053,1056,7704
2007,10740,14748,18109,327734,326128,2146,12,1673,9.4,52984,18698,34286,5.7,16.2,49771,14675,35096,4.5,15.3,3213,0.9,30.6,0,1022,1027,6101
2008,10740,14758,18164,322173,322741,2016,11.2,1795,9.9,45577,17972,27605,5.6,14.1,46712,13353,33359,4.1,14.5,-1135,-0.4,28.2,0,1236,1236,8388
2009,10740,14214,17621,301382,310338,1548,8.7,1923,10.8,33992,12562,21430,4,11,51904,12713,39191,4.1,16.7,-17912,-5.7,22,0,1320,1321,7228
2010,10740,13859,17243,295122,297606,1527,8.8,1789,10.3,35269,11661,23608,3.9,11.9,40237,10490,29747,3.5,13.5,-4968,-1.6,23.8,0,1187,1188,6664
2011,10740,13687,17137,292442,293114,1565,9.1,1568,9.1,33876,10425,23451,3.6,11.6,35220,8084,27136,2.8,12,-1344,-0.4,23.2,0,1049,1049,5124
2012,10740,13796,17258,290339,290296,1703,9.9,1565,9.1,40957,13887,27070,4.8,14.1,40871,13358,27513,4.6,14.1,86,0,28.2,0,950,980,5188
2013,10740,13822,17253,289076,289227,1491,8.7,1503,8.7,39303,11769,27534,4.1,13.6,39604,11936,27668,4.1,13.7,-301,-0.1,27.2,0,965,967,6534
2014,10740,13710,17180,285704,286517,1590,9.3,1518,8.9,35163,12685,22478,4.4,12.3,36789,9481,27308,3.3,12.8,-1626,-0.5,24.6,0,1060,1060,5351
1977,10780,2101,2288,27985,27690,343,15.3,262,11.6,5046,1996,3050,7.2,18.2,4456,1655,2801,6,16.1,590,2.1,32.2,0,191,191,1261
1978,10780,2002,2181,29538,28714,283,12.7,368,16.5,5764,1649,4115,5.7,20.1,4116,2036,2080,7.1,14.3,1648,5.8,28.6,0,216,216,889
1979,10780,2190,2375,31283,30422,359,15.8,179,7.9,6180,2586,3594,8.5,20.3,4457,1958,2499,6.4,14.7,1723,5.6,29.4,1,2,2,
1980,10780,2244,2421,31306,31293,333,13.9,282,11.8,5291,2621,2670,8.4,16.9,5265,1522,3743,4.9,16.8,26,0.1,33.6,0,189,192,911
1981,10780,2214,2394,31271,31177,335,14,323,13.5,5489,2392,3097,7.7,17.6,5301,2148,3153,6.9,17,188,0.6,34,0,205,206,1008
1982,10780,2182,2396,31309,31288,352,14.7,332,13.9,6088,2923,3165,9.3,19.5,6045,2532,3513,8.1,19.3,43,0.2,38.6,0,172,172,1384
1983,10780,2293,2502,32909,31935,307,12.5,223,9.1,6477,2415,4062,7.6,20.3,4529,1505,3024,4.7,14.2,1948,6.1,28.4,0,146,146,731
1984,10780,2377,2589,32880,32874,379,14.9,294,11.6,5708,2419,3289,7.4,17.4,5695,1792,3903,5.5,17.3,13,0.1,34.6,0,185,185,940
1985,10780,2388,2597,33639,33296,338,13,326,12.6,6526,2983,3543,9,19.6,5839,2767,3072,8.3,17.5,687,2.1,35,0,220,220,1280
1986,10780,2444,2667,34240,33912,393,14.9,307,11.7,7002,3985,3017,11.8,20.6,6345,1975,4370,5.8,18.7,657,1.9,37.4,0,206,206,1214
1987,10780,2470,2742,34853,34944,408,15,328,12.1,6172,2687,3485,7.7,17.7,6354,2434,3920,7,18.2,-182,-0.5,35.4,0,211,213,1530
1988,10780,2387,2679,34936,34827,330,12.2,372,13.7,5896,2528,3368,7.3,16.9,5678,2240,3438,6.4,16.3,218,0.6,32.6,0,261,261,1350
1989,10780,2369,2670,36055,35504,280,10.5,289,10.8,5667,2137,3530,6,16,4565,1599,2966,4.5,12.9,1102,3.1,25.8,0,178,178,713
1990,10780,2404,2704,37806,36884,339,12.6,298,11.1,7078,2219,4859,6,19.2,5234,2263,2971,6.1,14.2,1844,5,28.4,0,212,214,1505
1991,10780,2392,2704,38771,38313,294,10.9,289,10.7,6560,2493,4067,6.5,17.1,5643,1857,3786,4.8,14.7,917,2.4,29.4,0,179,179,1163
1992,10780,2414,2723,39252,38988,305,11.2,291,10.7,6452,1784,4668,4.6,16.5,5923,2306,3617,5.9,15.2,529,1.3,30.4,0,169,172,1100
1993,10780,2478,2778,40558,39890,324,11.8,270,9.8,6543,2529,4014,6.3,16.4,5207,1957,3250,4.9,13.1,1336,3.3,26.2,0,177,177,949
1994,10780,2550,2852,41585,41075,354,12.6,277,9.8,6508,2558,3950,6.2,15.8,5487,1655,3832,4,13.4,1021,2.4,26.8,0,181,182,1007
1995,10780,2571,2869,43461,42422,315,11,280,9.8,7472,2871,4601,6.8,17.6,5394,2100,3294,5,12.7,2078,4.9,25.4,0,181,181,1114
1996,10780,2633,2928,43385,43407,341,11.8,271,9.4,6272,2288,3984,5.3,14.4,6315,2507,3808,5.8,14.5,-43,-0.1,28.8,0,180,181,1028
1997,10780,2651,2952,43426,43531,340,11.5,316,10.7,7640,3377,4263,7.8,17.6,7850,2873,4977,6.6,18,-210,-0.4,35.2,0,204,204,1550
1998,10780,2664,2983,45474,44420,317,10.7,278,9.4,7681,3034,4647,6.8,17.3,5572,2473,3099,5.6,12.5,2109,4.8,25,0,195,195,1654
1999,10780,2684,2998,46198,46076,305,10.2,286,9.6,6726,2140,4586,4.6,14.6,6481,2492,3989,5.4,14.1,245,0.5,28.2,0,183,183,1531
2000,10780,2645,2979,49322,47767,286,9.6,309,10.3,9849,4562,5287,9.6,20.6,6738,2698,4040,5.6,14.1,3111,6.5,28.2,0,200,200,1837
2001,10780,2643,2966,48381,48926,292,9.8,333,11.2,6322,2682,3640,5.5,12.9,7412,2726,4686,5.6,15.1,-1090,-2.2,25.8,0,172,172,948
2002,10780,2693,3017,48074,48213,370,12.4,316,10.6,7271,2843,4428,5.9,15.1,7549,2711,4838,5.6,15.7,-278,-0.6,30.2,0,172,172,1013
2003,10780,2704,3046,47982,47820,340,11.3,260,8.6,6394,2094,4300,4.4,13.4,6069,1957,4112,4.1,12.7,325,0.7,25.4,0,197,197,1184
2004,10780,2725,3063,49374,48401,325,10.7,264,8.7,7829,2283,5546,4.7,16.2,5883,2238,3645,4.6,12.2,1946,4,24.4,0,179,179,1278
2005,10780,2766,3115,49650,49390,322,10.4,249,8.1,6819,2862,3957,5.8,13.8,6298,1439,4859,2.9,12.8,521,1,25.6,0,171,177,879
2006,10780,2787,3159,49582,49422,360,11.5,292,9.3,8018,3042,4976,6.2,16.2,7698,4158,3540,8.4,15.6,320,0.6,31.2,0,203,203,1238
2007,10780,2825,3223,51145,50255,345,10.8,273,8.6,8196,2720,5476,5.4,16.3,6415,1538,4877,3.1,12.8,1781,3.5,25.6,0,187,188,871
2008,10780,2825,3248,51701,51386,302,9.4,264,8.2,6769,2213,4556,4.3,13.2,6138,1849,4289,3.6,11.9,631,1.3,23.8,0,194,194,1255
2009,10780,2782,3205,52209,51887,250,7.8,286,8.9,7042,2309,4733,4.5,13.6,6397,1757,4640,3.4,12.3,645,1.3,24.6,0,220,220,983
2010,10780,2799,3238,51530,51669,276,8.6,234,7.3,6694,2767,3927,5.4,13,6972,1912,5060,3.7,13.5,-278,-0.5,26,0,157,157,1448
2011,10780,2754,3188,51009,51216,227,7.1,262,8.2,5671,1510,4161,2.9,11.1,6085,1543,4542,3,11.9,-414,-0.8,22.2,0,195,195,1041
2012,10780,2714,3153,50933,50909,236,7.5,265,8.4,5924,1629,4295,3.2,11.6,5875,1753,4122,3.4,11.5,49,0.1,23,0,167,167,896
2013,10780,2684,3123,51564,51057,191,6.1,228,7.3,5866,2023,3843,4,11.5,4851,955,3896,1.9,9.5,1015,2,19,0,151,151,655
2014,10780,2640,3090,51591,51274,229,7.4,233,7.5,5939,1785,4154,3.5,11.6,5305,1765,3540,3.4,10.3,634,1.3,20.6,0,167,169,919
1977,10900,10319,11645,230000,224662,1650,14.4,1277,11.1,38391,14545,23846,6.5,17.1,27715,10481,17234,4.7,12.3,10676,4.8,24.6,0,798,800,5255
1978,10900,10488,11823,230783,230403,1427,12.2,1248,10.6,34430,11164,23266,4.8,14.9,33670,12063,21607,5.2,14.6,760,0.3,29.2,0,855,858,6260
1979,10900,10598,11983,238505,234353,1370,11.5,1133,9.5,33199,10024,23175,4.3,14.2,24895,8295,16600,3.5,10.6,8304,3.6,21.2,0,773,773,3879
1980,10900,10678,12100,240722,239559,1325,11,1147,9.5,30510,10177,20333,4.2,12.7,28183,9558,18625,4,11.8,2327,0.9,23.6,0,799,800,4527
1981,10900,10320,11704,234539,235890,1148,9.7,1419,11.9,30688,10045,20643,4.3,13,33389,12483,20906,5.3,14.2,-2701,-1.2,26,0,845,847,4384
1982,10900,10461,12000,229932,231858,1477,12.4,1071,9,32375,13060,19315,5.6,14,36227,8778,27449,3.8,15.6,-3852,-1.6,28,0,633,633,3629
1983,10900,10695,12218,223449,226506,1182,9.8,1076,8.9,30506,11793,18713,5.2,13.5,36620,10518,26102,4.6,16.2,-6114,-2.7,27,0,677,678,4812
1984,10900,10928,12468,236959,230973,1419,11.5,1160,9.4,37728,13377,24351,5.8,16.3,25755,10863,14892,4.7,11.2,11973,5.1,22.4,0,731,735,5232
1985,10900,11326,12867,243624,241990,1509,11.9,1159,9.1,34065,10870,23195,4.5,14.1,30797,11986,18811,5,12.7,3268,1.4,25.4,0,735,736,6775
1986,10900,11766,13352,244418,243740,1703,13,1171,8.9,37122,15078,22044,6.2,15.2,35768,10974,24794,4.5,14.7,1354,0.5,29.4,0,775,776,6635
1987,10900,12310,14025,248375,246701,2044,14.9,1332,9.7,40679,15637,25042,6.3,16.5,37332,15598,21734,6.3,15.1,3347,1.4,30.2,0,869,876,6506
1988,10900,12647,14400,254524,250270,1820,12.8,1408,9.9,42355,16862,25493,6.7,16.9,33847,11990,21857,4.8,13.5,8508,3.4,27,0,947,947,5708
1989,10900,12986,14838,262432,258485,1779,12.2,1340,9.2,39916,13407,26509,5.2,15.4,32022,13472,18550,5.2,12.4,7894,3,24.8,0,910,920,5935
1990,10900,13129,15098,261012,261547,1650,11,1303,8.7,33120,11269,21851,4.3,12.7,34189,9703,24486,3.7,13.1,-1069,-0.4,25.4,0,937,938,5624
1991,10900,13221,15215,256504,258615,1562,10.3,1447,9.5,30530,11538,18992,4.5,11.8,34751,9965,24786,3.9,13.4,-4221,-1.6,23.6,0,898,908,5977
1992,10900,13159,15211,258098,257220,1526,10,1492,9.8,35351,14006,21345,5.4,13.7,33594,10697,22897,4.2,13.1,1757,0.6,26.2,0,988,1001,5437
1993,10900,13164,15158,253640,255652,1356,8.9,1401,9.2,33220,12311,20909,4.8,13,37245,13086,24159,5.1,14.6,-4025,-1.6,26,0,942,948,5261
1994,10900,13130,15151,258874,255909,1422,9.4,1385,9.1,33030,11108,21922,4.3,12.9,27100,9615,17485,3.8,10.6,5930,2.3,21.2,0,927,927,4503
1995,10900,13379,15473,263946,260652,1640,10.7,1278,8.3,38453,14245,24208,5.5,14.8,31865,10418,21447,4,12.2,6588,2.6,24.4,0,856,858,5511
1996,10900,13410,15517,265732,265303,1492,9.6,1412,9.1,34643,12662,21981,4.8,13.1,33785,11143,22642,4.2,12.7,858,0.4,25.4,0,923,923,5168
1997,10900,13519,15688,270927,268437,1635,10.5,1486,9.5,38349,15088,23261,5.6,14.3,33368,12514,20854,4.7,12.4,4981,1.9,24.8,0,900,900,5089
1998,10900,13696,15894,274334,272627,1634,10.3,1415,9,37785,15585,22200,5.7,13.9,34370,13492,20878,4.9,12.6,3415,1.3,25.2,0,913,913,6154
1999,10900,13626,15861,278150,276347,1470,9.3,1466,9.2,35190,13048,22142,4.7,12.7,31583,11148,20435,4,11.4,3607,1.3,22.8,0,951,951,5372
2000,10900,13684,16029,283566,280600,1535,9.6,1374,8.6,40534,13107,27427,4.7,14.4,34601,11113,23488,4,12.3,5933,2.1,24.6,0,840,840,4787
2001,10900,13788,16244,290770,287810,1560,9.7,1471,9.1,38809,12370,26439,4.3,13.5,32888,10755,22133,3.7,11.4,5921,2.1,22.8,0,851,851,4935
2002,10900,13760,16336,292443,292432,1728,10.6,1617,9.9,46259,19653,26606,6.7,15.8,46236,14930,31306,5.1,15.8,23,0,31.6,0,868,868,6092
2003,10900,13837,16429,288673,289518,1597,9.8,1285,7.9,36218,13777,22441,4.8,12.5,37908,10270,27638,3.5,13.1,-1690,-0.6,25,0,839,840,4821
2004,10900,13898,16527,292118,289361,1607,9.8,1374,8.4,37698,11510,26188,4,13,32184,11403,20781,3.9,11.1,5514,1.9,22.2,0,887,887,4691
2005,10900,14068,16779,299866,295080,1735,10.4,1369,8.2,37139,13069,24070,4.4,12.6,27567,7971,19596,2.7,9.3,9572,3.3,18.6,0,933,933,3925
2006,10900,14104,16949,306169,302153,1746,10.4,1466,8.7,40865,15438,25427,5.1,13.5,32833,11896,20937,3.9,10.9,8032,2.6,21.8,0,966,994,6853
2007,10900,14218,17257,304728,304924,1933,11.3,1538,9,40591,15431,25160,5.1,13.3,40982,12368,28614,4.1,13.4,-391,-0.1,26.6,0,962,962,5277
2008,10900,14140,17284,304543,303100,1602,9.3,1421,8.3,38439,15149,23290,5,12.7,35552,9943,25609,3.3,11.7,2887,1,23.4,0,1013,1013,6233
2009,10900,13772,16839,291832,297395,1259,7.4,1589,9.3,29030,10308,18722,3.5,9.8,40156,10230,29926,3.4,13.5,-11126,-3.7,19.6,0,1007,1021,5757
2010,10900,13549,16616,280968,285429,1273,7.6,1394,8.4,28409,10793,17616,3.8,10,37331,13843,23488,4.8,13.1,-8922,-3.1,20,0,873,873,9827
2011,10900,13433,16517,285170,282460,1367,8.3,1360,8.2,34086,12188,21898,4.3,12.1,28665,8303,20362,2.9,10.1,5421,2,20.2,0,873,875,4791
2012,10900,13536,16633,302472,293502,1439,8.7,1323,8,47469,11962,35507,4.1,16.2,29528,8855,20673,3,10.1,17941,6.1,20.2,0,808,814,4074
2013,10900,13535,16597,304186,303821,1337,8.1,1354,8.2,33535,11929,21606,3.9,11,32805,8809,23996,2.9,10.8,730,0.2,21.6,0,798,798,5137
2014,10900,13478,16594,309173,305809,1462,8.9,1302,7.9,35373,10612,24761,3.5,11.6,28645,7617,21028,2.5,9.4,6728,2.2,18.8,0,849,850,3902
1977,11020,2172,2409,36841,36141,340,14.3,255,10.7,5579,2553,3026,7.1,15.4,4178,1543,2635,4.3,11.6,1401,3.8,23.2,0,148,149,676
1978,11020,2198,2438,38072,37465,292,12,268,11.1,5615,2032,3583,5.4,15,4401,1920,2481,5.1,11.7,1214,3.3,23.4,0,165,165,855
1979,11020,2235,2474,39854,38945,283,11.5,238,9.7,6104,1796,4308,4.6,15.7,4285,1534,2751,3.9,11,1819,4.7,22,0,154,154,970
1980,11020,2265,2502,40281,40059,269,10.8,232,9.3,5946,2071,3875,5.2,14.8,5502,1545,3957,3.9,13.7,444,1.1,27.4,0,160,160,830
1981,11020,2107,2336,37161,38289,208,8.6,345,14.3,3982,1439,2543,3.8,10.4,6237,2272,3965,5.9,16.3,-2255,-5.9,20.8,0,193,193,1266
1982,11020,2125,2370,36960,37014,269,11.4,202,8.6,4759,2220,2539,6,12.9,4867,1416,3451,3.8,13.1,-108,-0.2,25.8,0,107,107,394
1983,11020,2140,2367,35315,35999,179,7.6,209,8.8,3802,1035,2767,2.9,10.6,5172,1691,3481,4.7,14.4,-1370,-3.8,21.2,0,115,115,579
1984,11020,2177,2414,37951,36543,260,10.9,209,8.7,6502,2256,4246,6.2,17.8,3687,1252,2435,3.4,10.1,2815,7.7,20.2,0,117,118,628
1985,11020,2241,2470,39407,38734,280,11.5,230,9.4,5844,2021,3823,5.2,15.1,4498,1687,2811,4.4,11.6,1346,3.5,23.2,0,141,141,741
1986,11020,2326,2552,40369,39878,288,11.5,198,7.9,6124,2750,3374,6.9,15.4,5141,1305,3836,3.3,12.9,983,2.5,25.8,0,121,121,685
1987,11020,2409,2668,42698,41673,367,14.1,237,9.1,7861,3471,4390,8.3,18.9,5811,2566,3245,6.2,13.9,2050,5,27.8,0,144,144,1374
1988,11020,2396,2657,42087,42299,263,9.9,259,9.7,5673,1739,3934,4.1,13.4,6097,2703,3394,6.4,14.4,-424,-1,26.8,0,160,160,987
1989,11020,2438,2697,44421,43349,273,10.2,236,8.8,6618,2551,4067,5.9,15.3,4473,1567,2906,3.6,10.3,2145,5,20.6,0,159,159,718
1990,11020,2474,2736,46444,45493,266,9.8,219,8.1,6380,1463,4917,3.2,14,4478,1351,3127,3,9.8,1902,4.2,19.6,0,138,138,623
1991,11020,2531,2814,44496,45511,260,9.4,187,6.7,4794,1880,2914,4.1,10.5,6823,1624,5199,3.6,15,-2029,-4.5,21,0,122,122,642
1992,11020,2523,2819,43724,44107,237,8.4,231,8.2,5385,1736,3649,3.9,12.2,6150,2150,4000,4.9,13.9,-765,-1.7,24.4,0,146,146,1396
1993,11020,2557,2868,46189,44956,260,9.1,205,7.2,6563,1649,4914,3.7,14.6,4096,1209,2887,2.7,9.1,2467,5.5,18.2,0,155,155,658
1994,11020,2566,2879,45796,45954,256,8.9,235,8.2,5893,2392,3501,5.2,12.8,6208,1455,4753,3.2,13.5,-315,-0.7,25.6,0,155,155,823
1995,11020,2597,2903,47551,46810,259,9,226,7.8,6609,2142,4467,4.6,14.1,5126,2156,2970,4.6,11,1483,3.1,22,0,138,138,918
1996,11020,2595,2901,47890,47732,233,8,234,8.1,6194,2352,3842,4.9,13,5877,2006,3871,4.2,12.3,317,0.7,24.6,0,150,150,1026
1997,11020,2619,2942,48342,48123,264,9,222,7.6,6770,2019,4751,4.2,14.1,6331,2259,4072,4.7,13.2,439,0.9,26.4,0,134,134,1137
1998,11020,2659,2983,48697,48508,266,9,219,7.4,5896,1839,4057,3.8,12.2,5518,1468,4050,3,11.4,378,0.8,22.8,0,147,147,974
1999,11020,2678,3007,50395,49485,244,8.1,214,7.1,7180,2648,4532,5.4,14.5,5360,1793,3567,3.6,10.8,1820,3.7,21.6,0,130,130,1076
2000,11020,2657,3014,51745,51151,259,8.6,245,8.1,6944,2548,4396,5,13.6,5755,2137,3618,4.2,11.3,1189,2.3,22.6,0,145,145,868
2001,11020,2649,3014,50350,51069,237,7.9,255,8.5,5080,1803,3277,3.5,9.9,6517,2158,4359,4.2,12.8,-1437,-2.9,19.8,0,148,148,756
2002,11020,2625,3004,49739,50018,276,9.2,284,9.4,7439,3010,4429,6,14.9,7996,2825,5171,5.6,16,-557,-1.1,29.8,0,148,148,790
2003,11020,2615,3007,50147,49442,242,8.1,205,6.8,6390,1719,4671,3.5,12.9,4979,1682,3297,3.4,10.1,1411,2.8,20.2,0,144,144,1015
2004,11020,2627,3040,50021,49840,256,8.5,210,7,6267,2302,3965,4.6,12.6,5905,1614,4291,3.2,11.8,362,0.8,23.6,0,128,128,1076
2005,11020,2613,3019,50107,49794,235,7.8,226,7.5,5449,1502,3947,3,10.9,4822,1493,3329,3,9.7,627,1.2,19.4,0,141,141,798
2006,11020,2635,3087,50897,50451,305,10,225,7.4,6145,2260,3885,4.5,12.2,5252,1211,4041,2.4,10.4,893,1.8,20.8,0,150,151,833
2007,11020,2651,3094,51232,51045,236,7.7,220,7.1,6560,2294,4266,4.5,12.9,6185,1468,4717,2.9,12.1,375,0.8,24.2,0,122,122,689
2008,11020,2605,3040,51652,51245,182,6,214,7,6532,2058,4474,4,12.7,5718,1512,4206,3,11.2,814,1.5,22.4,0,148,148,1007
2009,11020,2570,3006,49957,50654,188,6.2,193,6.4,4618,1258,3360,2.5,9.1,6011,1284,4727,2.5,11.9,-1393,-2.8,18.2,0,120,120,752
2010,11020,2572,2999,50348,50080,176,5.9,168,5.6,5261,1384,3877,2.8,10.5,4724,1030,3694,2.1,9.4,537,1.1,18.8,0,112,112,789
2011,11020,2571,2995,50390,50287,187,6.3,176,5.9,5262,1300,3962,2.6,10.5,5055,846,4209,1.7,10.1,207,0.4,20.2,0,109,109,513
2012,11020,2568,2993,50638,50481,186,6.2,184,6.2,5831,1604,4227,3.2,11.6,5517,1740,3777,3.4,10.9,314,0.7,21.8,0,112,112,684
2013,11020,2571,3003,52352,51440,210,7,192,6.4,6852,1897,4955,3.7,13.3,5028,1145,3883,2.2,9.8,1824,3.5,19.6,0,120,120,871
2014,11020,2544,2966,52347,51998,203,6.8,199,6.7,5557,1985,3572,3.8,10.7,4859,1394,3465,2.7,9.3,698,1.4,18.6,0,143,143,897
1977,11100,3918,4384,58735,57217,809,18.9,591,13.8,12930,5946,6984,10.4,22.6,9893,5099,4794,8.9,17.3,3037,5.3,34.6,0,404,406,2974
1978,11100,3726,4193,59464,59019,665,15.5,813,19,12091,4719,7372,8,20.5,11201,5187,6014,8.8,19,890,1.5,38,0,481,485,2723
1979,11100,4025,4488,64938,62273,672,15.5,408,9.4,14126,6460,7666,10.4,22.7,8795,2973,5822,4.8,14.1,5331,8.6,28.2,0,9,10,205
1980,11100,3977,4440,63946,64315,638,14.3,658,14.7,10550,3925,6625,6.1,16.4,11288,3997,7291,6.2,17.6,-738,-1.2,32.8,0,463,464,2659
1981,11100,3945,4391,64533,63730,666,15.1,676,15.3,11594,5169,6425,8.1,18.2,9987,4138,5849,6.5,15.7,1607,2.5,31.4,0,408,410,2217
1982,11100,4046,4537,66646,65573,717,16.1,552,12.4,13199,5559,7640,8.5,20.1,11052,4432,6620,6.8,16.9,2147,3.2,33.8,0,308,308,1809
1983,11100,4162,4677,65383,65608,656,14.2,543,11.8,12497,5836,6661,8.9,19,12946,4879,8067,7.4,19.7,-449,-0.7,38,0,364,365,2582
1984,11100,4263,4780,69658,67568,726,15.4,620,13.1,14261,6479,7782,9.6,21.1,10080,4656,5424,6.9,14.9,4181,6.2,29.8,0,402,404,2802
1985,11100,4287,4816,69963,70215,684,14.3,639,13.3,12472,6243,6229,8.9,17.8,12976,5735,7241,8.2,18.5,-504,-0.7,35.6,0,415,415,3068
1986,11100,4285,4817,68929,69393,675,14,649,13.5,12696,6302,6394,9.1,18.3,13624,5518,8106,8,19.6,-928,-1.3,36.6,0,428,428,2679
1987,11100,4230,4794,65841,68176,699,14.5,694,14.4,11363,4952,6411,7.3,16.7,16032,7101,8931,10.4,23.5,-4669,-6.8,33.4,0,423,428,3955
1988,11100,4161,4764,65986,65548,642,13.4,669,14,11584,5371,6213,8.2,17.7,10708,4807,5901,7.3,16.3,876,1.4,32.6,0,451,451,2178
1989,11100,4056,4646,66221,66057,550,11.7,661,14.1,10758,4087,6671,6.2,16.3,10430,4864,5566,7.4,15.8,328,0.5,31.6,0,415,416,2579
1990,11100,4070,4656,65365,65692,539,11.6,502,10.8,10170,4386,5784,6.7,15.5,10824,4078,6746,6.2,16.5,-654,-1,31,0,350,350,1848
1991,11100,4120,4709,65667,65387,531,11.3,492,10.5,9693,3815,5878,5.8,14.8,9133,3354,5779,5.1,14,560,0.8,28,0,314,315,2081
1992,11100,4143,4730,67606,66782,597,12.6,551,11.7,11790,4474,7316,6.7,17.7,10141,4049,6092,6.1,15.2,1649,2.5,30.4,0,336,339,2136
1993,11100,4215,4783,70903,69174,555,11.7,483,10.2,11113,3208,7905,4.6,16.1,7655,2839,4816,4.1,11.1,3458,5,22.2,0,314,314,1424
1994,11100,4309,4889,72133,71485,593,12.3,483,10,10957,3367,7590,4.7,15.3,9660,3623,6037,5.1,13.5,1297,1.8,27,0,328,328,1392
1995,11100,4431,5037,75703,73885,628,12.7,462,9.3,11938,4818,7120,6.5,16.2,8302,3248,5054,4.4,11.2,3636,5,22.4,0,302,303,1721
1996,11100,4476,5085,78285,77071,595,11.8,541,10.7,13539,5337,8202,6.9,17.6,11111,3771,7340,4.9,14.4,2428,3.2,28.8,0,342,342,2162
1997,11100,4477,5107,76956,77608,656,12.9,629,12.3,12258,4584,7674,5.9,15.8,13561,5369,8192,6.9,17.5,-1303,-1.7,31.6,0,381,381,2769
1998,11100,4519,5138,79869,78346,590,11.5,544,10.6,11636,4467,7169,5.7,14.9,8589,2867,5722,3.7,11,3047,3.9,22,0,334,334,1476
1999,11100,4466,5126,83092,81491,548,10.7,545,10.6,13661,5518,8143,6.8,16.8,10459,4190,6269,5.1,12.8,3202,4,25.6,0,371,371,1895
2000,11100,4440,5123,84432,83708,560,10.9,566,11,12899,4670,8229,5.6,15.4,11451,4565,6886,5.5,13.7,1448,1.7,27.4,0,339,339,1795
2001,11100,4483,5165,86933,85808,570,11.1,585,11.3,14530,7831,6699,9.1,16.9,12280,4099,8181,4.8,14.3,2250,2.6,28.6,0,333,333,1743
2002,11100,4511,5207,83099,84985,670,12.9,616,11.9,14080,5780,8300,6.8,16.6,17852,7682,10170,9,21,-3772,-4.4,33.2,0,353,353,2022
2003,11100,4513,5219,83889,83190,546,10.5,444,8.6,12225,4354,7871,5.2,14.7,10827,2516,8311,3,13,1398,1.7,26,0,322,322,1562
2004,11100,4543,5242,88892,86065,568,10.9,500,9.6,16013,5775,10238,6.7,18.6,10359,4026,6333,4.7,12,5654,6.6,24,0,343,343,2273
2005,11100,4608,5372,90781,89865,587,11.1,426,8,12198,4199,7999,4.7,13.6,10366,3152,7214,3.5,11.5,1832,2.1,23,0,302,303,2315
2006,11100,4625,5423,92585,91526,608,11.3,505,9.4,13385,5143,8242,5.6,14.6,11266,5052,6214,5.5,12.3,2119,2.3,24.6,0,350,350,3651
2007,11100,4688,5505,91614,91654,575,10.5,478,8.8,14927,6314,8613,6.9,16.3,15006,6344,8662,6.9,16.4,-79,-0.1,32.6,0,315,324,1972
2008,11100,4708,5525,93945,92557,526,9.6,457,8.3,11853,3466,8387,3.7,12.8,9076,2627,6449,2.8,9.8,2777,3,19.6,0,332,332,1881
2009,11100,4681,5504,90763,92276,466,8.5,458,8.3,9379,3625,5754,3.9,10.2,12405,4225,8180,4.6,13.4,-3026,-3.2,20.4,0,301,302,1322
2010,11100,4645,5472,88484,89446,441,8.1,448,8.2,8886,3471,5415,3.9,9.9,10809,3551,7258,4,12.1,-1923,-2.2,19.8,0,304,304,2509
2011,11100,4688,5509,90321,89319,464,8.5,402,7.3,10982,3114,7868,3.5,12.3,8978,2263,6715,2.5,10.1,2004,2.2,20.2,0,283,283,1198
2012,11100,4709,5530,91720,90872,466,8.4,452,8.2,10885,3334,7551,3.7,12,9189,2559,6630,2.8,10.1,1696,1.9,20.2,0,300,304,1667
2013,11100,4779,5619,95040,93239,488,8.8,410,7.4,12480,3944,8536,4.2,13.4,8878,2525,6353,2.7,9.5,3602,3.9,19,0,264,270,1766
2014,11100,4830,5679,93465,93878,524,9.3,429,7.6,11222,3477,7745,3.7,12,12047,4895,7152,5.2,12.8,-825,-0.8,24,0,301,301,1762
1977,11180,1239,1310,14952,14114,235,18.3,170,13.3,3523,1563,1960,11.1,25,1847,904,943,6.4,13.1,1676,11.9,26.2,0,116,116,694
1978,11180,1275,1350,16722,15827,195,14.7,153,11.5,3761,1343,2418,8.5,23.8,1970,841,1129,5.3,12.4,1791,11.4,24.8,0,114,114,685
1979,11180,1285,1367,18163,17428,179,13.2,155,11.4,3933,1407,2526,8.1,22.6,2463,1040,1423,6,14.1,1470,8.5,28.2,0,118,119,733
1980,11180,1277,1369,17352,17717,148,10.8,139,10.2,2556,823,1733,4.6,14.4,3286,737,2549,4.2,18.5,-730,-4.1,28.8,0,104,104,514
1981,11180,1243,1328,16626,16769,162,12,188,14,3037,1661,1376,9.9,18.1,3323,1407,1916,8.4,19.8,-286,-1.7,36.2,0,105,106,692
1982,11180,1269,1369,15954,16300,183,13.6,134,9.9,2639,1173,1466,7.2,16.2,3330,1519,1811,9.3,20.4,-691,-4.2,32.4,0,81,81,624
1983,11180,1261,1367,15028,15499,142,10.4,158,11.5,2261,992,1269,6.4,14.6,3203,943,2260,6.1,20.7,-942,-6.1,29.2,0,114,114,669
1984,11180,1286,1396,16296,15621,167,12.1,135,9.8,3293,1122,2171,7.2,21.1,1942,750,1192,4.8,12.4,1351,8.7,24.8,0,92,92,476
1985,11180,1266,1369,16628,16652,136,9.8,160,11.6,2545,908,1637,5.5,15.3,2593,934,1659,5.6,15.6,-48,-0.3,30.6,0,101,102,633
1986,11180,1282,1389,17737,17176,157,11.4,134,9.7,3716,2020,1696,11.8,21.6,2593,677,1916,3.9,15.1,1123,6.5,30.2,0,95,95,351
1987,11180,1276,1393,18542,18472,163,11.7,148,10.6,2903,1469,1434,8,15.7,2763,783,1980,4.2,15,140,0.7,30,0,91,92,535
1988,11180,1290,1408,18433,18386,136,9.7,115,8.2,2716,937,1779,5.1,14.8,2621,748,1873,4.1,14.3,95,0.5,28.6,0,78,78,410
1989,11180,1325,1437,31384,24874,165,11.6,138,9.7,15504,13152,2352,52.9,62.3,2484,884,1600,3.6,10,13020,52.3,20,0,96,97,531
1990,11180,1351,1467,34259,32807,144,9.9,112,7.7,5350,2475,2875,7.5,16.3,2446,821,1625,2.5,7.5,2904,8.8,15,0,71,71,552
1991,11180,1367,1503,34362,34323,169,11.4,131,8.8,3531,1056,2475,3.1,10.3,3453,1568,1885,4.6,10.1,78,0.2,20.2,0,80,81,534
1992,11180,1407,1548,21671,22025,174,11.4,129,8.4,3342,981,2361,4.5,15.2,4050,2171,1879,9.9,18.4,-708,-3.2,30.4,0,77,77,1604
1993,11180,1435,1575,21825,21752,157,10.1,128,8.2,2662,762,1900,3.5,12.2,2515,672,1843,3.1,11.6,147,0.6,23.2,0,82,82,374
1994,11180,1443,1588,22097,21957,139,8.8,119,7.5,2810,789,2021,3.6,12.8,2530,843,1687,3.8,11.5,280,1.3,23,0,76,76,531
1995,11180,1467,1611,23567,22859,164,10.3,135,8.4,3884,1267,2617,5.5,17,2467,1053,1414,4.6,10.8,1417,6.2,21.6,0,93,93,611
1996,11180,1474,1626,24320,23937,160,9.9,140,8.7,3697,1264,2433,5.3,15.4,2930,834,2096,3.5,12.2,767,3.2,24.4,0,93,93,554
1997,11180,1496,1650,25646,24974,180,11,158,9.6,4692,1616,3076,6.5,18.8,3347,1026,2321,4.1,13.4,1345,5.4,26.8,0,103,103,600
1998,11180,1504,1659,26485,26041,172,10.4,153,9.2,4490,1967,2523,7.6,17.2,3602,1534,2068,5.9,13.8,888,3.4,27.6,0,113,113,991
1999,11180,1512,1682,26620,26366,162,9.7,139,8.3,3958,1003,2955,3.8,15,3450,1237,2213,4.7,13.1,508,1.9,26.2,0,98,98,890
2000,11180,1530,1699,27550,27281,175,10.4,163,9.6,3955,1654,2301,6.1,14.5,3417,1230,2187,4.5,12.5,538,2,25,0,108,108,604
2001,11180,1537,1741,28352,28199,194,11.2,167,9.7,4796,2789,2007,9.9,17,4490,1723,2767,6.1,15.9,306,1.1,31.8,0,96,96,597
2002,11180,1530,1730,27893,28100,167,9.6,175,10.1,3685,1173,2512,4.2,13.1,4099,1427,2672,5.1,14.6,-414,-1.5,26.2,0,84,84,668
2003,11180,1540,1735,27891,27731,175,10.2,132,7.7,3793,1417,2376,5.1,13.7,3473,1295,2178,4.7,12.5,320,1.2,25,0,86,87,827
2004,11180,1562,1748,27869,27852,159,9.1,140,8,3473,946,2527,3.4,12.5,3438,1316,2122,4.7,12.3,35,0.2,24.6,0,87,87,853
2005,11180,1593,1795,29168,28504,175,9.9,124,7,3922,1351,2571,4.7,13.8,2594,695,1899,2.4,9.1,1328,4.7,18.2,0,99,99,584
2006,11180,1629,1823,29555,29234,199,11,152,8.4,3724,1615,2109,5.5,12.7,3082,849,2233,2.9,10.5,642,2.2,21,0,98,98,579
2007,11180,1625,1824,30129,29776,157,8.6,146,8,4435,1573,2862,5.3,14.9,3729,863,2866,2.9,12.5,706,2.4,25,0,89,90,512
2008,11180,1654,1865,30833,30435,169,9.2,118,6.4,4352,1530,2822,5,14.3,3555,1010,2545,3.3,11.7,797,2.6,23.4,0,83,83,800
2009,11180,1643,1855,29277,30038,117,6.3,124,6.7,3072,917,2155,3.1,10.2,4593,1143,3450,3.8,15.3,-1521,-5.1,20.4,0,88,88,730
2010,11180,1624,1855,28470,28850,136,7.4,122,6.6,2677,1010,1667,3.5,9.3,3437,831,2606,2.9,11.9,-760,-2.6,18.6,0,82,82,551
2011,11180,1609,1849,28637,28488,144,7.8,127,6.9,3225,1015,2210,3.6,11.3,2927,892,2035,3.1,10.3,298,1,20.6,0,87,87,691
2012,11180,1622,1836,29495,29013,145,7.9,147,8,4533,1637,2896,5.6,15.6,3568,1627,1941,5.6,12.3,965,3.3,24.6,0,93,93,1301
2013,11180,1631,1837,31087,30247,130,7.1,119,6.5,4862,2216,2646,7.3,16.1,3181,866,2315,2.9,10.5,1681,5.6,21,0,81,81,486
2014,11180,1614,1827,32572,31781,129,7.1,129,7.1,4134,1127,3007,3.5,13,2552,793,1759,2.5,8,1582,5,16,0,86,88,523
1977,11260,3466,3951,57435,59035,1055,27.7,742,19.5,18490,8664,9826,14.7,31.3,21690,7063,14627,12,36.7,-3200,-5.4,62.6,0,504,507,3901
1978,11260,3620,4138,60779,59041,941,23.3,735,18.2,19205,8074,11131,13.7,32.5,15728,6257,9471,10.6,26.6,3477,5.9,53.2,0,434,434,3049
1979,11260,3814,4339,60230,60377,1019,24,759,17.9,16039,6869,9170,11.4,26.6,16334,7341,8993,12.2,27.1,-295,-0.5,53.2,0,508,509,3496
1980,11260,3732,4283,59290,59599,766,17.8,769,17.8,12796,5237,7559,8.8,21.5,13414,4710,8704,7.9,22.5,-618,-1,43,0,510,511,2804
1981,11260,3848,4369,67007,62951,834,19.3,698,16.2,19237,7229,12008,11.5,30.6,11125,4662,6463,7.4,17.7,8112,12.9,35.4,0,389,389,2249
1982,11260,4279,4925,79123,72903,1155,24.8,595,12.8,26194,10336,15858,14.2,35.9,13753,5138,8615,7,18.9,12441,17,37.8,0,323,323,2990
1983,11260,4908,5634,81672,80512,1309,24.8,660,12.5,22307,10276,12031,12.8,27.7,19986,6303,13683,7.8,24.8,2321,2.9,49.6,0,428,428,2997
1984,11260,5471,6244,90300,86217,1403,23.6,787,13.3,23659,9691,13968,11.2,27.4,15494,6178,9316,7.2,18,8165,9.4,36,0,504,504,3578
1985,11260,5697,6523,96587,93466,1322,20.7,1033,16.2,26531,10722,15809,11.5,28.4,20289,9426,10863,10.1,21.7,6242,6.7,43.4,0,679,682,4049
1986,11260,5685,6548,92543,94029,1250,19.1,1167,17.9,21355,9656,11699,10.3,22.7,24327,7562,16765,8,25.9,-2972,-3.2,45.4,0,757,757,4413
1987,11260,5321,6141,82518,87806,1057,16.6,1392,21.9,15820,6759,9061,7.7,18,26396,11483,14913,13.1,30.1,-10576,-12.1,36,0,886,892,6367
1988,11260,5195,6026,78337,80275,983,16.2,1062,17.5,16368,7590,8778,9.5,20.4,20244,8659,11585,10.8,25.2,-3876,-4.8,40.8,0,656,656,4223
1989,11260,4635,5493,85482,82006,782,13.6,1337,23.2,23451,10125,13326,12.3,28.6,16499,9529,6970,11.6,20.1,6952,8.5,40.2,0,482,482,2022
1990,11260,5447,6348,91206,86442,1444,24.4,571,9.6,24012,11943,12069,13.8,27.8,14484,3968,10516,4.6,16.8,9528,11,33.6,0,342,343,2122
1991,11260,5736,6680,95897,93475,1005,15.4,666,10.2,19819,6975,12844,7.5,21.2,14975,4318,10657,4.6,16,4844,5.2,32,0,384,385,2289
1992,11260,5873,6912,96976,96436,1030,15.1,772,11.3,18825,5927,12898,6.1,19.5,17745,5534,12211,5.7,18.4,1080,1.1,36.8,0,456,464,2761
1993,11260,6013,7000,97565,97039,910,13.1,806,11.6,17945,5281,12664,5.4,18.5,16892,6281,10611,6.5,17.4,1053,1.1,34.8,0,462,469,2973
1994,11260,6189,7163,102091,99797,961,13.6,785,11.1,20750,8151,12599,8.2,20.8,16161,4917,11244,4.9,16.2,4589,4.6,32.4,0,456,460,2204
1995,11260,6348,7329,103356,102659,941,13,750,10.4,17503,6346,11157,6.2,17,16109,5129,10980,5,15.7,1394,1.3,31.4,0,483,485,2583
1996,11260,6473,7445,104968,104062,930,12.6,788,10.7,18124,5834,12290,5.6,17.4,16312,6582,9730,6.3,15.7,1812,1.7,31.4,0,504,504,2420
1997,11260,6618,7606,107312,105944,1036,13.8,852,11.3,21233,7371,13862,7,20,18497,5892,12605,5.6,17.5,2736,2.5,35,0,519,519,2470
1998,11260,6722,7744,113661,110466,1063,13.8,886,11.5,21587,7789,13798,7.1,19.5,15196,5075,10121,4.6,13.8,6391,5.7,27.6,0,562,562,2759
1999,11260,6762,7829,113790,113530,950,12.2,847,10.9,17129,5642,11487,5,15.1,16608,5818,10790,5.1,14.6,521,0.5,29.2,0,532,532,2502
2000,11260,6810,7880,120911,117345,1048,13.3,983,12.5,26135,10133,16002,8.6,22.3,19003,9148,9855,7.8,16.2,7132,6.1,32.4,0,525,525,3350
2001,11260,6842,7989,126531,124191,984,12.4,957,12,22361,7260,15101,5.8,18,17681,6854,10827,5.5,14.2,4680,3.8,28.4,0,525,525,3182
2002,11260,7002,8193,129511,127815,1207,14.9,974,12.1,25041,10405,14636,8.1,19.6,21649,6860,14789,5.4,16.9,3392,2.7,33.8,0,504,505,3251
2003,11260,7156,8373,134132,131003,1126,13.7,789,9.6,26703,10899,15804,8.3,20.4,20445,6051,14394,4.6,15.6,6258,4.8,31.2,0,479,479,2903
2004,11260,7334,8583,136506,134707,1131,13.4,827,9.8,21634,6246,15388,4.6,16.1,18036,6603,11433,4.9,13.4,3598,2.7,26.8,0,530,530,2998
2005,11260,7495,8829,143201,139668,1121,12.9,813,9.4,23757,7557,16200,5.4,17,16690,4346,12344,3.1,11.9,7067,5.1,23.8,0,548,548,2798
2006,11260,7514,8918,150866,146564,1146,12.9,973,11,27349,7340,20009,5,18.7,18744,6509,12235,4.4,12.8,8605,5.9,25.6,0,607,607,3275
2007,11260,7562,9049,153179,151886,1132,12.6,989,11,29229,11132,18097,7.3,19.2,26643,6699,19944,4.4,17.5,2586,1.7,35,0,577,581,2808
2008,11260,7540,9071,155839,154099,995,11,899,10,21602,6773,14829,4.4,14,18121,4357,13764,2.8,11.8,3481,2.2,23.6,0,604,604,3145
2009,11260,7459,9002,158832,156921,952,10.6,963,10.7,26297,8752,17545,5.6,16.8,22475,7474,15001,4.8,14.3,3822,2.5,28.6,0,565,584,3450
2010,11260,7447,9039,159019,158739,895,9.9,802,8.9,20833,5513,15320,3.5,13.1,20272,5018,15254,3.2,12.8,561,0.3,25.6,0,486,492,2706
2011,11260,7430,9084,160394,160009,886,9.8,814,9,20155,6073,14082,3.8,12.6,19385,5703,13682,3.6,12.1,770,0.5,24.2,0,488,493,2645
2012,11260,7576,9232,163792,162010,932,10.2,809,8.8,26079,8197,17882,5.1,16.1,22514,4505,18009,2.8,13.9,3565,2.2,27.8,0,424,424,1652
2013,11260,7659,9342,170596,167176,904,9.8,789,8.5,23468,6169,17299,3.7,14,16628,4718,11910,2.8,9.9,6840,4.1,19.8,0,457,457,2751
2014,11260,7672,9385,168647,169394,936,10,847,9.1,21233,7148,14085,4.2,12.5,22727,6068,16659,3.6,13.4,-1494,-0.9,25,0,538,539,2690
1977,11300,1996,2213,45672,45028,312,14.2,256,11.7,5262,2339,2923,5.2,11.7,3973,1477,2496,3.3,8.8,1289,2.9,17.6,0,163,163,699
1978,11300,2049,2279,47278,46460,305,13.6,235,10.5,5253,1564,3689,3.4,11.3,3616,1490,2126,3.2,7.8,1637,3.5,15.6,0,168,169,1093
1979,11300,2014,2250,45560,46401,260,11.5,281,12.4,4385,1448,2937,3.1,9.5,6067,2745,3322,5.9,13.1,-1682,-3.6,19,0,202,202,808
1980,11300,2005,2242,42029,43773,249,11.1,243,10.8,4319,1385,2934,3.2,9.9,7806,1249,6557,2.9,17.8,-3487,-7.9,19.8,0,173,174,787
1981,11300,1924,2147,40907,41130,219,10,288,13.2,4758,2585,2173,6.3,11.6,5204,1940,3264,4.7,12.7,-446,-1.1,23.2,0,171,172,586
1982,11300,1903,2140,38547,39696,250,11.7,239,11.1,5148,1639,3509,4.1,13,7445,1354,6091,3.4,18.8,-2297,-5.8,26,0,135,135,599
1983,11300,1792,2028,36728,37604,216,10.4,307,14.7,4149,1199,2950,3.2,11,5900,1800,4100,4.8,15.7,-1751,-4.7,22,0,159,160,725
1984,11300,1972,2207,40874,38864,267,12.6,143,6.8,6288,1268,5020,3.3,16.2,2267,761,1506,2,5.8,4021,10.4,11.6,0,4,4,12
1985,11300,2001,2232,41704,41447,259,11.7,241,10.8,4435,1652,2783,4,10.7,3921,1688,2233,4.1,9.5,514,1.2,19,0,148,149,1026
1986,11300,2072,2308,43615,42648,290,12.8,205,9,5821,1662,4159,3.9,13.6,3887,987,2900,2.3,9.1,1934,4.5,18.2,0,145,145,552
1987,11300,2088,2329,41701,42669,323,13.9,288,12.4,5407,2486,2921,5.8,12.7,7343,1999,5344,4.7,17.2,-1936,-4.5,25.4,0,191,191,1294
1988,11300,2079,2296,41063,41250,253,11,283,12.3,4601,1880,2721,4.6,11.2,4974,2158,2816,5.2,12.1,-373,-0.9,22.4,0,163,163,954
1989,11300,2075,2328,42842,41963,245,10.6,209,9,5212,2143,3069,5.1,12.4,3453,1066,2387,2.5,8.2,1759,4.2,16.4,0,142,142,596
1990,11300,2061,2326,43890,43316,222,9.5,210,9,5017,1350,3667,3.1,11.6,3869,1288,2581,3,8.9,1148,2.7,17.8,0,150,150,764
1991,11300,2064,2335,41904,42681,220,9.4,213,9.1,4371,1808,2563,4.2,10.2,5925,2321,3604,5.4,13.9,-1554,-3.7,20.4,0,136,137,1109
1992,11300,2112,2393,42148,41978,277,11.7,213,9,5142,1879,3263,4.5,12.2,4802,1826,2976,4.3,11.4,340,0.8,22.8,0,146,148,753
1993,11300,2139,2422,42592,42760,217,9,189,7.9,5141,1255,3886,2.9,12,5476,1360,4116,3.2,12.8,-335,-0.8,24,0,132,132,719
1994,11300,2145,2429,43752,43109,228,9.4,216,8.9,5881,1620,4261,3.8,13.6,4594,1335,3259,3.1,10.7,1287,2.9,21.4,0,144,144,607
1995,11300,2157,2446,43191,43429,249,10.2,224,9.2,6281,2048,4233,4.7,14.5,6756,1429,5327,3.3,15.6,-475,-1.1,29,0,141,141,817
1996,11300,2185,2474,44702,43988,266,10.8,231,9.4,8019,4563,3456,10.4,18.2,6591,2126,4465,4.8,15,1428,3.2,30,0,166,166,711
1997,11300,2221,2527,44685,44738,275,11,235,9.4,5785,2195,3590,4.9,12.9,5890,1454,4436,3.3,13.2,-105,-0.3,25.8,0,163,163,906
1998,11300,2226,2534,44107,44390,236,9.3,227,9,5448,2555,2893,5.8,12.3,6013,1554,4459,3.5,13.5,-565,-1.2,24.6,0,159,159,985
1999,11300,2234,2563,42110,43116,251,9.9,218,8.6,4713,1793,2920,4.2,10.9,6724,1922,4802,4.5,15.6,-2011,-4.7,21.8,0,156,156,1057
2000,11300,2193,2517,42095,42068,197,7.8,245,9.6,5466,1439,4027,3.4,13,5411,1330,4081,3.2,12.9,55,0.1,25.8,0,148,148,601
2001,11300,2166,2480,41716,41987,204,8.2,256,10.2,5506,1514,3992,3.6,13.1,6048,1758,4290,4.2,14.4,-542,-1.3,26.2,0,160,160,755
2002,11300,2127,2430,38424,40072,241,9.8,293,11.9,5971,2344,3627,5.8,14.9,9266,2601,6665,6.5,23.1,-3295,-8.2,29.8,0,131,131,638
2003,11300,2116,2417,38402,37310,231,9.6,203,8.4,6584,2025,4559,5.4,17.6,4399,1340,3059,3.6,11.8,2185,5.8,23.6,0,145,145,927
2004,11300,2103,2424,38909,38449,220,9.1,196,8.1,6115,3281,2834,8.5,15.9,5194,1554,3640,4,13.5,921,2.4,27,0,149,149,1134
2005,11300,2080,2406,38413,38484,212,8.8,207,8.6,4790,1644,3146,4.3,12.4,4932,1390,3542,3.6,12.8,-142,-0.4,24.8,0,148,148,968
2006,11300,2073,2402,39102,38687,218,9.1,199,8.3,5905,1531,4374,4,15.3,5075,1240,3835,3.2,13.1,830,2.2,26.2,0,135,136,745
2007,11300,2065,2376,39777,39471,209,8.8,240,10.1,7023,1699,5324,4.3,17.8,6410,1972,4438,5,16.2,613,1.6,32.4,0,150,150,1172
2008,11300,1992,2296,35328,36964,174,7.5,211,9.1,3964,945,3019,2.6,10.7,7236,1573,5663,4.3,19.6,-3272,-8.9,21.4,0,154,154,1199
2009,11300,1886,2195,34441,34811,135,6,220,9.8,4610,2103,2507,6,13.2,5350,1320,4030,3.8,15.4,-740,-2.2,26.4,0,161,161,810
2010,11300,1828,2137,34292,34153,125,5.8,173,8,3800,976,2824,2.9,11.1,3522,1301,2221,3.8,10.3,278,0.8,20.6,0,125,125,941
2011,11300,1802,2102,33795,34002,152,7.2,173,8.2,2875,738,2137,2.2,8.5,3288,797,2491,2.3,9.7,-413,-1.2,17,0,111,111,553
2012,11300,1792,2086,34124,33994,161,7.7,176,8.4,4107,1336,2771,3.9,12.1,3846,1199,2647,3.5,11.3,261,0.8,22.6,0,99,99,583
2013,11300,1784,2070,34531,34234,141,6.8,155,7.5,4586,1221,3365,3.6,13.4,3991,1321,2670,3.9,11.7,595,1.7,23.4,0,105,105,1143
2014,11300,1759,2044,34567,34408,144,7,152,7.4,3453,831,2622,2.4,10,3135,893,2242,2.6,9.1,318,0.9,18.2,0,111,113,507
1977,11340,1900,2101,40256,39296,333,16.1,267,12.9,6175,2595,3580,6.6,15.7,4254,1908,2346,4.9,10.8,1921,4.9,21.6,0,165,165,1176
1978,11340,1981,2179,41293,40775,299,14,222,10.4,6000,1519,4481,3.7,14.7,4964,2657,2307,6.5,12.2,1036,2.5,24.4,0,158,159,629
1979,11340,2029,2227,43049,42172,283,12.8,236,10.7,6213,2137,4076,5.1,14.7,4458,1168,3290,2.8,10.6,1755,4.1,21.2,0,170,170,802
1980,11340,2022,2227,42973,42990,280,12.6,259,11.6,5029,1861,3168,4.3,11.7,5063,1689,3374,3.9,11.8,-34,-0.1,23.4,0,189,190,676
1981,11340,1961,2167,41379,41855,248,11.3,280,12.8,4917,2409,2508,5.8,11.7,5868,2071,3797,4.9,14,-951,-2.3,23.4,0,173,173,785
1982,11340,1953,2180,39196,40255,262,12,219,10.1,3611,1600,2011,4,9,5729,960,4769,2.4,14.2,-2118,-5.2,18,0,129,129,504
1983,11340,1882,2123,37164,38027,223,10.4,259,12,3864,1541,2323,4.1,10.2,5589,1921,3668,5.1,14.7,-1725,-4.5,20.4,0,158,158,984
1984,11340,2148,2390,41038,39193,346,15.3,137,6.1,7020,2858,4162,7.3,17.9,3329,1031,2298,2.6,8.5,3691,9.4,17,0,3,3,7
1985,11340,2258,2506,40612,40858,347,14.2,231,9.4,5376,1453,3923,3.6,13.2,5867,1673,4194,4.1,14.4,-491,-1.2,26.4,0,151,151,752
1986,11340,2333,2582,39070,39839,356,14,272,10.7,5111,1853,3258,4.7,12.8,6648,3146,3502,7.9,16.7,-1537,-3.9,25.6,0,167,167,1194
1987,11340,2416,2696,40874,39971,393,14.9,265,10,6202,2433,3769,6.1,15.5,4396,1749,2647,4.4,11,1806,4.5,22,0,155,155,577
1988,11340,2443,2732,44047,42436,315,11.6,279,10.3,6922,2339,4583,5.5,16.3,3699,1258,2441,3,8.7,3223,7.6,17.4,0,184,184,634
1989,11340,2468,2752,44270,44125,274,10,254,9.3,6209,1686,4523,3.8,14.1,5918,2013,3905,4.6,13.4,291,0.7,26.8,0,171,171,1051
1990,11340,2503,2778,45135,44678,301,10.9,261,9.4,6307,2447,3860,5.5,14.1,5393,1645,3748,3.7,12.1,914,2,24.2,0,175,182,1032
1991,11340,2524,2813,44211,44688,317,11.3,283,10.1,6280,3378,2902,7.6,14.1,7234,2960,4274,6.6,16.2,-954,-2.1,28.2,0,166,166,1140
1992,11340,2583,2880,45727,44933,336,11.8,249,8.7,7576,3216,4360,7.2,16.9,5987,1601,4386,3.6,13.3,1589,3.6,26.6,0,154,156,996
1993,11340,2616,2916,46378,46041,319,11,279,9.6,6420,2571,3849,5.6,13.9,5746,1823,3923,4,12.5,674,1.4,25,0,191,191,1007
1994,11340,2654,2960,49258,47806,332,11.3,277,9.4,7848,2538,5310,5.3,16.4,4944,1571,3373,3.3,10.3,2904,6.1,20.6,0,198,198,903
1995,11340,2736,3058,50180,49702,355,11.8,251,8.3,6528,1848,4680,3.7,13.1,5572,1740,3832,3.5,11.2,956,1.9,22.4,0,177,177,995
1996,11340,2763,3088,50887,50466,352,11.5,301,9.8,8304,4178,4126,8.3,16.5,7462,2933,4529,5.8,14.8,842,1.7,29.6,0,198,198,1595
1997,11340,2830,3182,50579,50741,400,12.7,299,9.5,7640,3477,4163,6.9,15.1,7964,3509,4455,6.9,15.7,-324,-0.6,30.2,0,177,177,1364
1998,11340,2893,3258,53655,52092,398,12.4,317,9.8,9193,5092,4101,9.8,17.6,6067,2409,3658,4.6,11.6,3126,6,23.2,0,212,212,845
1999,11340,2924,3289,55879,54761,356,10.9,327,10,9795,4800,4995,8.8,17.9,7559,2089,5470,3.8,13.8,2236,4.1,27.6,0,208,208,896
2000,11340,2986,3362,57595,56723,368,11.1,299,9,9959,5007,4952,8.8,17.6,8214,2248,5966,4,14.5,1745,3.1,29,0,195,195,953
2001,11340,2974,3344,57196,57442,337,10,374,11.1,8548,3763,4785,6.6,14.9,9040,2594,6446,4.5,15.7,-492,-0.8,29.8,0,223,223,1104
2002,11340,2951,3335,52729,54887,407,12.2,402,12.1,8962,5179,3783,9.4,16.3,13277,2827,10450,5.2,24.2,-4315,-7.9,32.6,0,228,228,1242
2003,11340,2993,3382,53750,52980,405,12.1,300,9,7866,3232,4634,6.1,14.8,6326,1888,4438,3.6,11.9,1540,2.9,23.8,0,215,215,1202
2004,11340,3037,3425,54530,53910,374,11,291,8.6,8051,2742,5309,5.1,14.9,6810,1903,4907,3.5,12.6,1241,2.3,25.2,0,203,203,873
2005,11340,3078,3488,52937,53671,380,11,301,8.7,6276,2405,3871,4.5,11.7,7744,1821,5923,3.4,14.4,-1468,-2.7,23.4,0,207,207,835
2006,11340,3053,3469,53731,53191,364,10.5,331,9.5,7595,2831,4764,5.3,14.3,6514,2215,4299,4.2,12.2,1081,2.1,24.4,0,230,230,1497
2007,11340,3133,3594,54522,53828,409,11.6,279,7.9,8147,3363,4784,6.2,15.1,6759,2067,4692,3.8,12.6,1388,2.5,25.2,0,180,180,1399
2008,11340,3123,3564,54871,54372,333,9.4,299,8.4,7440,1942,5498,3.6,13.7,6441,1852,4589,3.4,11.8,999,1.9,23.6,0,226,226,1492
2009,11340,2981,3424,51981,53350,261,7.5,368,10.6,5693,2565,3128,4.8,10.7,8430,1670,6760,3.1,15.8,-2737,-5.1,21.4,0,272,275,1170
2010,11340,2924,3364,51453,51658,264,7.8,331,9.8,6012,2497,3515,4.8,11.6,6422,1701,4721,3.3,12.4,-410,-0.8,23.2,0,237,237,1215
2011,11340,2888,3332,52939,52103,288,8.6,304,9.1,7341,1601,5740,3.1,14.1,5668,2328,3340,4.5,10.9,1673,3.2,21.8,0,218,218,1648
2012,11340,2891,3349,54853,53905,281,8.4,272,8.1,7962,2247,5715,4.2,14.8,6065,1364,4701,2.5,11.3,1897,3.5,22.6,0,174,174,755
2013,11340,2880,3333,56208,55440,259,7.8,265,8,6353,1786,4567,3.2,11.5,4816,1312,3504,2.4,8.7,1537,2.8,17.4,0,186,188,714
2014,11340,2884,3330,56553,56276,273,8.2,260,7.8,5554,1346,4208,2.4,9.9,4999,1645,3354,2.9,8.9,555,1,17.8,0,195,195,1291
1977,11460,3740,4138,90919,86267,697,17.3,458,11.4,18864,6452,12412,7.5,21.9,9559,4260,5299,4.9,11.1,9305,10.8,22.2,0,297,297,2315
1978,11460,3888,4295,101720,96301,644,15.3,488,11.6,18464,5000,13464,5.2,19.2,7626,3473,4153,3.6,7.9,10838,11.3,15.8,0,302,302,1474
1979,11460,4025,4446,136908,131456,625,14.3,454,10.4,20338,5015,15323,3.8,15.5,9433,3177,6256,2.4,7.2,10905,8.3,14.4,0,306,306,1743
1980,11460,4022,4446,128876,131473,542,12.2,526,11.8,13940,3762,10178,2.9,10.6,19133,4532,14601,3.4,14.6,-5193,-4,21.2,0,341,342,1728
1981,11460,3977,4384,126421,127473,546,12.4,567,12.9,15781,5404,10377,4.2,12.4,17885,4484,13401,3.5,14,-2104,-1.6,24.8,0,312,314,1817
1982,11460,4033,4512,125011,125564,623,14,452,10.2,16596,5258,11338,4.2,13.2,17701,3155,14546,2.5,14.1,-1105,-0.9,26.4,0,272,272,1595
1983,11460,4132,4619,122232,123779,544,11.9,473,10.4,13275,3233,10042,2.6,10.7,16369,4469,11900,3.6,13.2,-3094,-2.5,21.4,0,284,284,1967
1984,11460,4408,4918,104332,99105,721,15.1,417,8.7,20652,6456,14196,6.5,20.8,10197,3439,6758,3.5,10.3,10455,10.5,20.6,0,248,248,1406
1985,11460,4624,5153,105623,104989,729,14.5,502,10,18471,6098,12373,5.8,17.6,17202,4347,12855,4.1,16.4,1269,1.2,32.8,0,316,316,1906
1986,11460,4830,5367,111399,108296,755,14.4,522,9.9,19139,7148,11991,6.6,17.7,12933,4241,8692,3.9,11.9,6206,5.8,23.8,0,323,323,2823
1987,11460,5122,5686,120519,120339,895,16.2,563,10.2,17406,6576,10830,5.5,14.5,17046,5964,11082,5,14.2,360,0.3,28.4,0,340,342,2879
1988,11460,5216,5813,127512,123881,741,12.9,598,10.4,21474,6434,15040,5.2,17.3,14211,4770,9441,3.9,11.5,7263,5.8,23,0,382,382,2316
1989,11460,5358,6000,129694,128745,728,12.3,556,9.4,18801,6929,11872,5.4,14.6,16902,3993,12909,3.1,13.1,1899,1.5,26.2,0,390,391,2562
1990,11460,5469,6165,134673,132133,745,12.3,553,9.1,21100,7751,13349,5.9,16,16020,5251,10769,4,12.1,5080,3.9,24.2,0,375,375,2712
1991,11460,5541,6288,132255,133381,726,11.7,597,9.6,16837,5680,11157,4.3,12.6,19088,5398,13690,4,14.3,-2251,-1.7,25.2,0,365,366,2702
1992,11460,5658,6440,128888,130462,761,11.9,582,9.1,17701,5339,12362,4.1,13.6,20848,5551,15297,4.3,16,-3147,-2.4,27.2,0,345,345,2693
1993,11460,5793,6576,128643,128760,704,10.8,560,8.6,16535,5444,11091,4.2,12.8,16769,4383,12386,3.4,13,-234,-0.2,25.6,0,353,354,2139
1994,11460,5873,6650,128883,128679,726,11,626,9.5,16695,5218,11477,4.1,13,16286,6994,9292,5.4,12.7,409,0.3,25.4,0,388,389,2647
1995,11460,6010,6792,132459,130723,790,11.8,626,9.3,18695,6026,12669,4.6,14.3,15222,5673,9549,4.3,11.6,3473,2.7,23.2,0,422,422,3104
1996,11460,6175,6981,133152,132998,806,11.7,625,9.1,16270,5621,10649,4.2,12.2,15961,5313,10648,4,12,309,0.2,24,0,395,395,2983
1997,11460,6262,7065,139863,136427,827,11.8,727,10.3,21400,8085,13315,5.9,15.7,14527,5012,9515,3.7,10.6,6873,5.1,21.2,0,413,413,2006
1998,11460,6268,7082,144232,142026,760,10.7,723,10.2,21846,7091,14755,5,15.4,17434,7606,9828,5.4,12.3,4412,3.1,24.6,0,430,430,3574
1999,11460,6295,7130,148845,146669,738,10.4,688,9.7,22140,8668,13472,5.9,15.1,17787,6744,11043,4.6,12.1,4353,3,24.2,0,427,427,3129
2000,11460,6348,7184,152337,150519,739,10.3,690,9.6,22865,8040,14825,5.3,15.2,19228,7550,11678,5,12.8,3637,2.4,25.6,0,383,383,2309
2001,11460,6436,7306,158567,155707,788,10.9,737,10.2,24791,10795,13996,6.9,15.9,19070,5621,13449,3.6,12.2,5721,3.7,24.4,0,434,434,2654
2002,11460,6345,7232,145948,151995,871,12,926,12.8,19689,7700,11989,5.1,13,31782,7587,24195,5,20.9,-12093,-7.9,26,0,470,470,2869
2003,11460,6373,7283,147289,145821,791,11,621,8.6,21116,6843,14273,4.7,14.5,18180,5658,12522,3.9,12.5,2936,2,25,0,406,408,3149
2004,11460,6346,7224,150199,147743,770,10.7,718,9.9,23001,9815,13186,6.6,15.6,18089,6316,11773,4.3,12.2,4912,3.4,24.4,0,456,456,3680
2005,11460,6432,7319,149913,149726,854,11.8,691,9.5,21684,10069,11615,6.7,14.5,21310,5090,16220,3.4,14.2,374,0.3,28.4,0,483,483,2731
2006,11460,6386,7301,146932,147857,764,10.5,712,9.8,18399,5720,12679,3.9,12.4,20249,7740,12509,5.2,13.7,-1850,-1.3,24.8,0,471,476,4504
2007,11460,6372,7292,147808,147133,792,10.9,766,10.5,24117,5849,18268,4,16.4,22766,6937,15829,4.7,15.5,1351,0.9,31,0,462,467,3388
2008,11460,6357,7271,143213,144871,734,10.1,659,9.1,18498,8103,10395,5.6,12.8,21813,6014,15799,4.2,15.1,-3315,-2.3,25.6,0,448,448,2992
2009,11460,6200,7105,137898,139815,624,8.7,749,10.4,17451,6618,10833,4.7,12.5,21284,7249,14035,5.2,15.2,-3833,-2.7,25,0,472,473,4415
2010,11460,6100,6987,134738,136068,571,8.1,638,9.1,16101,6358,9743,4.7,11.8,18761,6257,12504,4.6,13.8,-2660,-2,23.6,0,382,382,2793
2011,11460,6078,6998,152846,143549,633,9.1,589,8.4,32343,3898,28445,2.7,22.5,13748,5287,8461,3.7,9.6,18595,12.9,19.2,0,404,404,3377
2012,11460,6166,7100,142725,147652,715,10.2,617,8.8,20019,5487,14532,3.7,13.6,29873,20847,9026,14.1,20.2,-9854,-6.6,27.2,0,380,380,18676
2013,11460,6208,7143,148740,145542,656,9.2,607,8.6,18685,6258,12427,4.3,12.8,12288,3679,8609,2.5,8.4,6397,4.4,16.8,0,363,363,2193
2014,11460,6248,7223,135887,134708,684,9.5,573,8,17977,4287,13690,3.2,13.3,15618,3912,11706,2.9,11.6,2359,1.7,23.2,0,355,356,1952
1977,11500,1614,1745,25493,25189,275,16,225,13.1,4940,2413,2527,9.6,19.6,4332,1937,2395,7.7,17.2,608,2.4,34.4,0,161,161,857
1978,11500,1705,1841,27495,26508,300,16.7,209,11.7,5342,1806,3536,6.8,20.2,3367,1567,1800,5.9,12.7,1975,7.5,25.4,0,153,153,717
1979,11500,1671,1810,27703,27568,259,14.2,274,15,4917,1756,3161,6.4,17.8,4647,1862,2785,6.8,16.9,270,0.9,33.8,0,193,193,849
1980,11500,1673,1811,27368,27536,235,13,226,12.5,4803,1955,2848,7.1,17.4,5139,1371,3768,5,18.7,-336,-1.3,34.8,0,166,166,884
1981,11500,1602,1726,26348,26599,221,12.5,270,15.3,4170,1457,2713,5.5,15.7,4674,1835,2839,6.9,17.6,-504,-1.9,31.4,0,174,174,919
1982,11500,1572,1709,27723,26962,226,13.2,223,13,6301,1438,4863,5.3,23.4,4779,1363,3416,5.1,17.7,1522,5.7,35.4,0,142,142,799
1983,11500,1608,1743,26658,26980,225,13,201,11.6,5249,2172,3077,8.1,19.5,5893,3895,1998,14.4,21.8,-644,-2.3,39,0,137,137,721
1984,11500,1667,1817,28454,27585,283,15.9,212,11.9,4606,1524,3082,5.5,16.7,2868,1033,1835,3.7,10.4,1738,6.3,20.8,0,139,139,543
1985,11500,1718,1878,29043,28885,284,15.3,229,12.4,4236,1544,2692,5.3,14.7,3920,1795,2125,6.2,13.6,316,1.1,27.2,0,157,157,1104
1986,11500,1736,1906,30206,29604,255,13.5,219,11.6,5839,2928,2911,9.9,19.7,4635,2201,2434,7.4,15.7,1204,4,31.4,0,142,142,1570
1987,11500,1753,1945,30937,30841,286,14.8,236,12.2,4753,2300,2453,7.5,15.4,4561,1393,3168,4.5,14.8,192,0.6,29.6,0,165,165,778
1988,11500,1725,1927,30277,30367,229,11.9,226,11.7,4706,1687,3019,5.6,15.5,4886,2168,2718,7.1,16.1,-180,-0.6,31,0,137,137,563
1989,11500,1780,1998,32633,31458,271,13.8,204,10.4,5631,2221,3410,7.1,17.9,3280,1087,2193,3.5,10.4,2351,7.5,20.8,0,138,138,675
1990,11500,1821,2039,33537,33033,254,12.6,198,9.8,5470,2630,2840,8,16.6,4461,1167,3294,3.5,13.5,1009,3.1,27,0,140,140,692
1991,11500,1843,2086,32744,32730,255,12.4,221,10.7,4820,2219,2601,6.8,14.7,4792,1527,3265,4.7,14.6,28,0.1,29.2,0,140,141,672
1992,11500,1876,2132,33031,32800,262,12.4,207,9.8,5197,2076,3121,6.3,15.8,4734,1853,2881,5.6,14.4,463,1.4,28.8,0,136,139,718
1993,11500,1912,2163,34289,33645,246,11.5,202,9.4,5192,1912,3280,5.7,15.4,3904,1307,2597,3.9,11.6,1288,3.8,23.2,0,140,140,820
1994,11500,1957,2204,34762,34516,258,11.8,217,9.9,4736,1796,2940,5.2,13.7,4244,1124,3120,3.3,12.3,492,1.4,24.6,0,154,154,738
1995,11500,2015,2259,36677,35698,281,12.6,219,9.8,6445,1748,4697,4.9,18.1,4486,1611,2875,4.5,12.6,1959,5.5,25.2,0,149,150,688
1996,11500,2056,2317,38030,37491,286,12.5,231,10.1,6193,2513,3680,6.7,16.5,5114,1304,3810,3.5,13.6,1079,2.9,27.2,0,166,166,902
1997,11500,2062,2337,37390,37486,279,12,251,10.8,6296,2570,3726,6.9,16.8,6488,3097,3391,8.3,17.3,-192,-0.5,33.6,0,168,168,1528
1998,11500,2056,2324,38207,37762,257,11,265,11.4,5995,2357,3638,6.2,15.9,5104,2237,2867,5.9,13.5,891,2.4,27,0,181,181,883
1999,11500,2074,2366,39956,39783,256,10.9,210,9,5537,2121,3416,5.3,13.9,5191,2042,3149,5.1,13,346,0.9,26,0,151,151,946
2000,11500,2053,2346,40427,40181,225,9.6,242,10.3,5477,2039,3438,5.1,13.6,4985,1749,3236,4.4,12.4,492,1.2,24.8,0,146,146,851
2001,11500,2037,2346,39727,40231,222,9.5,248,10.6,4595,1692,2903,4.2,11.4,5602,1592,4010,4,13.9,-1007,-2.5,22.8,0,143,143,844
2002,11500,2055,2376,38143,38913,266,11.3,233,9.9,5006,2192,2814,5.6,12.9,6545,1851,4694,4.8,16.8,-1539,-3.9,25.8,0,127,127,577
2003,11500,2039,2375,40501,39117,221,9.3,185,7.8,7004,3264,3740,8.3,17.9,4236,1086,3150,2.8,10.8,2768,7.1,21.6,0,135,135,734
2004,11500,2037,2369,40474,40414,206,8.7,199,8.4,5774,1408,4366,3.5,14.3,5653,1460,4193,3.6,14,121,0.3,28,0,121,121,516
2005,11500,2019,2357,40644,40391,192,8.2,182,7.7,5702,1715,3987,4.2,14.1,5195,1551,3644,3.8,12.9,507,1.2,25.8,0,130,130,1120
2006,11500,2017,2362,40900,40680,207,8.8,181,7.7,5651,2493,3158,6.1,13.9,5210,1563,3647,3.8,12.8,441,1.1,25.6,0,130,130,745
2007,11500,2044,2396,40397,40528,226,9.5,186,7.8,6394,2827,3567,7,15.8,6655,2623,4032,6.5,16.4,-261,-0.6,31.6,0,121,121,982
2008,11500,2015,2377,40777,40392,175,7.4,171,7.2,5173,1577,3596,3.9,12.8,4402,1252,3150,3.1,10.9,771,1.9,21.8,0,139,139,1052
2009,11500,1939,2304,37733,39034,156,6.7,192,8.2,3272,1466,1806,3.8,8.4,5874,1216,4658,3.1,15,-2602,-6.6,16.8,0,146,146,880
2010,11500,1915,2280,36470,37008,140,6.1,156,6.8,3467,1122,2345,3,9.4,4543,1059,3484,2.9,12.3,-1076,-2.9,18.8,0,109,114,588
2011,11500,1870,2217,35646,35945,150,6.7,178,8,4002,1147,2855,3.2,11.1,4599,1718,2881,4.8,12.8,-597,-1.7,22.2,0,112,112,586
2012,11500,1840,2176,34633,34985,142,6.5,173,7.9,3549,1079,2470,3.1,10.1,4252,1181,3071,3.4,12.2,-703,-2.1,20.2,0,121,121,540
2013,11500,1830,2165,34675,34483,138,6.4,143,6.6,4120,1230,2890,3.6,11.9,3735,975,2760,2.8,10.8,385,1.1,21.6,0,94,94,620
2014,11500,1817,2155,34605,34556,165,7.7,159,7.4,3473,1251,2222,3.6,10.1,3374,1017,2357,2.9,9.8,99,0.3,19.6,0,115,115,561
1977,11540,2647,2831,51148,49273,420,15.2,306,11,9195,4228,4967,8.6,18.7,5444,2789,2655,5.7,11,3751,7.7,22,0,188,191,1518
1978,11540,2776,2972,55226,53186,397,13.7,255,8.8,8709,2414,6295,4.5,16.4,4631,1721,2910,3.2,8.7,4078,7.7,17.4,0,178,178,913
1979,11540,2837,3035,59355,57269,365,12.2,285,9.5,9213,2741,6472,4.8,16.1,5042,1619,3423,2.8,8.8,4171,7.3,17.6,0,189,189,947
1980,11540,2879,3088,59930,59635,321,10.5,261,8.5,6563,1700,4863,2.9,11,5973,1355,4618,2.3,10,590,1,20,0,187,187,869
1981,11540,2828,3018,56155,57672,337,11.1,382,12.5,6791,2335,4456,4,11.8,9824,2648,7176,4.6,17,-3033,-5.2,23.6,0,220,221,932
1982,11540,2862,3078,57226,56641,365,12,273,9,7330,3444,3886,6.1,12.9,6160,1896,4264,3.3,10.9,1170,2,21.8,0,152,152,907
1983,11540,2934,3145,55656,56734,310,10,263,8.5,5865,2366,3499,4.2,10.3,8021,2165,5856,3.8,14.1,-2156,-3.8,20.6,0,160,160,769
1984,11540,3049,3273,59776,57451,391,12.2,267,8.3,9005,3318,5687,5.8,15.7,4354,1767,2587,3.1,7.6,4651,8.1,15.2,0,162,162,773
1985,11540,3149,3401,62664,61361,433,13,306,9.2,8309,3177,5132,5.2,13.5,5703,2070,3633,3.4,9.3,2606,4.2,18.6,0,195,195,857
1986,11540,3009,3262,63739,62937,314,9.4,408,12.3,9541,3722,5819,5.9,15.2,7936,3806,4130,6,12.6,1605,2.6,25.2,0,202,202,1537
1987,11540,3224,3537,66664,65390,487,14.3,234,6.9,10292,5189,5103,7.9,15.7,7744,2668,5076,4.1,11.8,2548,3.9,23.6,0,74,75,817
1988,11540,3269,3592,72973,69654,373,10.5,305,8.6,13395,5832,7563,8.4,19.2,6757,2151,4606,3.1,9.7,6638,9.5,19.4,0,201,201,1301
1989,11540,3328,3668,76775,74979,392,10.8,305,8.4,10533,3069,7464,4.1,14,6940,1771,5169,2.4,9.3,3593,4.7,18.6,0,207,207,1062
1990,11540,3415,3779,79906,78367,390,10.5,258,6.9,10049,2515,7534,3.2,12.8,6971,1901,5070,2.4,8.9,3078,3.9,17.8,0,165,167,1113
1991,11540,3487,3895,80346,80120,414,10.8,302,7.9,9346,3191,6155,4,11.7,8894,1961,6933,2.4,11.1,452,0.6,22.2,0,186,189,1143
1992,11540,3553,3995,83052,81688,427,10.8,320,8.1,11103,3887,7216,4.8,13.6,8374,2660,5714,3.3,10.3,2729,3.3,20.6,0,195,196,995
1993,11540,3653,4101,86082,84572,411,10.2,299,7.4,11172,3717,7455,4.4,13.2,8152,2835,5317,3.4,9.6,3020,3.6,19.2,0,204,204,1089
1994,11540,3775,4239,89637,87594,428,10.3,279,6.7,12528,4127,8401,4.7,14.3,8441,2201,6240,2.5,9.6,4087,4.7,19.2,0,175,176,1418
1995,11540,3865,4347,91909,90661,446,10.4,325,7.6,11041,3632,7409,4,12.2,8545,2970,5575,3.3,9.4,2496,2.8,18.8,0,206,206,1292
1996,11540,3975,4460,95277,93597,467,10.6,351,8,11814,4701,7113,5,12.6,8453,2858,5595,3.1,9,3361,3.6,18,0,211,211,1183
1997,11540,4137,4646,97725,96747,568,12.5,386,8.5,12918,5389,7529,5.6,13.4,10961,3924,7037,4.1,11.3,1957,2.1,22.6,0,233,233,1788
1998,11540,4161,4695,97798,97743,473,10.1,412,8.8,12805,4987,7818,5.1,13.1,12695,5077,7618,5.2,13,110,0.1,26,0,260,260,1434
1999,11540,4223,4761,102724,100243,466,9.9,402,8.5,14948,3903,11045,3.9,14.9,9985,3522,6463,3.5,10,4963,4.9,20,0,234,234,1666
2000,11540,4310,4871,107977,105489,507,10.5,404,8.4,15417,4613,10804,4.4,14.6,10440,3810,6630,3.6,9.9,4977,4.7,19.8,0,238,238,1708
2001,11540,4366,4963,107537,107840,509,10.3,452,9.2,13439,5099,8340,4.7,12.5,14044,4502,9542,4.2,13,-605,-0.5,25,0,257,257,1421
2002,11540,4400,4991,104839,106042,527,10.6,483,9.7,16058,5982,10076,5.6,15.1,18464,4887,13577,4.6,17.4,-2406,-2.3,30.2,0,224,224,2116
2003,11540,4453,5048,104891,104440,495,9.9,363,7.3,12764,4126,8638,4,12.2,11861,3239,8622,3.1,11.4,903,0.8,22.8,0,232,232,1258
2004,11540,4516,5146,105393,104936,489,9.6,359,7.1,13575,4197,9378,4,12.9,12660,3148,9512,3,12.1,915,0.8,24.2,0,245,245,1798
2005,11540,4611,5256,106992,106098,507,9.8,366,7.1,14883,5800,9083,5.5,14,13095,3674,9421,3.5,12.3,1788,1.7,24.6,0,252,254,1954
2006,11540,4591,5318,106855,106574,565,10.7,456,8.6,13448,5679,7769,5.3,12.6,12886,4621,8265,4.3,12.1,562,0.5,24.2,0,292,292,2444
2007,11540,4648,5421,106168,106360,566,10.6,452,8.4,13637,4938,8699,4.6,12.8,14021,4891,9130,4.6,13.2,-384,-0.4,25.6,0,258,259,1873
2008,11540,4617,5422,109853,107750,449,8.3,392,7.3,15936,4518,11418,4.2,14.8,11730,3154,8576,2.9,10.9,4206,3.9,21.8,0,258,265,1997
2009,11540,4566,5377,103364,105990,411,7.6,426,7.9,9274,2744,6530,2.6,8.7,14526,3050,11476,2.9,13.7,-5252,-5,17.4,0,263,263,1811
2010,11540,4455,5273,101208,102073,353,6.6,424,8,8882,2837,6045,2.8,8.7,10611,2605,8006,2.6,10.4,-1729,-1.7,17.4,0,246,246,1291
2011,11540,4470,5292,104052,102351,424,8,390,7.4,11738,2770,8968,2.7,11.5,8336,2096,6240,2,8.1,3402,3.4,16.2,0,245,249,1363
2012,11540,4500,5319,104553,104248,448,8.5,422,8,11636,3149,8487,3,11.2,11026,2431,8595,2.3,10.6,610,0.6,21.2,0,236,240,1175
2013,11540,4488,5280,106893,105624,367,6.9,390,7.4,13179,3267,9912,3.1,12.5,10640,3764,6876,3.6,10.1,2539,2.4,20.2,0,231,232,2006
2014,11540,4483,5274,108252,107365,379,7.2,349,6.6,11765,3848,7917,3.6,11,9990,3161,6829,2.9,9.3,1775,1.7,18.6,0,227,228,2511
1977,11700,4565,5053,73373,72248,835,16.7,705,14.1,12704,5545,7159,7.7,17.6,10454,4459,5995,6.2,14.5,2250,3.1,29,0,480,481,2723
1978,11700,4748,5263,81078,77233,840,16.3,631,12.2,15708,6139,9569,7.9,20.3,8017,2986,5031,3.9,10.4,7691,9.9,20.8,0,456,459,1782
1979,11700,4854,5401,85041,82994,791,14.8,618,11.6,14142,5772,8370,7,17,10048,3233,6815,3.9,12.1,4094,4.9,24.2,0,450,450,1943
1980,11700,4883,5448,86703,85836,714,13.2,649,12,13753,5601,8152,6.5,16,12018,3650,8368,4.3,14,1735,2,28,0,472,476,1825
1981,11700,4803,5339,83456,84444,687,12.8,763,14.2,12177,4734,7443,5.6,14.4,14153,5896,8257,7,16.8,-1976,-2.4,28.8,0,462,464,2081
1982,11700,4912,5518,82586,82961,871,16,629,11.6,12018,6021,5997,7.3,14.5,12768,4909,7859,5.9,15.4,-750,-0.9,29,0,385,385,1732
1983,11700,4729,5333,83438,82602,684,12.6,790,14.6,13186,5917,7269,7.2,16,11513,5420,6093,6.6,13.9,1673,2.1,27.8,0,423,423,2979
1984,11700,5383,6013,91910,87801,918,16.2,344,6.1,17260,6148,11112,7,19.7,9042,2429,6613,2.8,10.3,8218,9.4,20.6,0,19,19,193
1985,11700,5626,6295,96372,94758,934,15.2,661,10.7,18015,8522,9493,9,19,14786,4536,10250,4.8,15.6,3229,3.4,31.2,0,443,443,2318
1986,11700,5845,6534,116048,106004,967,15.1,694,10.8,33559,6722,26837,6.3,31.7,13471,5055,8416,4.8,12.7,20088,19,25.4,0,456,456,2318
1987,11700,6059,6835,100762,108360,1056,15.8,722,10.8,17449,6905,10544,6.4,16.1,32644,6399,26245,5.9,30.1,-15195,-14,32.2,0,486,486,3282
1988,11700,6097,6930,106389,103716,915,13.3,792,11.5,17339,6879,10460,6.6,16.7,11992,4174,7818,4,11.6,5347,5.1,23.2,0,529,529,1993
1989,11700,6289,7152,113025,109711,927,13.2,708,10.1,18749,6287,12462,5.7,17.1,12121,4293,7828,3.9,11,6628,6.1,22,0,461,466,2215
1990,11700,6437,7352,115020,113787,934,12.9,689,9.5,18207,8077,10130,7.1,16,15741,5618,10123,4.9,13.8,2466,2.2,27.6,0,488,488,4005
1991,11700,6485,7457,110143,112690,910,12.3,812,11,17127,7276,9851,6.5,15.2,22221,6751,15470,6,19.7,-5094,-4.5,30.4,0,505,507,3179
1992,11700,6509,7482,112375,111157,849,11.4,767,10.3,17365,5936,11429,5.3,15.6,14929,4690,10239,4.2,13.4,2436,2.2,26.8,0,486,486,2244
1993,11700,6646,7631,115947,114122,835,11.1,666,8.8,16600,4743,11857,4.2,14.5,12950,4395,8555,3.9,11.3,3650,3.2,22.6,0,465,466,2824
1994,11700,6882,7882,120059,117938,986,12.7,692,8.9,18982,6933,12049,5.9,16.1,14739,4826,9913,4.1,12.5,4243,3.6,25,0,456,458,1801
1995,11700,7072,8102,124016,121970,988,12.4,746,9.3,18004,5831,12173,4.8,14.8,13912,5310,8602,4.4,11.4,4092,3.4,22.8,0,521,521,2694
1996,11700,7267,8300,126519,125354,940,11.5,712,8.7,17339,6685,10654,5.3,13.8,15008,3789,11219,3,12,2331,1.8,24,0,465,465,2155
1997,11700,7493,8574,132332,129503,1068,12.6,806,9.5,21605,8001,13604,6.2,16.7,15946,5877,10069,4.5,12.3,5659,4.4,24.6,0,526,526,2797
1998,11700,7638,8763,134827,133353,1071,12.4,856,9.9,19519,7307,12212,5.5,14.6,16570,5667,10903,4.2,12.4,2949,2.2,24.8,0,559,559,2660
1999,11700,7798,8960,138691,137615,1107,12.5,899,10.1,20541,7962,12579,5.8,14.9,18390,7748,10642,5.6,13.4,2151,1.5,26.8,0,590,590,4056
2000,11700,7877,9048,143760,140714,1041,11.6,960,10.7,21991,8844,13147,6.3,15.6,15900,5874,10026,4.2,11.3,6091,4.3,22.6,0,594,594,2947
2001,11700,8008,9215,141464,142924,1080,11.8,1000,10.9,19221,6901,12320,4.8,13.4,22141,7859,14282,5.5,15.5,-2920,-2.1,26.8,0,587,587,2610
2002,11700,8196,9435,141463,141445,1268,13.6,1040,11.2,21582,8859,12723,6.3,15.3,21546,6903,14643,4.9,15.2,36,0.1,30.4,0,564,564,2536
2003,11700,8354,9620,149134,145455,1188,12.5,826,8.7,25650,8970,16680,6.2,17.6,18291,6707,11584,4.6,12.6,7359,5,25.2,0,567,569,3425
2004,11700,8553,9806,148808,148255,1147,11.8,856,8.8,19739,6322,13417,4.3,13.3,18632,5740,12892,3.9,12.6,1107,0.7,25.2,0,583,583,4053
2005,11700,8759,10068,150345,149153,1294,13.1,941,9.5,22196,8893,13303,6,14.9,19812,5661,14151,3.8,13.3,2384,1.6,26.6,0,677,679,3944
2006,11700,8961,10341,152331,150877,1360,13.4,998,9.8,22745,8330,14415,5.5,15.1,19837,7587,12250,5,13.1,2908,2,26.2,0,686,686,3618
2007,11700,9328,10751,155241,153555,1415,13.4,992,9.4,23569,9098,14471,5.9,15.3,20196,5851,14345,3.8,13.2,3373,2.1,26.4,0,642,644,3845
2008,11700,9315,10779,155684,155030,1157,10.8,1059,9.9,19788,6742,13046,4.3,12.8,18479,6549,11930,4.2,11.9,1309,0.9,23.8,0,770,770,4629
2009,11700,8960,10443,146166,150489,959,9.1,1200,11.3,16248,7329,8919,4.9,10.8,24894,5339,19555,3.5,16.5,-8646,-5.7,21.6,0,856,856,2865
2010,11700,8632,10112,141473,143204,891,8.7,1162,11.3,17748,8080,9668,5.6,12.4,21210,5615,15595,3.9,14.8,-3462,-2.4,24.8,0,763,767,3338
2011,11700,8502,10018,143536,142297,947,9.4,962,9.6,17161,5777,11384,4.1,12.1,14683,4290,10393,3,10.3,2478,1.8,20.6,0,662,662,3175
2012,11700,8608,10149,144653,143964,1029,10.2,912,9.1,18267,6255,12012,4.3,12.7,16889,4680,12209,3.3,11.7,1378,1,23.4,0,561,567,2556
2013,11700,8685,10226,147126,145789,969,9.5,902,8.9,17205,5868,11337,4,11.8,14531,4184,10347,2.9,10,2674,1.8,20,0,605,605,2684
2014,11700,8714,10257,153911,150097,1048,10.3,944,9.3,21733,5814,15919,3.9,14.5,14104,4933,9171,3.3,9.4,7629,5.1,18.8,0,635,638,3220
1977,12020,1797,1921,27339,26315,331,17.7,220,11.8,5247,2406,2841,9.1,19.9,3198,1287,1911,4.9,12.2,2049,7.7,24.4,0,144,144,762
1978,12020,1851,1976,31105,29207,300,15.4,245,12.6,6369,1596,4773,5.5,21.8,2573,1259,1314,4.3,8.8,3796,13,17.6,0,173,173,706
1979,12020,1878,2001,35050,34051,295,14.8,257,12.9,6382,1945,4437,5.7,18.7,4383,1235,3148,3.6,12.9,1999,5.8,25.8,0,191,191,823
1980,12020,1899,2030,41207,38118,270,13.4,231,11.5,12377,1763,10614,4.6,32.5,6198,2974,3224,7.8,16.3,6179,16.2,32.6,0,166,168,1287
1981,12020,1881,2039,31720,35289,317,15.6,284,14,5787,2884,2903,8.2,16.4,12925,2021,10904,5.7,36.6,-7138,-20.2,32.8,0,181,181,1014
1982,12020,1901,2087,31650,31702,319,15.5,249,12.1,4673,2613,2060,8.2,14.7,4776,1562,3214,4.9,15.1,-103,-0.4,29.4,0,141,141,807
1983,12020,1966,2157,32751,32042,287,13.5,225,10.6,5661,2339,3322,7.3,17.7,4243,1387,2856,4.3,13.2,1418,4.5,26.4,0,152,153,836
1984,12020,2071,2264,35446,34123,337,15.2,242,11,6490,2428,4062,7.1,19,3844,1418,2426,4.2,11.3,2646,7.7,22.6,0,153,153,889
1985,12020,2216,2402,39204,38460,362,15.5,233,10,6578,2617,3961,6.8,17.1,5090,1604,3486,4.2,13.2,1488,3.9,26.4,0,144,145,806
1986,12020,2281,2470,41108,40121,361,14.8,278,11.4,7122,2325,4797,5.8,17.8,5147,1976,3171,4.9,12.8,1975,5,25.6,0,183,183,949
1987,12020,2368,2565,43554,42423,368,14.6,266,10.5,6763,2473,4290,5.8,15.9,4500,1853,2647,4.4,10.6,2263,5.3,21.2,0,177,177,1027
1988,12020,2436,2648,40935,40976,354,13.6,270,10.4,6684,2546,4138,6.2,16.3,6765,2296,4469,5.6,16.5,-81,-0.2,32.6,0,164,164,879
1989,12020,2522,2758,43573,42275,384,14.2,271,10,8330,3784,4546,9,19.7,5734,2037,3697,4.8,13.6,2596,6.1,27.2,0,193,193,1252
1990,12020,2528,2768,43455,43464,341,12.3,307,11.1,6895,2362,4533,5.4,15.9,6913,3060,3853,7,15.9,-18,0,31.8,0,204,204,1753
1991,12020,2578,2843,44190,43743,366,13.1,288,10.3,7109,3543,3566,8.1,16.3,6215,2073,4142,4.7,14.2,894,2.1,28.4,0,177,179,1082
1992,12020,2590,2849,50906,47520,346,12.1,322,11.3,14219,10795,3424,22.7,29.9,7446,2748,4698,5.8,15.7,6773,14.2,31.4,0,197,202,1652
1993,12020,2688,2965,43417,47162,359,12.4,237,8.2,5748,1943,3805,4.1,12.2,13237,1640,11597,3.5,28.1,-7489,-15.9,24.4,0,161,161,1020
1994,12020,2715,2995,44287,43835,358,12,316,10.6,6448,2455,3993,5.6,14.7,5544,2109,3435,4.8,12.6,904,2.1,25.2,0,217,217,1004
1995,12020,2833,3115,48734,46542,397,13,277,9.1,9048,3004,6044,6.5,19.4,4664,1684,2980,3.6,10,4384,9.4,20,0,205,205,1051
1996,12020,2913,3198,51928,51502,383,12.1,297,9.4,7672,2649,5023,5.1,14.9,6819,2401,4418,4.7,13.2,853,1.7,26.4,0,202,202,1172
1997,12020,2964,3279,51251,51542,420,13,329,10.2,7888,3925,3963,7.6,15.3,8469,3039,5430,5.9,16.4,-581,-1.1,30.6,0,204,204,889
1998,12020,2999,3308,52840,51998,402,12.2,360,10.9,8418,3898,4520,7.5,16.2,6733,2785,3948,5.4,12.9,1685,3.3,25.8,0,238,238,1767
1999,12020,3069,3380,54003,53398,404,12.1,321,9.6,7347,2333,5014,4.4,13.8,6137,2056,4081,3.9,11.5,1210,2.3,23,0,209,209,1104
2000,12020,3117,3447,55555,54764,445,13,373,10.9,9141,3921,5220,7.2,16.7,7559,2654,4905,4.8,13.8,1582,2.9,27.6,0,223,223,1031
2001,12020,3201,3548,56780,56404,412,11.8,351,10,8458,2410,6048,4.3,15,7706,2349,5357,4.2,13.7,752,1.3,27.4,0,209,209,1192
2002,12020,3258,3604,54581,55610,473,13.2,409,11.5,8240,3378,4862,6.1,14.8,10298,2944,7354,5.3,18.5,-2058,-3.7,29.6,0,209,210,1117
2003,12020,3322,3672,55425,54853,432,11.9,308,8.5,7922,2755,5167,5,14.4,6778,1888,4890,3.4,12.4,1144,2,24.8,0,199,199,987
2004,12020,3391,3746,56989,55946,413,11.2,289,7.8,8552,2470,6082,4.4,15.3,6465,2194,4271,3.9,11.6,2087,3.7,23.2,0,200,200,1003
2005,12020,3492,3857,56845,56895,473,12.5,320,8.4,8100,3462,4638,6.1,14.2,8200,2002,6198,3.5,14.4,-100,-0.2,28.4,0,223,223,1057
2006,12020,3535,3915,57738,57303,468,12.1,387,10,8046,3009,5037,5.3,14,7176,2524,4652,4.4,12.5,870,1.5,25,0,249,249,1416
2007,12020,3643,4041,58609,58092,476,12,351,8.8,8942,3363,5579,5.8,15.4,7908,2082,5826,3.6,13.6,1034,1.8,27.2,0,222,222,1118
2008,12020,3643,4097,58498,58396,464,11.4,378,9.3,8332,3668,4664,6.3,14.3,8127,1986,6141,3.4,13.9,205,0.4,27.8,0,262,262,1395
2009,12020,3490,3940,55422,56763,338,8.4,462,11.5,6130,2576,3554,4.5,10.8,8811,2170,6641,3.8,15.5,-2681,-4.7,21.6,0,310,311,1438
2010,12020,3453,3896,53695,54452,345,8.8,372,9.5,5243,1851,3392,3.4,9.6,6757,2397,4360,4.4,12.4,-1514,-2.8,19.2,0,256,256,1164
2011,12020,3429,3891,56056,54719,371,9.5,359,9.2,7983,1976,6007,3.6,14.6,5309,1676,3633,3.1,9.7,2674,4.9,19.4,0,243,243,1114
2012,12020,3425,3881,54874,55410,381,9.8,384,9.9,6992,2575,4417,4.6,12.6,8064,4044,4020,7.3,14.6,-1072,-2,25.2,0,213,213,888
2013,12020,3492,3932,56963,55844,368,9.5,326,8.4,7003,2283,4720,4.1,12.5,4765,1724,3041,3.1,8.5,2238,4,17,0,214,214,1268
2014,12020,3537,3985,56705,56754,396,10,314,8,7386,2581,4805,4.5,13,7484,3351,4133,5.9,13.2,-98,-0.2,26,0,220,221,865
1977,12060,34571,42714,754858,730173,8506,20.4,6198,14.9,179082,86656,92426,11.9,24.5,129714,53447,76267,7.3,17.8,49368,6.7,35.6,0,4030,4054,28715
1978,12060,36088,44421,818555,786515,7473,17.2,5741,13.2,181644,62476,119168,7.9,23.1,117565,45256,72309,5.8,14.9,64079,8.2,29.8,0,3851,3860,23751
1979,12060,37265,46131,862882,839977,7550,16.7,5575,12.3,177903,69842,108061,8.3,21.2,132093,48261,83832,5.7,15.7,45810,5.5,31.4,0,3820,3827,21446
1980,12060,38525,47615,886894,874430,7176,15.3,5555,11.9,159851,62125,97726,7.1,18.3,134922,44044,90878,5,15.4,24929,2.9,30.8,0,3788,3806,20933
1981,12060,38552,47577,914742,898680,7105,14.9,6816,14.3,185413,72621,112792,8.1,20.6,153288,58588,94700,6.5,17.1,32125,3.5,34.2,0,3930,3938,23066
1982,12060,39739,49926,951386,932312,8599,17.6,5863,12,200262,103447,96815,11.1,21.5,162113,52728,109385,5.7,17.4,38149,4.1,34.8,0,3043,3048,21233
1983,12060,42028,52416,957737,950254,7932,15.5,5649,11,188437,74682,113755,7.9,19.8,173470,51686,121784,5.4,18.3,14967,1.5,36.6,0,3540,3544,22063
1984,12060,44770,55582,1057991,1009769,8957,16.6,5866,10.9,225798,85495,140303,8.5,22.4,129353,51507,77846,5.1,12.8,96445,9.6,25.6,0,3546,3559,24024
1985,12060,48073,59318,1155545,1110682,10061,17.5,6338,11,249544,89731,159813,8.1,22.5,159818,61926,97892,5.6,14.4,89726,8.1,28.8,0,3762,3792,25971
1986,12060,51109,62906,1240299,1196447,10923,17.9,7089,11.6,265209,102470,162739,8.6,22.2,177505,71574,105931,6,14.8,87704,7.4,29.6,0,4244,4244,28833
1987,12060,53511,66492,1284813,1267679,11915,18.4,8109,12.5,275583,126182,149401,10,21.7,241314,89914,151400,7.1,19,34269,2.7,38,0,4899,4927,36140
1988,12060,55079,68802,1337841,1307964,11045,16.3,8468,12.5,293870,117848,176022,9,22.5,234117,91354,142763,7,17.9,59753,4.6,35.8,0,5366,5369,38161
1989,12060,56297,70923,1392930,1367626,10944,15.7,8849,12.7,315324,136755,178569,10,23.1,264716,92550,172166,6.8,19.4,50608,3.7,38.8,0,5572,5599,43910
1990,12060,57067,72300,1437301,1415471,10264,14.3,8409,11.7,282551,101756,180795,7.2,20,238891,80866,158025,5.7,16.9,43660,3.1,33.8,0,5508,5539,40113
1991,12060,58710,74431,1391885,1415466,11173,15.2,9112,12.4,253284,113391,139893,8,17.9,300447,115860,184587,8.2,21.2,-47163,-3.3,35.8,0,5311,5443,64453
1992,12060,60389,76316,1425119,1408989,11757,15.6,9572,12.7,290354,110732,179622,7.9,20.6,258094,111804,146290,7.9,18.3,32260,2.3,36.6,0,5666,5785,51094
1993,12060,63059,78629,1479172,1452025,11322,14.6,8837,11.4,281962,105423,176539,7.3,19.4,227668,85698,141970,5.9,15.7,54294,3.7,31.4,0,5498,5529,40951
1994,12060,65643,81786,1555201,1513671,12394,15.5,9029,11.3,302888,119577,183311,7.9,20,219828,87057,132771,5.8,14.5,83060,5.5,29,0,5771,5794,37455
1995,12060,68663,85628,1665961,1609892,13223,15.8,9083,10.9,339775,138969,200806,8.6,21.1,227638,87905,139733,5.5,14.1,112137,7,28.2,0,5807,5843,43182
1996,12060,71258,88701,1727059,1695715,13488,15.5,10154,11.7,338336,138244,200092,8.2,20,275648,114306,161342,6.7,16.3,62688,3.7,32.6,0,6311,6311,48106
1997,12060,73562,91971,1793935,1759768,14318,15.8,11036,12.2,382709,150664,232045,8.6,21.7,314374,118487,195887,6.7,17.9,68335,3.8,35.8,0,6700,6700,52329
1998,12060,75447,94582,1867421,1831140,14227,15.3,11345,12.2,379813,149912,229901,8.2,20.7,307251,124604,182647,6.8,16.8,72562,3.9,33.6,0,6960,6960,51460
1999,12060,77383,97246,2018921,1946689,14031,14.6,11257,11.7,439219,178704,260515,9.2,22.6,294754,120343,174411,6.2,15.1,144465,7.5,30.2,0,6862,6862,49482
2000,12060,78558,99305,2098930,2060269,14349,14.6,12313,12.5,417795,165051,252744,8,20.3,340472,149023,191449,7.2,16.5,77323,3.8,33,0,7030,7030,50331
2001,12060,80012,101696,2126720,2115414,14379,14.3,12695,12.6,385161,165468,219693,7.8,18.2,362551,126534,236017,6,17.1,22610,1.1,34.2,0,7019,7021,49779
2002,12060,81459,103251,2078305,2100130,15949,15.6,14296,14,392917,178160,214757,8.5,18.7,436568,170043,266525,8.1,20.8,-43651,-2.1,37.4,0,7078,7092,62019
2003,12060,83253,105191,2059938,2051750,15413,14.9,11159,10.8,352229,142819,209410,7,17.2,335853,104766,231087,5.1,16.4,16376,0.8,32.8,0,7193,7206,51698
2004,12060,85794,107997,2104590,2070164,15367,14.5,11216,10.6,373568,137751,235817,6.7,18,304716,101108,203608,4.9,14.7,68852,3.3,29.4,0,7137,7167,48320
2005,12060,88888,111813,2143977,2114676,16239,14.8,11257,10.3,364712,143111,221601,6.8,17.2,306110,107854,198256,5.1,14.5,58602,2.7,29,0,7344,7347,58885
2006,12060,91822,115603,2251708,2190385,17052,15,12168,10.7,420340,167717,252623,7.7,19.2,297693,115879,181814,5.3,13.6,122647,5.6,27.2,0,7793,7802,64481
2007,12060,94496,119598,2295095,2267425,17466,14.9,13173,11.2,415226,156611,258615,6.9,18.3,359887,120522,239365,5.3,15.9,55339,2.4,31.8,0,8193,8291,52512
2008,12060,93930,119655,2277314,2276773,15639,13.1,14257,12,382569,152999,229570,6.7,16.8,381486,139353,242133,6.1,16.8,1083,0,33.6,0,9864,9873,64703
2009,12060,89236,114677,2122924,2188848,12692,10.9,15934,13.7,290018,129430,160588,5.9,13.2,421865,122814,299051,5.6,19.3,-131847,-6.1,26.4,0,10741,10811,72897
2010,12060,87523,112416,2082188,2096248,12354,10.9,13677,12.1,288149,113048,175101,5.4,13.7,316271,101942,214329,4.9,15.1,-28122,-1.4,27.4,0,8722,8737,57717
2011,12060,86996,111999,2074524,2069017,12903,11.5,12557,11.2,303252,101301,201951,4.9,14.7,292238,110147,182091,5.3,14.1,11014,0.6,28.2,0,8029,8048,54741
2012,12060,88394,113697,2123353,2092948,14050,12.5,12194,10.8,332371,118286,214085,5.7,15.9,271561,104399,167162,5,13,60810,2.9,26,0,7066,7117,43724
2013,12060,89865,115278,2165397,2138268,12861,11.3,11258,9.9,312668,88479,224189,4.1,14.6,258410,92645,165765,4.3,12.1,54258,2.5,24.2,0,6874,6879,45475
2014,12060,90929,116898,2189512,2166010,13766,11.9,11262,9.7,327301,104915,222386,4.8,15.1,280296,105652,174644,4.9,12.9,47005,2.2,25.8,0,7515,7528,42945
1977,12100,3590,3862,47642,47819,554,14.4,513,13.3,8098,2917,5181,6.1,16.9,8451,3312,5139,6.9,17.7,-353,-0.8,33.8,0,314,315,1351
1978,12100,3681,3963,49069,48354,605,15.5,506,12.9,10160,3592,6568,7.4,21,8730,3846,4884,8,18.1,1430,2.9,36.2,0,322,323,2053
1979,12100,3799,4080,55319,52145,627,15.6,480,11.9,14816,5974,8842,11.5,28.4,8468,3578,4890,6.9,16.2,6348,12.2,32.4,0,326,327,1996
1980,12100,3906,4217,69132,62313,643,15.5,502,12.1,23392,4870,18522,7.8,37.5,9753,3477,6276,5.6,15.7,13639,21.8,31.4,0,366,366,2048
1981,12100,3714,4016,78120,73023,525,12.8,670,16.3,22059,10486,11573,14.4,30.2,11864,4369,7495,6,16.2,10195,14,32.4,0,421,421,1955
1982,12100,3707,4067,88152,83147,622,15.4,535,13.2,24160,7487,16673,9,29.1,14150,4506,9644,5.4,17,10010,12.1,34,0,310,310,2300
1983,12100,3773,4134,83527,85937,514,12.5,472,11.5,12990,3724,9266,4.3,15.1,17809,5791,12018,6.7,20.7,-4819,-5.6,30.2,0,317,321,1889
1984,12100,3884,4271,86142,84737,630,15,484,11.5,17290,7508,9782,8.9,20.4,14479,9740,4739,11.5,17.1,2811,3.3,34.2,0,312,312,3933
1985,12100,4070,4487,91848,89826,685,15.6,478,10.9,17096,8149,8947,9.1,19,13051,5291,7760,5.9,14.5,4045,4.5,29,0,330,332,2689
1986,12100,4188,4637,99472,95592,674,14.8,503,11,18195,9640,8555,10.1,19,10437,3256,7181,3.4,10.9,7758,8.1,21.8,0,344,344,2312
1987,12100,4351,4861,113486,106434,786,16.5,543,11.4,26698,12384,14314,11.6,25.1,12595,4700,7895,4.4,11.8,14103,13.3,23.6,0,364,366,2678
1988,12100,4506,5103,107995,109743,775,15.6,516,10.4,16391,6705,9686,6.1,14.9,19887,4819,15068,4.4,18.1,-3496,-3.2,29.8,0,347,347,2417
1989,12100,4556,5175,112944,110570,654,12.7,590,11.5,16925,4992,11933,4.5,15.3,12177,4344,7833,3.9,11,4748,4.3,22,0,388,388,2524
1990,12100,4611,5257,115744,114230,678,13,547,10.5,21173,9519,11654,8.3,18.5,18145,8719,9426,7.6,15.9,3028,2.6,31.8,0,351,351,2045
1991,12100,4584,5236,109687,112853,634,12.1,650,12.4,14887,4892,9995,4.3,13.2,21219,5161,16058,4.6,18.8,-6332,-5.6,26.4,0,408,413,3051
1992,12100,4563,5240,108432,109102,626,11.9,597,11.4,10694,3714,6980,3.4,9.8,12033,3737,8296,3.4,11,-1339,-1.2,19.6,0,378,379,2379
1993,12100,4554,5187,109386,108826,526,10.1,575,11,13739,3688,10051,3.4,12.6,12619,4858,7761,4.5,11.6,1120,1,23.2,0,363,364,2011
1994,12100,4618,5241,113320,111317,590,11.3,523,10,17736,8648,9088,7.8,15.9,13730,7277,6453,6.5,12.3,4006,3.6,24.6,0,329,330,5615
1995,12100,4740,5364,114651,113996,642,12.1,496,9.4,13546,5315,8231,4.7,11.9,12235,3184,9051,2.8,10.7,1311,1.2,21.4,0,327,327,1614
1996,12100,4754,5386,115064,114822,586,10.9,543,10.1,11843,4094,7749,3.6,10.3,11359,3273,8086,2.9,9.9,484,0.4,19.8,0,365,365,1712
1997,12100,4808,5435,117841,116097,698,12.9,652,12,17177,6363,10814,5.5,14.8,13689,4822,8867,4.2,11.8,3488,3,23.6,0,388,388,2086
1998,12100,4841,5487,119507,118592,679,12.4,603,11,16482,6163,10319,5.2,13.9,14651,4720,9931,4,12.4,1831,1.5,24.8,0,415,415,2175
1999,12100,4798,5428,122081,121424,575,10.5,618,11.3,14168,4841,9327,4,11.7,12853,4044,8809,3.3,10.6,1315,1.1,21.2,0,398,398,2287
2000,12100,4879,5525,119899,120495,614,11.2,520,9.5,12151,3949,8202,3.3,10.1,13343,3582,9761,3,11.1,-1192,-1,20.2,0,312,312,1471
2001,12100,4985,5658,122071,121457,645,11.5,566,10.1,16681,7781,8900,6.4,13.7,15453,6808,8645,5.6,12.7,1228,1,25.4,0,343,343,1813
2002,12100,4982,5698,124668,123258,707,12.5,662,11.7,17676,6338,11338,5.1,14.3,14855,5308,9547,4.3,12.1,2821,2.2,24.2,0,349,349,2389
2003,12100,4997,5676,124399,124141,638,11.3,560,9.9,15726,4405,11321,3.5,12.7,15210,3603,11607,2.9,12.3,516,0.4,24.6,0,343,343,1732
2004,12100,5102,5804,128189,126125,657,11.5,481,8.4,18633,4879,13754,3.9,14.8,14505,3230,11275,2.6,11.5,4128,3.3,23,0,312,312,1713
2005,12100,5234,5983,128740,127956,772,13.1,572,9.7,16856,6318,10538,4.9,13.2,15287,5839,9448,4.6,11.9,1569,1.3,23.8,0,387,387,2615
2006,12100,5305,6076,129544,128970,725,12.1,575,9.6,13498,5112,8386,4,10.5,12350,3660,8690,2.8,9.6,1148,0.9,19.2,0,378,378,2050
2007,12100,5390,6192,128346,128690,720,11.8,583,9.5,17993,6046,11947,4.7,14,18680,6950,11730,5.4,14.5,-687,-0.5,28,0,382,384,2397
2008,12100,5352,6184,127290,127284,638,10.4,602,9.8,14215,4931,9284,3.9,11.2,14202,4115,10087,3.2,11.2,13,0,22.4,0,436,436,2808
2009,12100,5086,5928,116675,121549,481,8,668,11.1,9953,4249,5704,3.5,8.2,19700,3369,16331,2.8,16.2,-9747,-8,16.4,0,458,459,2292
2010,12100,4952,5757,114235,115144,484,8.3,614,10.5,10910,3690,7220,3.2,9.5,12728,4342,8386,3.8,11.1,-1818,-1.6,19,0,369,369,1872
2011,12100,4875,5680,111106,112462,474,8.3,514,9,11683,5049,6634,4.5,10.4,14394,2765,11629,2.5,12.8,-2711,-2.4,20.8,0,316,316,1660
2012,12100,4903,5704,114233,112525,562,9.9,525,9.2,15146,3835,11311,3.4,13.5,11730,3651,8079,3.2,10.4,3416,3.1,20.8,0,330,330,1928
2013,12100,4889,5703,112823,113364,522,9.2,515,9.1,12865,3798,9067,3.4,11.3,13946,3670,10276,3.2,12.3,-1081,-1,22.6,0,311,311,2378
2014,12100,4805,5588,110006,110978,513,9.1,578,10.3,11143,4782,6361,4.3,10,13086,3521,9565,3.2,11.8,-1943,-1.8,20,0,369,393,2449
1977,12220,948,1032,16157,15323,211,21.2,137,13.8,3629,2267,1362,14.8,23.7,1960,896,1064,5.8,12.8,1669,10.9,25.6,0,99,99,664
1978,12220,968,1054,17376,16765,173,16.6,151,14.5,3226,1122,2104,6.7,19.2,2004,888,1116,5.3,12,1222,7.2,24,0,103,103,462
1979,12220,1019,1106,19254,18303,186,17.2,130,12,4002,1776,2226,9.7,21.9,2100,727,1373,4,11.5,1902,10.4,23,0,97,101,508
1980,12220,1014,1096,19384,19315,129,11.7,137,12.4,2830,748,2082,3.9,14.7,2692,935,1757,4.8,13.9,138,0.8,27.8,0,97,97,542
1981,12220,997,1074,19346,19261,137,12.7,136,12.6,2943,1253,1690,6.5,15.3,2773,1009,1764,5.2,14.4,170,0.9,28.8,0,87,88,517
1982,12220,960,1057,19981,19722,140,13.1,140,13.1,3194,1582,1612,8,16.2,2675,1055,1620,5.3,13.6,519,2.6,27.2,0,86,86,469
1983,12220,1017,1109,19197,19342,143,13.2,96,8.9,2265,1035,1230,5.4,11.7,2554,980,1574,5.1,13.2,-289,-1.5,23.4,0,54,54,417
1984,12220,1065,1154,20958,20103,166,14.7,123,10.9,4143,1037,3106,5.2,20.6,2433,824,1609,4.1,12.1,1710,8.5,24.2,0,78,78,501
1985,12220,1120,1208,21979,21501,173,14.6,122,10.3,4280,1431,2849,6.7,19.9,3324,1989,1335,9.3,15.5,956,4.4,31,0,65,65,289
1986,12220,1147,1235,21200,21596,184,15.1,157,12.9,3054,1255,1799,5.8,14.1,3845,1114,2731,5.2,17.8,-791,-3.7,28.2,0,117,118,621
1987,12220,1174,1269,23144,22630,191,15.2,157,12.5,3963,1258,2705,5.6,17.5,2934,1364,1570,6,13,1029,4.5,26,0,103,103,644
1988,12220,1199,1293,24177,23672,181,14.2,151,11.8,3958,1820,2138,7.7,16.7,2947,1089,1858,4.6,12.4,1011,4.3,24.8,0,89,89,613
1989,12220,1260,1364,24677,24353,171,12.9,93,7,3891,1049,2842,4.3,16,3242,1514,1728,6.2,13.3,649,2.7,26.6,0,70,70,1311
1990,12220,1284,1391,25822,25173,171,12.4,135,9.8,4026,1174,2852,4.7,16,2728,1083,1645,4.3,10.8,1298,5.2,21.6,0,95,95,589
1991,12220,1290,1415,24468,25185,183,13.1,158,11.3,3035,1625,1410,6.5,12.1,4468,1677,2791,6.7,17.7,-1433,-5.6,24.2,0,112,112,1064
1992,12220,1360,1489,25233,24877,197,13.5,120,8.3,3896,1517,2379,6.1,15.7,3184,785,2399,3.2,12.8,712,2.9,25.6,0,82,82,524
1993,12220,1389,1529,25552,25370,197,13.1,152,10.1,4014,1146,2868,4.5,15.8,3650,1231,2419,4.9,14.4,364,1.4,28.8,0,99,99,512
1994,12220,1447,1591,26602,26068,220,14.1,149,9.6,4399,1892,2507,7.3,16.9,3330,1259,2071,4.8,12.8,1069,4.1,25.6,0,106,106,794
1995,12220,1481,1634,28373,27490,198,12.3,151,9.4,5195,2579,2616,9.4,18.9,3429,1356,2073,4.9,12.5,1766,6.4,25,0,111,111,1113
1996,12220,1532,1685,29738,29011,228,13.8,174,10.5,5141,2050,3091,7.1,17.7,3686,870,2816,3,12.7,1455,5,25.4,0,125,125,616
1997,12220,1597,1757,30073,29871,256,14.8,186,10.8,5253,1981,3272,6.6,17.6,4848,1336,3512,4.5,16.2,405,1.4,32.4,0,118,118,747
1998,12220,1612,1762,28602,29337,235,13.4,222,12.6,4628,2126,2502,7.2,15.8,6098,3241,2857,11,20.8,-1470,-5,31.6,0,154,154,1022
1999,12220,1614,1772,31249,30703,223,12.6,214,12.1,4814,1622,3192,5.3,15.7,3721,1371,2350,4.5,12.1,1093,3.6,24.2,0,142,142,740
2000,12220,1623,1787,32618,31934,215,12.1,198,11.1,6123,2269,3854,7.1,19.2,4754,1718,3036,5.4,14.9,1369,4.3,29.8,0,125,125,953
2001,12220,1660,1840,33261,33010,235,12.9,200,11,5339,1975,3364,6,16.2,4837,1336,3501,4,14.7,502,1.5,29.4,0,127,127,665
2002,12220,1652,1845,32427,32847,226,12.3,217,11.8,5364,2234,3130,6.8,16.3,6204,2075,4129,6.3,18.9,-840,-2.6,32.6,0,128,129,751
2003,12220,1705,1904,35122,33621,249,13.4,153,8.2,6545,2356,4189,7,19.5,3542,1071,2471,3.2,10.5,3003,9,21,0,113,113,691
2004,12220,1774,1983,36105,35407,264,13.6,153,7.9,5952,2310,3642,6.5,16.8,4555,1730,2825,4.9,12.9,1397,3.9,25.8,0,111,111,760
2005,12220,1834,2060,37205,36552,260,12.9,168,8.3,6082,2512,3570,6.9,16.6,4775,1419,3356,3.9,13.1,1307,3.5,26.2,0,122,122,1059
2006,12220,1859,2089,39100,38115,247,11.9,199,9.6,6831,2232,4599,5.9,17.9,4861,1891,2970,5,12.8,1970,5.1,25.6,0,150,150,1606
2007,12220,1959,2202,40213,39473,308,14.4,194,9.1,7024,2406,4618,6.1,17.8,5543,1702,3841,4.3,14,1481,3.8,28,0,121,124,894
2008,12220,1986,2241,40325,40006,251,11.3,189,8.5,6121,2709,3412,6.8,15.3,5482,1506,3976,3.8,13.7,639,1.6,27.4,0,146,146,1128
2009,12220,1978,2235,38439,39340,212,9.5,209,9.4,4056,1971,2085,5,10.3,5858,1103,4755,2.8,14.9,-1802,-4.6,20.6,0,151,151,511
2010,12220,1932,2196,36605,37432,201,9.1,228,10.3,4612,1626,2986,4.3,12.3,6266,2919,3347,7.8,16.7,-1654,-4.4,24.6,0,170,170,1506
2011,12220,1916,2162,36888,36378,205,9.5,197,9.1,4628,1890,2738,5.2,12.7,3608,891,2717,2.4,9.9,1020,2.8,19.8,0,133,133,637
2012,12220,1959,2212,38840,37843,225,10.3,180,8.2,5452,2333,3119,6.2,14.4,3457,1077,2380,2.8,9.1,1995,5.3,18.2,0,122,122,595
2013,12220,2005,2266,39657,39156,236,10.6,178,8,5537,2247,3290,5.7,14.1,4535,1633,2902,4.2,11.6,1002,2.5,23.2,0,126,126,1141
2014,12220,2036,2323,40252,39929,236,10.3,169,7.4,4834,1699,3135,4.3,12.1,4187,1157,3030,2.9,10.5,647,1.6,21,0,136,136,884
1977,12260,4983,5741,92405,90018,967,17.2,699,12.5,14673,6455,8218,7.2,16.3,9899,4262,5637,4.7,11,4774,5.3,22,0,473,473,3021
1978,12260,5150,5957,98735,95588,891,15.2,682,11.7,17180,6238,10942,6.5,18,10886,5005,5881,5.2,11.4,6294,6.6,22.8,0,465,466,2130
1979,12260,5248,6129,102765,100691,892,14.8,684,11.3,15469,6392,9077,6.3,15.4,11321,4607,6714,4.6,11.2,4148,4.2,22.4,0,523,525,2706
1980,12260,5275,6148,104508,103615,783,12.8,748,12.2,14344,5493,8851,5.3,13.8,12557,4851,7706,4.7,12.1,1787,1.7,24.2,0,520,522,2774
1981,12260,5125,5986,104318,103842,777,12.8,879,14.5,15773,7522,8251,7.2,15.2,14821,5971,8850,5.8,14.3,952,0.9,28.6,0,528,528,3060
1982,12260,5169,6141,107752,105909,909,15,699,11.5,18680,7567,11113,7.1,17.6,14994,5054,9940,4.8,14.2,3686,3.4,28.4,0,393,393,2185
1983,12260,5243,6214,103280,105003,766,12.4,690,11.2,16114,6997,9117,6.7,15.3,19560,6428,13132,6.1,18.6,-3446,-3.3,30.6,0,408,409,2465
1984,12260,5595,6559,111345,107409,893,14,586,9.2,19710,7067,12643,6.6,18.4,11837,3916,7921,3.6,11,7873,7.4,22,0,295,295,1546
1985,12260,5842,6799,121236,116563,923,13.8,708,10.6,23941,9057,14884,7.8,20.5,14594,6421,8173,5.5,12.5,9347,8,25,0,418,419,2221
1986,12260,6184,7240,126718,125526,1162,16.6,690,9.8,20642,9231,11411,7.4,16.4,18257,6577,11680,5.2,14.5,2385,1.9,29,0,469,469,2980
1987,12260,6401,7580,138968,135612,1190,16,825,11.1,23008,9309,13699,6.9,17,16296,6509,9787,4.8,12,6712,5,24,0,537,542,3299
1988,12260,6419,7641,141902,140705,1054,13.9,935,12.3,21720,8917,12803,6.3,15.4,19326,7039,12287,5,13.7,2394,1.7,27.4,0,616,616,3040
1989,12260,6475,7754,145798,144060,934,12.1,838,10.9,21774,8841,12933,6.1,15.1,18298,6160,12138,4.3,12.7,3476,2.4,25.4,0,534,535,3110
1990,12260,6597,7903,148801,147205,1022,13.1,813,10.4,20943,7988,12955,5.4,14.2,17750,6541,11209,4.4,12.1,3193,2.1,24.2,0,531,532,3288
1991,12260,6727,8083,159566,153987,973,12.2,793,9.9,29580,14603,14977,9.5,19.2,18421,4877,13544,3.2,12,11159,7.2,24,0,499,510,2756
1992,12260,6851,8248,161282,160396,1002,12.3,799,9.8,21823,6769,15054,4.2,13.6,20051,5347,14704,3.3,12.5,1772,1.1,25,0,514,517,2855
1993,12260,6972,8351,162509,161803,906,10.9,761,9.2,20959,5802,15157,3.6,13,19547,8040,11507,5,12.1,1412,0.9,24.2,0,513,514,3233
1994,12260,7077,8433,163202,162784,991,11.8,895,10.7,20839,7748,13091,4.8,12.8,20002,7858,12144,4.8,12.3,837,0.5,24.6,0,542,564,4234
1995,12260,7192,8587,169788,166445,1042,12.2,858,10.1,23063,8068,14995,4.8,13.9,16376,5656,10720,3.4,9.8,6687,4.1,19.6,0,579,579,3161
1996,12260,7306,8728,167959,168824,1068,12.3,907,10.5,20979,8521,12458,5,12.4,22708,6302,16406,3.7,13.5,-1729,-1.1,24.8,0,604,604,3415
1997,12260,7400,8929,164889,166853,1130,12.8,968,10.9,24600,9445,15155,5.7,14.7,28528,8651,19877,5.2,17.1,-3928,-2.4,29.4,0,582,582,3246
1998,12260,7439,8985,168336,166586,1059,11.8,979,10.9,25470,9602,15868,5.8,15.3,21969,7505,14464,4.5,13.2,3501,2.1,26.4,0,593,593,3119
1999,12260,7542,9100,168630,166846,1011,11.2,891,9.9,23022,8590,14432,5.1,13.8,19454,6624,12830,4,11.7,3568,2.1,23.4,0,539,539,3017
2000,12260,7463,9022,174669,171692,935,10.3,1006,11.1,25872,10097,15775,5.9,15.1,19918,7353,12565,4.3,11.6,5954,3.5,23.2,0,598,598,3656
2001,12260,7535,9095,177514,176497,921,10.2,934,10.3,25175,10277,14898,5.8,14.3,23141,7939,15202,4.5,13.1,2034,1.2,26.2,0,496,496,3705
2002,12260,7571,9185,180892,181645,1128,12.3,1038,11.4,24814,11345,13469,6.2,13.7,26319,8829,17490,4.9,14.5,-1505,-0.8,27.4,0,557,558,3860
2003,12260,7675,9295,175944,175068,975,10.6,690,7.5,22199,7438,14761,4.2,12.7,20447,4628,15819,2.6,11.7,1752,1,23.4,0,478,478,2796
2004,12260,7765,9371,176560,175071,997,10.7,802,8.6,23476,7984,15492,4.6,13.4,20497,6684,13813,3.8,11.7,2979,1.7,23.4,0,531,531,2727
2005,12260,7883,9589,175486,175328,1108,11.7,819,8.7,20455,7186,13269,4.1,11.7,20139,6079,14060,3.5,11.5,316,0.2,23,0,571,571,4338
2006,12260,7973,9739,177738,176197,1075,11.1,854,8.9,24266,10455,13811,5.9,13.8,21183,6165,15018,3.5,12,3083,1.8,24,0,583,583,2691
2007,12260,8101,9937,179362,178244,1129,11.5,897,9.1,25132,9328,15804,5.2,14.1,22895,7928,14967,4.4,12.8,2237,1.3,25.6,0,552,562,3625
2008,12260,8062,9942,182143,179739,966,9.8,871,8.8,27541,10098,17443,5.6,15.3,22733,6143,16590,3.4,12.6,4808,2.7,25.2,0,631,631,3915
2009,12260,7789,9625,170476,175865,750,7.7,977,10,23897,13480,10417,7.7,13.6,34675,6651,28024,3.8,19.7,-10778,-6.1,27.2,0,676,680,3292
2010,12260,7602,9482,166013,167916,760,8,859,9,16992,6326,10666,3.8,10.1,20797,5051,15746,3,12.4,-3805,-2.3,20.2,0,568,568,2650
2011,12260,7488,9425,172822,169165,793,8.4,766,8.1,23205,9824,13381,5.8,13.7,15890,4165,11725,2.5,9.4,7315,4.3,18.8,0,513,513,2687
2012,12260,7503,9440,172856,172753,817,8.7,826,8.8,21508,6297,15211,3.6,12.5,21301,5826,15475,3.4,12.3,207,0.2,24.6,0,500,502,2880
2013,12260,7465,9357,176242,174091,694,7.4,751,8,22480,6715,15765,3.9,12.9,18177,4890,13287,2.8,10.4,4303,2.5,20.8,0,502,506,3085
2014,12260,7411,9333,179610,176797,767,8.2,714,7.7,22533,7859,14674,4.4,12.7,16907,4421,12486,2.5,9.6,5626,3.1,19.2,0,497,497,2412
1977,12420,9553,10929,150364,139381,2205,20.9,1482,14,45517,24235,21282,17.4,32.7,23551,10840,12711,7.8,16.9,21966,15.8,33.8,0,1059,1068,7146
1978,12420,9230,10638,145754,147622,1776,16.5,1904,17.7,36140,13017,23123,8.8,24.5,39875,18455,21420,12.5,27,-3735,-2.5,49,0,1151,1153,13537
1979,12420,10459,11961,169773,158146,2178,19.3,961,8.5,45638,19489,26149,12.3,28.9,22383,7659,14724,4.8,14.2,23255,14.7,28.4,0,18,23,189
1980,12420,7657,9241,159705,160414,603,5.7,1997,18.8,30019,8272,21747,5.2,18.7,31436,14313,17123,8.9,19.6,-1417,-0.9,37.4,0,1576,1589,9708
1981,12420,11017,12631,184889,176940,2720,24.9,1180,10.8,41413,21270,20143,12,23.4,25514,10006,15508,5.7,14.4,15899,9,28.8,0,607,613,3771
1982,12420,11975,13993,206196,195658,2935,22,1498,11.2,51993,26281,25712,13.4,26.6,30916,10515,20401,5.4,15.8,21077,10.8,31.6,0,929,929,5812
1983,12420,12959,14996,216239,210100,2628,18.1,1700,11.7,52877,24301,28576,11.6,25.2,40598,14615,25983,7,19.3,12279,5.9,38.6,0,1161,1168,6605
1984,12420,14101,16266,244624,230777,3223,20.6,1953,12.5,63220,28157,35063,12.2,27.4,35525,13555,21970,5.9,15.4,27695,12,30.8,0,1331,1332,7801
1985,12420,15369,17657,277072,261845,3427,20.2,2025,11.9,70171,26153,44018,10,26.8,39716,15535,24181,5.9,15.2,30455,11.6,30.4,0,1411,1415,9020
1986,12420,15969,18404,283076,279603,3333,18.5,2477,13.7,63620,28407,35213,10.2,22.8,56673,22048,34625,7.9,20.3,6947,2.5,40.6,0,1771,1774,14806
1987,12420,15587,18303,270103,278096,3195,17.4,3152,17.2,51957,27280,24677,9.8,18.7,67942,27538,40404,9.9,24.4,-15985,-5.7,37.4,0,2187,2196,16343
1988,12420,14916,17811,266994,267527,2695,14.9,3052,16.9,54118,22643,31475,8.5,20.2,55184,24251,30933,9.1,20.6,-1066,-0.4,40.4,0,2220,2220,14230
1989,12420,14811,17666,274480,271557,2622,14.8,2753,15.5,56328,24322,32006,9,20.7,50482,22554,27928,8.3,18.6,5846,2.1,37.2,0,1806,1842,14270
1990,12420,15130,18115,284399,278865,2762,15.4,2191,12.3,58392,25817,32575,9.3,20.9,47324,20184,27140,7.2,17,11068,3.9,34,0,1517,1533,10481
1991,12420,15835,19068,302354,293406,3033,16.3,2098,11.3,62984,26923,36061,9.2,21.5,45088,17261,27827,5.9,15.4,17896,6.1,30.8,0,1315,1325,9807
1992,12420,16574,19978,320789,311751,3151,16.1,2188,11.2,65095,27231,37864,8.7,20.9,47018,17880,29138,5.7,15.1,18077,5.8,30.2,0,1376,1402,10235
1993,12420,17584,20948,341022,330741,3109,15.2,2098,10.3,67309,23829,43480,7.2,20.4,46749,17470,29279,5.3,14.1,20560,6.3,28.2,0,1329,1344,9570
1994,12420,18696,22191,364661,352600,3426,15.9,2130,9.9,71430,24446,46984,6.9,20.3,47308,16489,30819,4.7,13.4,24122,6.9,26.8,0,1443,1446,8115
1995,12420,19688,23264,398975,381409,3584,15.8,2375,10.5,84839,33933,50906,8.9,22.2,49706,18582,31124,4.9,13,35133,9.2,26,0,1564,1571,9654
1996,12420,20690,24463,421425,410276,3836,16.1,2557,10.7,83301,32785,50516,8,20.3,61003,20089,40914,4.9,14.9,22298,5.4,29.8,0,1708,1710,10680
1997,12420,21334,25434,447813,434908,3986,16,3011,12.1,95827,41119,54708,9.5,22,70016,27988,42028,6.4,16.1,25811,5.9,32.2,0,1912,1912,13343
1998,12420,21884,26242,475083,461136,3808,14.7,2909,11.3,99036,33801,65235,7.3,21.5,71142,23531,47611,5.1,15.4,27894,6.1,30.8,0,1920,1920,11677
1999,12420,22188,26861,496316,486268,3861,14.5,3166,11.9,105303,42412,62891,8.7,21.7,85206,35285,49921,7.3,17.5,20097,4.2,35,0,2022,2022,17155
2000,12420,22747,27697,546207,520831,4086,15,3278,12,128931,48515,80416,9.3,24.8,78179,33483,44696,6.4,15,50752,9.8,30,0,1971,1971,14434
2001,12420,23497,28842,574829,561367,4279,15.1,3354,11.8,119330,54434,64896,9.7,21.3,92407,34864,57543,6.2,16.5,26923,4.8,33,0,1963,1963,15034
2002,12420,23841,29315,548463,562301,4387,15.1,3899,13.4,103933,44440,59493,7.9,18.5,131610,40666,90944,7.2,23.4,-27677,-4.9,37,0,2102,2105,14914
2003,12420,24378,29999,554734,546981,4392,14.9,3033,10.3,98364,38608,59756,7.1,18,82857,25538,57319,4.7,15.1,15507,2.9,30.2,0,2103,2111,14284
2004,12420,25054,30759,563388,556993,4282,14.1,3163,10.4,93514,36148,57366,6.5,16.8,80724,23577,57147,4.2,14.5,12790,2.3,29,0,2091,2104,13792
2005,12420,25937,31909,595903,577810,4443,14.2,2980,9.5,109954,48927,61027,8.5,19,73768,24505,49263,4.2,12.8,36186,6.2,25.6,0,1977,1983,14318
2006,12420,26818,33270,615243,600439,4907,15.1,3183,9.8,112932,44737,68195,7.5,18.8,83324,32985,50339,5.5,13.9,29608,4.9,27.8,0,2124,2125,19039
2007,12420,27991,34999,653570,632585,5255,15.4,3372,9.9,132719,54273,78446,8.6,21,90749,29788,60961,4.7,14.3,41970,6.7,28.6,0,2120,2129,14706
2008,12420,28806,36016,667953,658289,4802,13.6,3391,9.6,116095,49191,66904,7.5,17.6,96766,27351,69415,4.2,14.7,19329,2.9,29.4,0,2353,2355,15586
2009,12420,28711,36019,647157,655488,4113,11.5,3740,10.4,91535,40858,50677,6.2,14,108197,26510,81687,4,16.5,-16662,-2.5,28,0,2526,2535,14351
2010,12420,29079,36575,640625,642196,4325,12,3484,9.6,96343,43284,53059,6.7,15,99485,30457,69028,4.7,15.5,-3142,-0.5,30,0,2323,2324,17161
2011,12420,29682,37405,649045,643648,4648,12.6,3530,9.6,99966,34496,65470,5.4,15.5,89171,28212,60959,4.4,13.9,10795,1.6,27.8,0,2380,2388,14868
2012,12420,30834,38720,677853,662652,5047,13.3,3690,9.7,110778,39696,71082,6,16.7,80375,30253,50122,4.6,12.1,30403,4.6,24.2,0,2252,2268,15558
2013,12420,31963,40155,707713,690784,5013,12.8,3537,9,118110,48373,69737,7,17.1,84252,30705,53547,4.4,12.2,33858,4.9,24.4,0,2308,2316,17206
2014,12420,33183,41535,723386,713304,5318,13.1,3616,8.9,119011,44282,74729,6.2,16.7,98847,43451,55396,6.1,13.9,20164,2.8,27.8,0,2451,2461,24648
1977,12540,6014,6800,82516,78814,1285,19.3,989,14.9,21367,9490,11877,12,27.1,13963,6718,7245,8.5,17.7,7404,9.4,35.4,0,656,657,4182
1978,12540,6182,6982,87598,85001,1275,18.5,1072,15.6,20858,7619,13239,9,24.5,15663,7095,8568,8.3,18.4,5195,6.1,36.8,0,700,701,4017
1979,12540,6473,7298,92990,90201,1329,18.6,965,13.5,20724,7473,13251,8.3,23,15145,6264,8881,6.9,16.8,5579,6.2,33.6,0,654,656,3653
1980,12540,6810,7680,99295,96067,1366,18.2,946,12.6,24097,11147,12950,11.6,25.1,17641,6937,10704,7.2,18.4,6456,6.7,36.8,0,686,686,3911
1981,12540,6708,7573,101384,99062,1260,16.6,1252,16.5,22875,10420,12455,10.5,23.1,18230,7968,10262,8,18.4,4645,4.7,36.8,0,762,763,4607
1982,12540,7012,8004,110188,105582,1502,19.3,961,12.3,27933,14260,13673,13.5,26.5,18721,6767,11954,6.4,17.7,9212,8.8,35.4,0,541,541,3117
1983,12540,7217,8209,103446,105427,1251,15.5,1060,13.1,22292,9891,12401,9.4,21.1,26253,7751,18502,7.4,24.9,-3961,-3.8,42.2,0,702,703,4504
1984,12540,7496,8518,111575,107563,1315,15.7,998,11.9,26898,10561,16337,9.8,25,18874,7186,11688,6.7,17.5,8024,7.5,35,0,668,671,4864
1985,12540,7823,8826,117700,115779,1321,15.2,1028,11.8,26267,10080,16187,8.7,22.7,22425,8881,13544,7.7,19.4,3842,3.3,38.8,0,631,632,4068
1986,12540,7951,8963,123400,120466,1350,15.2,1164,13.1,27779,12259,15520,10.2,23.1,21911,8479,13432,7,18.2,5868,4.9,36.4,0,750,750,4057
1987,12540,7984,9060,119518,121873,1488,16.5,1322,14.7,25277,12555,12722,10.3,20.7,29987,12266,17721,10.1,24.6,-4710,-3.9,41.4,0,842,845,4547
1988,12540,7969,9108,121707,118411,1315,14.5,1209,13.3,28591,10955,17636,9.3,24.1,21998,9870,12128,8.3,18.6,6593,5.5,37.2,0,799,799,3658
1989,12540,8033,9277,127417,124920,1257,13.7,1104,12,26652,10179,16473,8.1,21.3,21658,8515,13143,6.8,17.3,4994,4,34.6,0,745,745,5029
1990,12540,8249,9529,132889,129938,1273,13.5,952,10.1,26037,10323,15714,7.9,20,20135,6955,13180,5.4,15.5,5902,4.5,31,0,680,681,4406
1991,12540,8479,9834,138732,136064,1360,14.1,1067,11,29615,12543,17072,9.2,21.8,24279,7803,16476,5.7,17.8,5336,4,35.6,0,662,670,3894
1992,12540,8347,9727,134682,135564,1237,12.6,1289,13.2,26759,11108,15651,8.2,19.7,28522,9378,19144,6.9,21,-1763,-1.3,39.4,0,834,855,5178
1993,12540,8175,9514,129263,131047,1020,10.6,1159,12.1,24293,8460,15833,6.5,18.5,27861,9130,18731,7,21.3,-3568,-2.8,37,0,756,763,4594
1994,12540,8114,9451,128218,127668,1100,11.6,1111,11.7,22919,9522,13397,7.5,18,21819,7393,14426,5.8,17.1,1100,0.9,34.2,0,719,721,4007
1995,12540,8046,9407,129702,129330,1060,11.2,1053,11.2,20693,6744,13949,5.2,16,19949,6914,13035,5.3,15.4,744,0.6,30.8,0,694,712,3969
1996,12540,8156,9504,135394,132567,1085,11.5,974,10.3,26806,13219,13587,10,20.2,21152,8854,12298,6.7,16,5654,4.2,32,0,593,593,3718
1997,12540,8098,9425,134550,135007,1095,11.6,1159,12.2,26330,9019,17311,6.7,19.5,27243,9771,17472,7.2,20.2,-913,-0.7,39,0,651,651,3175
1998,12540,8138,9489,138436,136142,1118,11.8,1043,11,25724,10455,15269,7.7,18.9,21136,8552,12584,6.3,15.5,4588,3.4,31,0,611,611,3826
1999,12540,8193,9580,145351,142055,1131,11.9,1030,10.8,28407,12767,15640,9,20,21814,9491,12323,6.7,15.4,6593,4.6,30.8,0,626,626,3761
2000,12540,8290,9723,150386,148600,1127,11.7,980,10.2,27073,12215,14858,8.2,18.2,23500,7986,15514,5.4,15.8,3573,2.4,31.6,0,568,568,3112
2001,12540,8373,9851,153612,152457,1149,11.7,1120,11.4,25550,10773,14777,7.1,16.8,23240,10122,13118,6.6,15.2,2310,1.6,30.4,0,631,631,4412
2002,12540,8521,10021,152885,152854,1412,14.2,1216,12.3,31066,14585,16481,9.5,20.3,31003,10013,20990,6.6,20.3,63,0,40.6,0,650,651,3862
2003,12540,8585,10133,157976,153671,1316,13.1,975,9.7,29369,12974,16395,8.4,19.1,20758,6946,13812,4.5,13.5,8611,5.6,27,0,667,676,4478
2004,12540,8679,10234,164623,160358,1261,12.4,1041,10.2,30886,10936,19950,6.8,19.3,22355,8703,13652,5.4,13.9,8531,5.4,27.8,0,672,684,3813
2005,12540,8973,10579,169739,166351,1383,13.3,937,9,29501,11288,18213,6.8,17.7,22724,9082,13642,5.5,13.7,6777,4,27.4,0,655,665,6030
2006,12540,9224,10900,180694,175033,1457,13.6,1064,9.9,31717,12486,19231,7.1,18.1,20394,7632,12762,4.4,11.7,11323,6.4,23.4,0,731,731,5306
2007,12540,9467,11207,186294,183540,1462,13.2,1110,10,34018,13504,20514,7.4,18.5,28509,9629,18880,5.2,15.5,5509,3,31,0,715,724,4218
2008,12540,9403,11191,187804,186525,1278,11.5,1206,10.8,30075,11322,18753,6.1,16.1,27517,7988,19529,4.3,14.8,2558,1.3,29.6,0,877,877,4989
2009,12540,9157,10958,179193,182796,1146,10.4,1230,11.1,24103,9637,14466,5.3,13.2,31308,10337,20971,5.7,17.1,-7205,-3.9,26.4,0,907,908,6892
2010,12540,8966,10827,174988,176325,1048,9.7,1094,10.1,22584,10119,12465,5.7,12.8,25257,6816,18441,3.9,14.3,-2673,-1.5,25.6,0,786,786,4063
2011,12540,8955,10859,185888,181291,1020,9.4,935,8.6,30770,6528,24242,3.6,17,21575,5886,15689,3.2,11.9,9195,5.1,23.8,0,638,638,3479
2012,12540,9165,11060,191163,188345,1178,10.8,983,9,31475,8131,23344,4.3,16.7,25839,12664,13175,6.7,13.7,5636,3,27.4,0,596,598,3256
2013,12540,9174,11105,202931,197846,1085,9.8,1059,9.6,30547,9837,20710,5,15.4,20376,6779,13597,3.4,10.3,10171,5.1,20.6,0,699,700,3790
2014,12540,9259,11229,194938,197826,1269,11.4,1073,9.6,25081,7795,17286,3.9,12.7,30857,11067,19790,5.6,15.6,-5776,-2.9,25.4,0,771,771,4811
1977,12580,30084,35493,631117,619111,5491,15.8,4122,11.8,111919,44194,67725,7.1,18.1,87908,33052,54856,5.3,14.2,24011,3.9,28.4,0,2643,2654,16454
1978,12580,30686,36172,653241,641875,4714,13.2,4053,11.3,109568,32741,76827,5.1,17.1,86836,32992,53844,5.1,13.5,22732,3.6,27,0,2700,2704,14900
1979,12580,31194,36918,679578,666043,4857,13.3,3920,10.7,112547,36592,75955,5.5,16.9,85477,32392,53085,4.9,12.8,27070,4.1,25.6,0,2744,2763,15318
1980,12580,31548,37267,725367,702232,4604,12.4,4144,11.2,143822,66657,77165,9.5,20.5,97551,30838,66713,4.4,13.9,46271,6.6,27.8,0,2798,2818,16516
1981,12580,30938,36494,687884,704948,4431,12,4995,13.5,107097,41155,65942,5.8,15.2,141224,41631,99593,5.9,20,-34127,-4.8,30.4,0,2846,2854,16193
1982,12580,31465,37727,702970,695122,5465,14.7,3947,10.6,124591,57509,67082,8.3,17.9,108895,31867,77028,4.6,15.7,15696,2.2,31.4,0,2161,2161,13216
1983,12580,32780,39081,703805,703722,4791,12.5,3721,9.7,109150,36986,72164,5.3,15.5,108983,35509,73474,5,15.5,167,0,31,0,2438,2456,15592
1984,12580,32719,39221,737739,718819,4834,12.3,4650,11.9,128630,44538,84092,6.2,17.9,90789,37636,53153,5.2,12.6,37841,5.3,25.2,0,2690,2703,15025
1985,12580,35107,41789,789672,763795,5860,14.5,3418,8.4,153888,59415,94473,7.8,20.1,102133,39272,62861,5.1,13.4,51755,6.7,26.8,0,1226,1232,12280
1986,12580,37010,43901,830621,809124,6557,15.3,4376,10.2,169830,68618,101212,8.5,21,126836,48649,78187,6,15.7,42994,5.3,31.4,0,2702,2777,20042
1987,12580,38552,46195,885991,860452,7328,16.2,4954,11,189868,95121,94747,11.1,22.1,138789,48984,89805,5.7,16.1,51079,6,32.2,0,3158,3191,24366
1988,12580,39369,47263,897918,890238,6571,14.1,5383,11.5,169366,64927,104439,7.3,19,154006,49246,104760,5.5,17.3,15360,1.7,34.6,0,3483,3483,23856
1989,12580,40347,48640,912672,906275,6467,13.5,5116,10.7,152165,58368,93797,6.4,16.8,139371,46697,92674,5.2,15.4,12794,1.4,30.8,0,3354,3361,23436
1990,12580,41176,49660,932741,922242,6095,12.4,4865,9.9,153405,54639,98766,5.9,16.6,132407,47004,85403,5.1,14.4,20998,2.2,28.8,0,3176,3194,23815
1991,12580,41448,50306,897557,915476,6125,12.3,5495,11,133448,58175,75273,6.4,14.6,169287,58254,111033,6.4,18.5,-35839,-3.9,29.2,0,3351,3380,27354
1992,12580,41822,50930,883866,890520,6334,12.5,5568,11,144122,51598,92524,5.8,16.2,157430,49498,107932,5.6,17.7,-13308,-1.5,32.4,0,3277,3360,22573
1993,12580,42468,51333,882673,882677,5847,11.4,5306,10.4,137368,49940,87428,5.7,15.6,137376,46265,91111,5.2,15.6,-8,0,31.2,0,3285,3319,24671
1994,12580,43102,52115,897015,889277,6145,11.9,5234,10.1,148130,56015,92115,6.3,16.7,132654,46310,86344,5.2,14.9,15476,1.8,29.8,0,3261,3295,21048
1995,12580,43974,53186,932131,914011,6456,12.3,5222,9.9,152610,55034,97576,6,16.7,116370,43155,73215,4.7,12.7,36240,4,25.4,0,3384,3406,22312
1996,12580,44253,53509,930719,931473,6150,11.5,5705,10.7,140649,54005,86644,5.8,15.1,142156,51634,90522,5.5,15.3,-1507,-0.2,30.2,0,3573,3577,22447
1997,12580,44700,54193,958967,944686,6811,12.6,6158,11.4,175189,67507,107682,7.1,18.5,146626,56526,90100,6,15.5,28563,3,31,0,3571,3571,21261
1998,12580,44874,54513,982943,974716,6422,11.8,5976,11,158952,63714,95238,6.5,16.3,142498,57245,85253,5.9,14.6,16454,1.7,29.2,0,3741,3741,27096
1999,12580,44962,54639,997913,991022,5970,10.9,5755,10.5,164985,63829,101156,6.4,16.6,151205,61175,90030,6.2,15.3,13780,1.3,30.6,0,3495,3495,28778
2000,12580,44965,54943,1027140,1011271,6039,11,5723,10.4,175568,61082,114486,6,17.4,143830,53905,89925,5.3,14.2,31738,3.2,28.4,0,3433,3433,21419
2001,12580,45465,55674,1052825,1041949,6315,11.4,5980,10.8,167684,65686,101998,6.3,16.1,145931,56488,89443,5.4,14,21753,2.1,28,0,3242,3245,25403
2002,12580,46017,56277,1038849,1043393,6988,12.5,6328,11.3,168114,70967,97147,6.8,16.1,177202,59893,117309,5.7,17,-9088,-0.9,32.2,0,3132,3133,22367
2003,12580,46832,57240,1059419,1043206,6637,11.8,4734,8.4,166692,61304,105388,5.9,16,134265,36318,97947,3.5,12.9,32427,3.1,25.8,0,3116,3116,18737
2004,12580,47778,58301,1081510,1067766,6574,11.4,5035,8.7,163654,54753,108901,5.1,15.3,136167,49768,86399,4.7,12.8,27487,2.5,25.6,0,3180,3183,27257
2005,12580,48718,59456,1087596,1082059,6894,11.7,5224,8.9,153510,60255,93255,5.6,14.2,142436,48279,94157,4.5,13.2,11074,1,26.4,0,3315,3321,23597
2006,12580,49446,60629,1124669,1104103,7176,12,5476,9.1,172035,63655,108380,5.8,15.6,130905,43888,87017,4,11.9,41130,3.7,23.8,0,3639,3642,22536
2007,12580,49830,61265,1125199,1123038,6813,11.2,6001,9.9,166821,58093,108728,5.2,14.9,162499,52672,109827,4.7,14.5,4322,0.4,29,0,3616,3653,23064
2008,12580,49166,60822,1125321,1121746,6010,9.9,5858,9.6,158559,56806,101753,5.1,14.1,151408,52839,98569,4.7,13.5,7151,0.6,27,0,4011,4015,26534
2009,12580,47327,59044,1077004,1098377,5108,8.5,6248,10.5,119753,42055,77698,3.8,10.9,162498,45156,117342,4.1,14.8,-42745,-3.9,21.8,0,3972,3991,22648
2010,12580,46568,58180,1060790,1069359,5203,8.9,5740,9.8,127109,42594,84515,4,11.9,144246,38971,105275,3.6,13.5,-17137,-1.6,23.8,0,3474,3487,21033
2011,12580,46101,57839,1067273,1061651,5211,9,5133,8.9,131446,45544,85902,4.3,12.4,120202,33299,86903,3.1,11.3,11244,1.1,22.6,0,3196,3199,17528
2012,12580,46918,58643,1093433,1078875,5695,9.8,4895,8.4,152897,48864,104033,4.5,14.2,123781,42861,80920,4,11.5,29116,2.7,23,0,2826,2852,16126
2013,12580,47175,59118,1118393,1104515,5375,9.2,4945,8.4,145311,50918,94393,4.6,13.2,117554,36445,81109,3.3,10.6,27757,2.6,21.2,0,2929,2947,19836
2014,12580,47165,59354,1133054,1119948,5609,9.5,4953,8.4,142658,39622,103036,3.5,12.7,116446,35167,81279,3.1,10.4,26212,2.3,20.8,0,3277,3289,20423
1977,12620,2265,2476,45149,46324,363,14.9,290,11.9,5251,1948,3303,4.2,11.3,7600,1621,5979,3.5,16.4,-2349,-5.1,22.6,0,187,188,838
1978,12620,2355,2575,44208,40867,372,14.7,269,10.7,10715,1550,9165,3.8,26.2,4032,1659,2373,4.1,9.9,6683,16.3,19.8,0,191,192,966
1979,12620,2432,2671,42542,43348,400,15.3,285,10.9,7297,3141,4156,7.2,16.8,8908,1497,7411,3.5,20.5,-1611,-3.7,33.6,0,203,203,774
1980,12620,2383,2637,42994,42588,295,11.1,299,11.3,5931,1910,4021,4.5,13.9,5119,1975,3144,4.6,12,812,1.9,24,0,205,205,900
1981,12620,2255,2505,41178,41412,258,10.1,357,13.9,5614,1479,4135,3.6,13.6,6081,2260,3821,5.5,14.7,-467,-1.1,27.2,0,214,214,827
1982,12620,2256,2538,41267,41187,346,13.7,276,10.9,5953,3122,2831,7.6,14.5,5793,1407,4386,3.4,14.1,160,0.4,28.2,0,168,170,835
1983,12620,2348,2633,42905,42175,310,12,237,9.2,6092,2746,3346,6.5,14.4,4631,1543,3088,3.7,11,1461,3.4,22,0,160,160,676
1984,12620,2421,2704,44396,43506,358,13.4,283,10.6,6206,2566,3640,5.9,14.3,4426,1669,2757,3.8,10.2,1780,4.1,20.4,0,190,192,936
1985,12620,2538,2833,45607,45090,381,13.7,266,9.6,8832,5305,3527,11.8,19.6,7798,4491,3307,10,17.3,1034,2.3,34.6,0,182,182,1211
1986,12620,2656,2947,46132,45837,416,14.4,287,9.9,7283,2421,4862,5.3,15.9,6693,2458,4235,5.4,14.6,590,1.3,29.2,0,167,168,831
1987,12620,2815,3147,48710,47714,537,17.6,334,10.9,8469,3695,4774,7.7,17.7,6476,2696,3780,5.7,13.6,1993,4.1,27.2,0,202,202,1067
1988,12620,2864,3227,50385,49410,467,14.7,344,10.8,8325,2581,5744,5.2,16.8,6374,2426,3948,4.9,12.9,1951,3.9,25.8,0,241,241,1743
1989,12620,2975,3374,53295,52060,451,13.7,322,9.8,8893,2998,5895,5.8,17.1,6422,2603,3819,5,12.3,2471,4.8,24.6,0,210,211,1050
1990,12620,2975,3366,51379,52067,386,11.5,370,11,6257,2435,3822,4.7,12,7632,2585,5047,5,14.7,-1375,-2.7,24,0,241,241,1190
1991,12620,2940,3343,48957,50361,367,11,386,11.5,5469,2270,3199,4.5,10.9,8277,2388,5889,4.7,16.4,-2808,-5.5,21.8,0,243,244,1452
1992,12620,2952,3348,47885,48390,392,11.7,360,10.7,5876,2009,3867,4.2,12.1,6885,2153,4732,4.4,14.2,-1009,-2.1,24.2,0,220,225,1139
1993,12620,2988,3385,50243,48991,365,10.8,320,9.5,7901,3033,4868,6.2,16.1,5397,1878,3519,3.8,11,2504,5.1,22,0,198,203,886
1994,12620,3040,3439,51374,50800,394,11.5,334,9.8,7156,2493,4663,4.9,14.1,6007,1826,4181,3.6,11.8,1149,2.3,23.6,0,228,228,1160
1995,12620,3045,3450,51611,51467,385,11.2,353,10.2,6848,2339,4509,4.5,13.3,6560,2289,4271,4.4,12.7,288,0.6,25.4,0,237,237,1291
1996,12620,3091,3508,51912,51708,432,12.4,361,10.4,6552,2555,3997,4.9,12.7,6143,1880,4263,3.6,11.9,409,0.8,23.8,0,257,257,1169
1997,12620,3075,3518,51266,51491,412,11.7,386,11,6373,2443,3930,4.7,12.4,6823,2606,4217,5.1,13.3,-450,-0.9,24.8,0,233,233,980
1998,12620,3135,3584,53696,52504,416,11.7,342,9.6,7790,2913,4877,5.5,14.8,5405,1971,3434,3.8,10.3,2385,4.5,20.6,0,229,229,1279
1999,12620,3210,3655,55400,54689,412,11.4,341,9.4,8436,2905,5531,5.3,15.4,7014,2469,4545,4.5,12.8,1422,2.6,25.6,0,205,205,1082
2000,12620,3214,3668,55875,55622,360,9.8,351,9.6,7153,2306,4847,4.1,12.9,6647,2833,3814,5.1,12,506,0.9,24,0,218,218,1222
2001,12620,3287,3762,58299,57185,438,11.8,370,9.9,8626,3245,5381,5.7,15.1,6398,2080,4318,3.6,11.2,2228,3.9,22.4,0,231,231,1086
2002,12620,3270,3733,56918,57615,408,10.9,438,11.7,7853,3180,4673,5.5,13.6,9247,3316,5931,5.8,16,-1394,-2.4,27.2,0,235,235,1407
2003,12620,3291,3774,57446,56911,391,10.5,289,7.7,8284,3265,5019,5.7,14.6,7214,1897,5317,3.3,12.7,1070,1.9,25.4,0,180,180,1023
2004,12620,3284,3766,55449,55898,361,9.6,332,8.8,6433,1860,4573,3.3,11.5,7331,2118,5213,3.8,13.1,-898,-1.6,23,0,230,232,1512
2005,12620,3327,3824,57997,56627,400,10.6,313,8.3,8065,2900,5165,5.1,14.2,5324,1788,3536,3.2,9.4,2741,4.8,18.8,0,204,204,926
2006,12620,3316,3840,59586,58490,424,11.1,361,9.4,8709,4517,4192,7.7,14.9,6516,2527,3989,4.3,11.1,2193,3.8,22.2,0,259,259,1739
2007,12620,3332,3883,59604,59330,395,10.2,345,8.9,7933,3267,4666,5.5,13.4,7385,2799,4586,4.7,12.4,548,1,24.8,0,220,220,1732
2008,12620,3312,3884,60287,59721,378,9.8,333,8.6,7787,3026,4761,5.1,13,6654,1922,4732,3.2,11.1,1133,1.9,22.2,0,238,238,1400
2009,12620,3220,3791,59416,59705,281,7.3,364,9.5,7269,2662,4607,4.5,12.2,7847,2118,5729,3.5,13.1,-578,-0.9,24.4,0,230,230,1238
2010,12620,3207,3789,57381,58301,321,8.5,308,8.1,6317,2798,3519,4.8,10.8,8157,2250,5907,3.9,14,-1840,-3.2,21.6,0,195,195,1189
2011,12620,3111,3701,56422,56638,288,7.7,349,9.3,6244,2615,3629,4.6,11,6676,2675,4001,4.7,11.8,-432,-0.8,22,0,219,219,1466
2012,12620,3134,3704,57638,57018,322,8.7,304,8.2,7332,1945,5387,3.4,12.9,6091,1905,4186,3.3,10.7,1241,2.2,21.4,0,177,177,1118
2013,12620,3129,3692,57288,57269,281,7.6,282,7.7,5666,1589,4077,2.8,9.9,5628,1456,4172,2.5,9.8,38,0.1,19.6,0,172,172,908
2014,12620,3140,3720,57836,57215,337,9.1,278,7.5,7597,3244,4353,5.7,13.3,6354,1729,4625,3,11.1,1243,2.2,22.2,0,179,179,861
1977,12700,3365,3680,30012,28921,636,17.6,489,13.5,7149,2851,4298,9.9,24.7,4966,2112,2854,7.3,17.2,2183,7.5,34.4,0,321,321,1423
1978,12700,3572,3896,33208,31622,632,16.7,417,11,7370,2989,4381,9.5,23.3,4197,1748,2449,5.5,13.3,3173,10,26.6,0,299,299,1157
1979,12700,3651,3986,35864,34360,569,14.4,445,11.3,8207,3404,4803,9.9,23.9,5198,2186,3012,6.4,15.1,3009,8.8,30.2,0,319,320,1364
1980,12700,3733,4076,37866,37021,535,13.3,426,10.6,7228,2383,4845,6.4,19.5,5537,1853,3684,5,15,1691,4.5,30,0,288,289,1163
1981,12700,3677,4028,37829,37435,519,12.8,513,12.7,7889,3357,4532,9,21.1,7101,3666,3435,9.8,19,788,2.1,38,0,304,305,1592
1982,12700,3879,4349,40828,39404,753,18,418,10,8640,4441,4199,11.3,21.9,5791,2041,3750,5.2,14.7,2849,7.2,29.4,0,236,236,1083
1983,12700,4009,4478,42408,41550,558,12.6,449,10.2,8758,3288,5470,7.9,21.1,7042,2653,4389,6.4,16.9,1716,4.2,33.8,0,287,288,1533
1984,12700,4224,4714,46772,44751,646,14.1,424,9.2,10330,3925,6405,8.8,23.1,6287,2172,4115,4.9,14,4043,9.1,28,0,272,273,1287
1985,12700,4550,5051,50791,48757,822,16.8,499,10.2,10943,4228,6715,8.7,22.4,6874,2914,3960,6,14.1,4069,8.3,28.2,0,329,330,1628
1986,12700,4823,5336,53938,52280,858,16.5,553,10.7,12299,5475,6824,10.5,23.5,8983,3558,5425,6.8,17.2,3316,6.3,34.4,0,351,351,2217
1987,12700,5163,5761,58629,56215,1071,19.3,607,10.9,15816,8030,7786,14.3,28.1,10988,4613,6375,8.2,19.5,4828,8.6,39,0,397,397,2567
1988,12700,5378,6014,62111,60374,919,15.6,668,11.3,14842,6394,8448,10.6,24.6,11368,4887,6481,8.1,18.8,3474,5.8,37.6,0,457,457,2740
1989,12700,5320,6018,62417,62295,790,13.1,782,13,12019,5146,6873,8.3,19.3,11774,4574,7200,7.3,18.9,245,0.4,37.8,0,568,572,3285
1990,12700,5139,5844,59538,60841,671,11.3,758,12.8,10141,4123,6018,6.8,16.7,12747,4236,8511,7,21,-2606,-4.3,33.4,0,501,502,2576
1991,12700,4991,5726,54717,56882,646,11.2,745,12.9,8944,4454,4490,7.8,15.7,13273,4892,8381,8.6,23.3,-4329,-7.6,31.4,0,446,446,2878
1992,12700,4936,5667,55356,55021,626,11,658,11.5,10172,3500,6672,6.4,18.5,9502,3407,6095,6.2,17.3,670,1.2,34.6,0,396,400,1736
1993,12700,5023,5743,57444,56157,629,11,535,9.4,10355,3431,6924,6.1,18.4,7781,2902,4879,5.2,13.9,2574,4.5,27.8,0,367,369,1705
1994,12700,5104,5808,57082,57300,638,11,550,9.5,9193,3318,5875,5.8,16,9628,3533,6095,6.2,16.8,-435,-0.8,32,0,345,348,1904
1995,12700,5268,5990,60006,58522,725,12.3,538,9.1,10647,4346,6301,7.4,18.2,7678,2673,5005,4.6,13.1,2969,5.1,26.2,0,354,355,1611
1996,12700,5420,6163,60821,60418,696,11.5,506,8.3,8863,3106,5757,5.1,14.7,8057,2783,5274,4.6,13.3,806,1.4,26.6,0,324,324,1719
1997,12700,5607,6384,63754,62349,745,11.9,540,8.6,11993,4433,7560,7.1,19.2,9182,4280,4902,6.9,14.7,2811,4.5,29.4,0,337,337,1940
1998,12700,5696,6442,65689,64675,670,10.4,590,9.2,11423,4253,7170,6.6,17.7,9395,3292,6103,5.1,14.5,2028,3.2,29,0,366,366,1657
1999,12700,5818,6570,68458,67105,702,10.8,562,8.6,11252,4147,7105,6.2,16.8,8545,3635,4910,5.4,12.7,2707,4.1,25.4,0,366,366,1750
2000,12700,5959,6698,71463,69972,746,11.2,628,9.5,12552,4639,7913,6.6,17.9,9569,4925,4644,7,13.7,2983,4.2,27.4,0,381,381,1881
2001,12700,6105,6888,73137,72756,735,10.7,668,9.8,12236,4742,7494,6.5,16.8,11473,5475,5998,7.5,15.8,763,1,31.6,0,388,388,2160
2002,12700,6103,6936,74136,73578,845,12.2,778,11.3,14179,5680,8499,7.7,19.3,13062,4707,8355,6.4,17.8,1117,1.5,35.6,0,389,389,1718
2003,12700,6218,7044,74937,74263,823,11.8,624,9,11855,4165,7690,5.6,16,10507,3615,6892,4.9,14.1,1348,1.9,28.2,0,353,354,2035
2004,12700,6144,7000,76679,75742,772,11,769,11,11496,4476,7020,5.9,15.2,9622,3492,6130,4.6,12.7,1874,2.5,25.4,0,513,514,2123
2005,12700,6165,7061,75209,75719,829,11.8,699,10,10662,4978,5684,6.6,14.1,11682,4651,7031,6.1,15.4,-1020,-1.3,28.2,0,422,422,2476
2006,12700,6259,7169,75934,75401,825,11.6,689,9.7,10782,4684,6098,6.2,14.3,9715,3218,6497,4.3,12.9,1067,1.4,25.8,0,445,445,2169
2007,12700,6303,7214,75722,75701,810,11.3,757,10.5,11369,4543,6826,6,15,11327,4203,7124,5.6,15,42,0,30,0,433,441,2016
2008,12700,6216,7103,73792,74390,645,9,718,10.1,9072,2918,6154,3.9,12.2,10268,3330,6938,4.5,13.8,-1196,-1.6,24.4,0,438,438,1743
2009,12700,5923,6818,69935,71674,587,8.5,790,11.4,7756,2806,4950,3.9,10.8,11234,3761,7473,5.2,15.7,-3478,-4.9,21.6,0,469,470,2067
2010,12700,5804,6682,68739,69196,590,8.8,667,9.9,7884,2987,4897,4.3,11.4,8797,2136,6661,3.1,12.7,-913,-1.3,22.8,0,347,347,1149
2011,12700,5761,6641,68815,68506,611,9.2,605,9.1,8083,2357,5726,3.4,11.8,7464,2448,5016,3.6,10.9,619,0.9,21.8,0,349,349,1496
2012,12700,5844,6743,70866,69827,669,10,582,8.7,10451,3518,6933,5,15,8372,3201,5171,4.6,12,2079,3,24,0,310,314,1169
2013,12700,5891,6801,71151,70914,631,9.3,585,8.7,9105,3195,5910,4.5,12.8,8631,3185,5446,4.5,12.2,474,0.6,24.4,0,328,329,2044
2014,12700,5962,6870,71892,71427,624,9.2,523,7.7,8229,3075,5154,4.3,11.5,7298,2118,5180,3,10.2,931,1.3,20.4,0,325,325,1254
1977,12940,8130,9131,145167,138247,1701,19.3,1068,12.1,35425,13962,21463,10.1,25.6,21585,7863,13722,5.7,15.6,13840,10,31.2,0,762,763,4978
1978,12940,7867,8881,153701,149135,1295,14.4,1442,16,35184,11670,23514,7.8,23.6,26052,10182,15870,6.8,17.5,9132,6.1,35,0,852,855,5045
1979,12940,8728,9831,167485,160693,1639,17.5,746,8,36736,13108,23628,8.2,22.9,23152,6553,16599,4.1,14.4,13584,8.5,28.8,0,7,7,142
1980,12940,8999,10162,174023,170619,1486,14.9,1112,11.1,33717,11868,21849,7,19.8,26909,7200,19709,4.2,15.8,6808,4,31.6,0,786,787,4558
1981,12940,8930,10108,176085,173788,1471,14.5,1402,13.9,36008,14646,21362,8.4,20.7,31413,12555,18858,7.2,18.1,4595,2.6,36.2,0,928,934,7153
1982,12940,9382,10740,179934,177806,1861,17.8,1161,11.1,36435,15927,20508,9,20.5,32179,12344,19835,6.9,18.1,4256,2.4,36.2,0,645,650,5064
1983,12940,9778,11115,172376,175272,1567,14.3,1249,11.4,31567,12364,19203,7.1,18,37358,12272,25086,7,21.3,-5791,-3.3,36,0,853,861,5709
1984,12940,10144,11499,178703,175715,1691,15,1313,11.6,35586,13508,22078,7.7,20.3,29609,9967,19642,5.7,16.9,5977,3.4,33.8,0,858,859,5072
1985,12940,10442,11867,180950,181593,1740,14.9,1397,11.9,32757,13909,18848,7.7,18,34042,12552,21490,6.9,18.7,-1285,-0.7,36,0,960,963,6337
1986,12940,10497,11958,179187,179823,1736,14.6,1575,13.2,34566,14334,20232,8,19.2,35838,12466,23372,6.9,19.9,-1272,-0.7,38.4,0,1114,1114,6179
1987,12940,10108,11549,176098,177902,1654,14.1,1961,16.7,34200,14594,19606,8.2,19.2,37808,15834,21974,8.9,21.3,-3608,-2.1,38.4,0,1291,1297,8762
1988,12940,9810,11345,177172,175532,1465,12.8,1569,13.7,35360,13882,21478,7.9,20.1,32079,12300,19779,7,18.3,3281,1.8,36.6,0,1057,1057,5868
1989,12940,9784,11349,189102,183418,1305,11.5,1314,11.6,40284,13895,26389,7.6,22,28915,12750,16165,7,15.8,11369,6.2,31.6,0,882,883,7944
1990,12940,9884,11493,200874,194876,1391,12.2,1194,10.5,38429,14391,24038,7.4,19.7,26433,10076,16357,5.2,13.6,11996,6.1,27.2,0,819,820,5409
1991,12940,10244,11962,209576,205422,1568,13.4,1121,9.6,39380,13648,25732,6.6,19.2,31071,11148,19923,5.4,15.1,8309,4.1,30.2,0,707,707,5065
1992,12940,10542,12304,217014,213070,1587,13.1,1188,9.8,40841,13155,27686,6.2,19.2,32952,9801,23151,4.6,15.5,7889,3.7,31,0,793,808,5560
1993,12940,10842,12589,218177,217558,1440,11.6,1142,9.2,33897,9533,24364,4.4,15.6,32658,10754,21904,4.9,15,1239,0.6,30,0,788,788,6372
1994,12940,11146,12934,225966,221446,1625,12.7,1237,9.7,37277,13055,24222,5.9,16.8,28237,8812,19425,4,12.8,9040,4,25.6,0,851,853,5124
1995,12940,11475,13310,235428,230363,1644,12.5,1234,9.4,43075,16190,26885,7,18.7,32945,10243,22702,4.4,14.3,10130,4.4,28.6,0,835,835,4745
1996,12940,11797,13631,243697,239838,1611,12,1237,9.2,39615,14249,25366,5.9,16.5,31897,9581,22316,4,13.3,7718,3.2,26.6,0,855,855,5248
1997,12940,12014,14014,251017,247334,1746,12.6,1388,10,46267,16922,29345,6.8,18.7,38900,14054,24846,5.7,15.7,7367,3,31.4,0,899,899,5868
1998,12940,12203,14321,263388,257774,1707,12,1361,9.6,47845,18691,29154,7.3,18.6,36617,12159,24458,4.7,14.2,11228,4.4,28.4,0,896,896,6788
1999,12940,12239,14448,273154,269729,1588,11,1461,10.2,47430,18137,29293,6.7,17.6,40580,15847,24733,5.9,15,6850,2.6,30,0,986,986,8946
2000,12940,12144,14422,281620,277944,1582,11,1630,11.3,49527,17876,31651,6.4,17.8,42174,17571,24603,6.3,15.2,7353,2.6,30.4,0,967,967,10302
2001,12940,12259,14575,281088,281810,1614,11.1,1597,11,45189,16293,28896,5.8,16,46633,16723,29910,5.9,16.5,-1444,-0.5,32,0,893,893,8311
2002,12940,12449,14739,277450,278970,1823,12.4,1636,11.2,54466,24204,30262,8.7,19.5,57506,21790,35716,7.8,20.6,-3040,-1.1,39,0,874,876,10533
2003,12940,12608,14913,279547,277362,1729,11.7,1318,8.9,43444,14610,28834,5.3,15.7,39074,11008,28066,4,14.1,4370,1.6,28.2,0,938,941,6435
2004,12940,12663,14953,284552,281320,1559,10.5,1368,9.2,45023,11831,33192,4.2,16,38559,11694,26865,4.2,13.7,6464,2.3,27.4,0,928,929,5624
2005,12940,12788,15198,287770,285089,1709,11.4,1292,8.6,58228,17883,40345,6.3,20.4,52865,27347,25518,9.6,18.5,5363,1.9,37,0,933,934,12876
2006,12940,13082,15597,313552,300014,1951,12.7,1397,9.1,62627,23376,39251,7.8,20.9,35550,12771,22779,4.3,11.8,27077,9.1,23.6,0,927,927,7662
2007,12940,13533,16228,316521,314288,1920,12.1,1372,8.6,49364,16994,32370,5.4,15.7,44898,12302,32596,3.9,14.3,4466,1.4,28.6,0,903,905,6297
2008,12940,13697,16494,318480,316208,1765,10.8,1335,8.2,45880,15543,30337,4.9,14.5,41335,12828,28507,4.1,13.1,4545,1.4,26.2,0,995,995,8023
2009,12940,13496,16277,313673,315103,1439,8.8,1522,9.3,43791,15283,28508,4.9,13.9,46651,13452,33199,4.3,14.8,-2860,-0.9,27.8,0,1048,1048,5457
2010,12940,13421,16250,309815,311289,1408,8.7,1334,8.2,38371,11907,26464,3.8,12.3,41319,10134,31185,3.3,13.3,-2948,-1,24.6,0,916,918,6812
2011,12940,13297,16234,307309,308441,1506,9.3,1447,8.9,38263,13654,24609,4.4,12.4,40527,10968,29559,3.6,13.1,-2264,-0.7,24.8,0,1013,1013,6684
2012,12940,13400,16372,317352,312372,1556,9.6,1452,8.9,47194,13278,33916,4.3,15.1,37234,11522,25712,3.7,11.9,9960,3.2,23.8,0,901,904,6631
2013,12940,13326,16313,330392,323489,1340,8.2,1386,8.5,45127,10259,34868,3.2,14,31320,9807,21513,3,9.7,13807,4.3,19.4,0,906,907,5647
2014,12940,13348,16326,340883,334856,1450,8.9,1325,8.1,47187,12305,34882,3.7,14.1,35132,12352,22780,3.7,10.5,12055,3.6,21,0,903,912,5447
1977,12980,2150,2372,45071,44490,326,13.9,275,11.7,6545,2932,3613,6.6,14.7,5383,1809,3574,4.1,12.1,1162,2.6,24.2,0,167,167,956
1978,12980,2170,2379,47132,46089,271,11.4,258,10.9,6447,1545,4902,3.4,14,4360,1524,2836,3.3,9.5,2087,4.5,19,0,161,162,853
1979,12980,2148,2359,49241,48176,225,9.5,238,10,7186,1385,5801,2.9,14.9,5055,1466,3589,3,10.5,2131,4.4,21,0,158,158,839
1980,12980,2129,2344,45380,47289,222,9.4,228,9.7,4297,1511,2786,3.2,9.1,8115,1764,6351,3.7,17.2,-3818,-8.1,18.2,0,158,158,941
1981,12980,2036,2229,42486,43926,223,9.8,325,14.2,4370,1477,2893,3.4,9.9,7250,2507,4743,5.7,16.5,-2880,-6.6,19.8,0,182,182,912
1982,12980,2021,2241,41850,42211,284,12.7,246,11,5416,2507,2909,5.9,12.8,6138,2094,4044,5,14.5,-722,-1.7,25.6,0,137,137,588
1983,12980,2023,2250,39785,40822,197,8.8,207,9.2,3931,1675,2256,4.1,9.6,6005,1267,4738,3.1,14.7,-2074,-5.1,19.2,0,129,129,629
1984,12980,2120,2365,41550,40661,314,13.6,203,8.8,7187,2860,4327,7,17.7,5408,2389,3019,5.9,13.3,1779,4.4,26.6,0,132,132,937
1985,12980,2168,2420,41911,41734,285,11.9,233,9.7,5434,1911,3523,4.6,13,5080,1510,3570,3.6,12.2,354,0.8,24.4,0,157,157,676
1986,12980,2178,2441,44084,42977,257,10.6,233,9.6,6895,2200,4695,5.1,16,4680,1287,3393,3,10.9,2215,5.1,21.8,0,144,144,771
1987,12980,2254,2522,46846,45596,316,12.7,234,9.4,8587,2723,5864,6,18.8,6086,2405,3681,5.3,13.3,2501,5.5,26.6,0,134,134,974
1988,12980,2265,2537,49703,48846,263,10.4,240,9.5,8160,2805,5355,5.7,16.7,6446,2088,4358,4.3,13.2,1714,3.5,26.4,0,150,150,1016
1989,12980,2325,2599,51147,50623,271,10.6,216,8.4,7822,2422,5400,4.8,15.5,6773,3073,3700,6.1,13.4,1049,2.1,26.8,0,132,132,1339
1990,12980,2337,2607,54219,52682,260,10,247,9.5,9419,3629,5790,6.9,17.9,6345,2363,3982,4.5,12,3074,5.9,24,0,157,157,1066
1991,12980,2348,2617,51025,52627,284,10.9,271,10.4,5741,2193,3548,4.2,10.9,8944,3504,5440,6.7,17,-3203,-6.1,21.8,0,184,185,2674
1992,12980,2335,2612,50388,50643,233,8.9,229,8.7,6425,2238,4187,4.4,12.7,6934,2147,4787,4.2,13.7,-509,-1,25.4,0,129,129,982
1993,12980,2358,2643,52521,51433,240,9.1,206,7.8,7244,2898,4346,5.6,14.1,5068,1587,3481,3.1,9.9,2176,4.2,19.8,0,137,137,1015
1994,12980,2412,2699,54584,53535,260,9.7,197,7.4,6533,2000,4533,3.7,12.2,4435,1175,3260,2.2,8.3,2098,3.9,16.6,0,134,134,736
1995,12980,2459,2745,57730,56173,252,9.3,211,7.8,8595,2528,6067,4.5,15.3,5481,1701,3780,3,9.8,3114,5.5,19.6,0,133,135,739
1996,12980,2466,2764,58129,57955,256,9.3,234,8.5,7098,1976,5122,3.4,12.2,6749,1747,5002,3,11.6,349,0.6,23.2,0,159,159,1031
1997,12980,2491,2806,58020,58160,306,11,276,9.9,7948,2503,5445,4.3,13.7,8228,2763,5465,4.8,14.1,-280,-0.4,27.4,0,170,170,1105
1998,12980,2465,2798,59826,58945,262,9.4,259,9.2,8042,2000,6042,3.4,13.6,6279,2147,4132,3.6,10.7,1763,2.9,21.4,0,163,163,820
1999,12980,2448,2775,60514,60140,241,8.7,255,9.2,8394,2746,5648,4.6,14,7646,2212,5434,3.7,12.7,748,1.3,25.4,0,147,147,1339
2000,12980,2410,2744,60819,60680,240,8.7,273,9.9,7713,2432,5281,4,12.7,7435,2604,4831,4.3,12.3,278,0.4,24.6,0,177,177,1119
2001,12980,2412,2775,59012,60014,292,10.6,279,10.1,6205,3142,3063,5.2,10.3,8209,1934,6275,3.2,13.7,-2004,-3.4,20.6,0,158,158,1027
2002,12980,2406,2759,57062,58011,288,10.4,300,10.8,7975,3156,4819,5.4,13.7,9872,3565,6307,6.1,17,-1897,-3.3,27.4,0,131,131,1178
2003,12980,2388,2739,56863,56284,258,9.4,226,8.3,6818,1724,5094,3.1,12.1,5659,2021,3638,3.6,10.1,1159,2,20.2,0,159,159,1103
2004,12980,2317,2653,54630,55606,222,8.3,284,10.6,4963,1450,3513,2.6,8.9,6914,1886,5028,3.4,12.4,-1951,-3.5,17.8,0,161,161,832
2005,12980,2302,2648,52943,53660,249,9.4,224,8.5,5094,1677,3417,3.1,9.5,6527,914,5613,1.7,12.2,-1433,-2.7,19,0,117,117,400
2006,12980,2316,2675,53914,53249,246,9.3,198,7.5,6721,1615,5106,3,12.6,5390,1290,4100,2.4,10.1,1331,2.5,20.2,0,137,137,815
2007,12980,2293,2652,53617,53740,228,8.6,261,9.8,5838,2093,3745,3.9,10.9,6083,2061,4022,3.8,11.3,-245,-0.4,21.8,0,153,153,831
2008,12980,2230,2592,54089,53653,191,7.3,219,8.4,5978,1766,4212,3.3,11.1,5105,1695,3410,3.2,9.5,873,1.6,19,0,160,160,1089
2009,12980,2165,2506,49352,51515,170,6.7,236,9.3,4323,1676,2647,3.3,8.4,8648,1901,6747,3.7,16.8,-4325,-8.4,16.8,0,141,141,972
2010,12980,2107,2441,49028,49155,155,6.3,201,8.1,5836,975,4861,2,11.9,6089,1327,4762,2.7,12.4,-253,-0.5,23.8,0,125,125,576
2011,12980,2085,2417,48768,48811,179,7.4,182,7.5,4482,1018,3464,2.1,9.2,4567,1145,3422,2.3,9.4,-85,-0.2,18.4,0,107,107,529
2012,12980,2063,2396,49398,49064,198,8.2,212,8.8,5931,1215,4716,2.5,12.1,5262,1539,3723,3.1,10.7,669,1.4,21.4,0,107,107,590
2013,12980,2061,2388,52029,50666,163,6.8,186,7.8,6231,1448,4783,2.9,12.3,3504,1003,2501,2,6.9,2727,5.4,13.8,0,111,111,647
2014,12980,2030,2357,53147,52453,160,6.8,175,7.4,5300,1437,3863,2.7,10.1,3911,810,3101,1.5,7.5,1389,2.6,15,0,127,130,493
1977,13020,1729,1883,26468,25465,292,15.7,234,12.6,5578,1771,3807,7,21.9,3571,1295,2276,5.1,14,2007,7.9,28,0,141,142,703
1978,13020,1775,1940,28729,27571,248,13,195,10.2,4824,1454,3370,5.3,17.5,2508,949,1559,3.4,9.1,2316,8.4,18.2,0,135,136,552
1979,13020,1787,1967,28702,28708,227,11.6,191,9.8,4511,1919,2592,6.7,15.7,4523,2476,2047,8.6,15.8,-12,-0.1,31.4,0,140,140,1979
1980,13020,1746,1932,27035,27852,180,9.2,198,10.2,2941,1143,1798,4.1,10.6,4575,1108,3467,4,16.4,-1634,-5.8,21.2,0,126,126,583
1981,13020,1698,1865,27231,27081,179,9.4,236,12.4,5033,2440,2593,9,18.6,4733,1941,2792,7.2,17.5,300,1.1,35,0,132,132,771
1982,13020,1647,1855,26318,26721,205,11,192,10.3,3756,1742,2014,6.5,14.1,4561,784,3777,2.9,17.1,-805,-3,28.2,0,119,119,466
1983,13020,1670,1866,25250,25773,168,9,179,9.6,3098,1191,1907,4.6,12,4143,1009,3134,3.9,16.1,-1045,-4.1,24,0,110,110,636
1984,13020,1724,1910,26464,25890,231,12.2,197,10.4,4222,1778,2444,6.9,16.3,3073,1496,1577,5.8,11.9,1149,4.4,23.8,0,122,122,475
1985,13020,1751,1933,26193,26385,205,10.7,177,9.2,3391,1242,2149,4.7,12.9,3775,1689,2086,6.4,14.3,-384,-1.4,25.8,0,116,117,839
1986,13020,1781,1968,27519,26848,217,11.1,181,9.3,4206,1802,2404,6.7,15.7,2864,948,1916,3.5,10.7,1342,5,21.4,0,123,123,533
1987,13020,1843,2046,28264,27920,262,13,186,9.2,4426,1669,2757,6,15.9,3738,1065,2673,3.8,13.4,688,2.5,26.8,0,125,125,504
1988,13020,1818,2028,28001,27954,211,10.4,212,10.4,3878,1246,2632,4.5,13.9,3783,1140,2643,4.1,13.5,95,0.4,27,0,134,134,714
1989,13020,1837,2051,29239,28607,197,9.7,172,8.4,4809,1620,3189,5.7,16.8,3545,1580,1965,5.5,12.4,1264,4.4,24.8,0,111,111,789
1990,13020,1881,2098,30265,29714,205,9.9,146,7,4470,1468,3002,4.9,15,3367,889,2478,3,11.3,1103,3.7,22.6,0,95,95,418
1991,13020,1923,2143,30938,30568,224,10.6,178,8.4,4714,1843,2871,6,15.4,3973,1324,2649,4.3,13,741,2.4,26,0,112,112,607
1992,13020,1980,2190,30355,30647,222,10.2,168,7.7,3789,1273,2516,4.2,12.4,4373,1031,3342,3.4,14.3,-584,-1.9,24.8,0,92,92,351
1993,13020,2027,2244,31969,31154,208,9.4,149,6.7,4629,1227,3402,3.9,14.9,2999,760,2239,2.4,9.6,1630,5.3,19.2,0,91,91,446
1994,13020,2087,2308,32239,32120,220,9.7,158,6.9,4099,1307,2792,4.1,12.8,3861,819,3042,2.5,12,238,0.8,24,0,109,110,521
1995,13020,2092,2326,32977,32589,204,8.8,180,7.8,4464,1508,2956,4.6,13.7,3688,1246,2442,3.8,11.3,776,2.4,22.6,0,122,122,524
1996,13020,2113,2349,33852,33320,228,9.8,188,8,4387,1569,2818,4.7,13.2,3323,932,2391,2.8,10,1064,3.2,20,0,124,124,489
1997,13020,2137,2377,34730,34335,224,9.5,208,8.8,5275,2061,3214,6,15.4,4484,1387,3097,4,13.1,791,2.3,26.2,0,130,130,606
1998,13020,2115,2350,34854,34769,185,7.8,202,8.5,4382,1263,3119,3.6,12.6,4211,1235,2976,3.6,12.1,171,0.5,24.2,0,135,135,732
1999,13020,2132,2372,34429,34623,216,9.2,189,8,4179,1544,2635,4.5,12.1,4567,1392,3175,4,13.2,-388,-1.1,24.2,0,132,132,654
2000,13020,2090,2336,35068,34749,180,7.6,214,9.1,4481,1289,3192,3.7,12.9,3842,1115,2727,3.2,11.1,639,1.8,22.2,0,128,128,529
2001,13020,2093,2350,34971,35101,188,8,201,8.6,4451,1916,2535,5.5,12.7,4710,1645,3065,4.7,13.4,-259,-0.7,25.4,0,126,126,850
2002,13020,2056,2298,33780,34292,219,9.4,267,11.5,4453,1921,2532,5.6,13,5477,2035,3442,5.9,16,-1024,-3,26,0,120,120,751
2003,13020,2043,2279,33110,33303,212,9.3,199,8.7,4711,1662,3049,5,14.1,5097,1844,3253,5.5,15.3,-386,-1.2,28.2,0,141,141,1263
2004,13020,2021,2261,33214,33093,170,7.5,169,7.5,4379,1389,2990,4.2,13.2,4137,1124,3013,3.4,12.5,242,0.7,25,0,97,98,586
2005,13020,2007,2256,32563,32809,183,8.1,170,7.5,4412,1539,2873,4.7,13.4,4903,1095,3808,3.3,14.9,-491,-1.5,26.8,0,110,110,598
2006,13020,1955,2211,32636,32545,175,7.8,201,9,4183,1498,2685,4.6,12.9,4001,1205,2796,3.7,12.3,182,0.6,24.6,0,142,142,868
2007,13020,1955,2220,31640,32128,194,8.8,186,8.4,4323,1579,2744,4.9,13.5,5298,1878,3420,5.8,16.5,-975,-3,27,0,110,113,689
2008,13020,1908,2168,31401,31454,149,6.8,181,8.3,3246,862,2384,2.7,10.3,3352,979,2373,3.1,10.7,-106,-0.4,20.6,0,119,119,632
2009,13020,1864,2109,30451,30862,123,5.8,168,7.9,3132,812,2320,2.6,10.1,3954,883,3071,2.9,12.8,-822,-2.7,20.2,0,104,104,599
2010,13020,1830,2074,29365,29860,127,6.1,144,6.9,2845,640,2205,2.1,9.5,3834,746,3088,2.5,12.8,-989,-3.3,19,0,89,89,443
2011,13020,1806,2054,29885,29585,137,6.6,143,6.9,3737,993,2744,3.4,12.6,3137,823,2314,2.8,10.6,600,2,21.2,0,90,90,503
2012,13020,1795,2045,30664,30243,139,6.8,151,7.4,4680,1670,3010,5.5,15.5,3837,1245,2592,4.1,12.7,843,2.8,25.4,0,98,100,567
2013,13020,1787,2035,30289,30294,126,6.2,141,6.9,2974,804,2170,2.7,9.8,2984,808,2176,2.7,9.9,-10,-0.1,19.6,0,90,90,583
2014,13020,1754,2006,30323,30247,134,6.7,149,7.4,2963,668,2295,2.2,9.8,2811,660,2151,2.2,9.3,152,0.5,18.6,0,100,101,318
1977,13140,5523,6392,116091,113599,1055,17,698,11.2,22083,9531,12552,8.4,19.4,17098,6212,10886,5.5,15.1,4985,4.3,30.2,0,457,461,3345
1978,13140,5273,6155,123118,119348,824,13.1,979,15.6,24463,6824,17639,5.7,20.5,16923,7695,9228,6.4,14.2,7540,6.3,28.4,0,558,559,4227
1979,13140,5715,6638,129412,126438,936,14.6,501,7.8,23398,8334,15064,6.6,18.5,17449,4443,13006,3.5,13.8,5949,4.7,27.6,0,9,10,457
1980,13140,4408,5313,122787,123628,214,3.6,916,15.3,23086,4307,18779,3.5,18.7,24767,7803,16964,6.3,20,-1681,-1.3,37.4,0,689,696,4166
1981,13140,5775,6656,133683,131717,1081,18.1,610,10.2,26886,10330,16556,7.8,20.4,22954,6531,16423,5,17.4,3932,3,34.8,0,297,300,1989
1982,13140,5871,6845,130683,132143,1055,15.6,788,11.7,23072,12250,10822,9.3,17.5,25992,7619,18373,5.8,19.7,-2920,-2.2,35,0,474,474,3102
1983,13140,5992,6964,120034,124917,885,12.8,787,11.4,20171,8926,11245,7.1,16.1,29937,6043,23894,4.8,24,-9766,-7.9,32.2,0,515,515,3589
1984,13140,5948,6964,121483,120362,852,12.2,866,12.4,23544,10873,12671,9,19.6,21301,6849,14452,5.7,17.7,2243,1.9,35.4,0,550,550,3139
1985,13140,6096,7052,114691,117120,912,13,832,11.9,21138,10560,10578,9,18,25995,11163,14832,9.5,22.2,-4857,-4.2,36,0,483,489,3909
1986,13140,6087,7057,113284,113939,866,12.3,846,12,21596,8590,13006,7.5,19,22905,7066,15839,6.2,20.1,-1309,-1.1,38,0,568,571,4165
1987,13140,5988,7008,109194,111057,994,14.1,988,14,18349,8203,10146,7.4,16.5,22074,8340,13734,7.5,19.9,-3725,-3.4,33,0,624,625,4150
1988,13140,5841,6851,109849,109312,797,11.5,911,13.2,19702,7154,12548,6.5,18,18628,7195,11433,6.6,17,1074,1,34,0,596,596,4257
1989,13140,5837,6838,111197,110683,776,11.3,798,11.7,19761,7323,12438,6.6,17.9,18733,6948,11785,6.3,16.9,1028,1,33.8,0,500,516,4086
1990,13140,5836,6863,113998,112035,751,11,684,10,20761,7702,13059,6.9,18.5,16834,6251,10583,5.6,15,3927,3.5,30,0,471,473,3289
1991,13140,5943,7017,118867,116558,852,12.3,703,10.1,22394,7989,14405,6.9,19.2,17775,6914,10861,5.9,15.2,4619,4,30.4,0,442,446,3719
1992,13140,6101,7194,122099,120300,899,12.6,706,9.9,22551,8204,14347,6.8,18.7,18952,6158,12794,5.1,15.8,3599,2.9,31.6,0,436,448,2875
1993,13140,6224,7303,122078,122109,795,11,670,9.2,19562,6425,13137,5.3,16,19624,6178,13446,5.1,16.1,-62,-0.1,32,0,448,448,2778
1994,13140,6241,7311,120438,121435,793,10.9,751,10.3,17504,6574,10930,5.4,14.4,19497,5988,13509,4.9,16.1,-1993,-1.7,28.8,0,500,500,3296
1995,13140,6392,7479,126305,123334,862,11.7,683,9.2,23541,10752,12789,8.7,19.1,17599,6184,11415,5,14.3,5942,4.8,28.6,0,466,467,2764
1996,13140,6389,7475,122587,124340,795,10.6,758,10.1,18506,6865,11641,5.5,14.9,22011,6452,15559,5.2,17.7,-3505,-2.8,29.8,0,520,520,3623
1997,13140,6380,7479,123747,123270,847,11.3,827,11.1,20369,7481,12888,6.1,16.5,19414,6926,12488,5.6,15.7,955,0.8,31.4,0,503,503,3569
1998,13140,6325,7431,127659,125885,743,10,783,10.5,20136,6676,13460,5.3,16,16587,5731,10856,4.6,13.2,3549,2.8,26.4,0,503,503,2815
1999,13140,6276,7391,129456,128691,786,10.6,841,11.3,21916,10217,11699,7.9,17,20388,6864,13524,5.3,15.8,1528,1.2,31.6,0,538,538,3792
2000,13140,6238,7358,128654,129083,727,9.9,762,10.3,19667,6250,13417,4.8,15.2,20526,7764,12762,6,15.9,-859,-0.7,30.4,0,452,452,3459
2001,13140,6198,7337,129504,128953,733,10,810,11,20518,9006,11512,7,15.9,19415,7167,12248,5.6,15.1,1103,0.8,30.2,0,476,476,2992
2002,13140,6202,7323,126172,127736,852,11.6,851,11.6,21082,8090,12992,6.3,16.5,24210,8496,15714,6.7,19,-3128,-2.5,33,0,451,451,2855
2003,13140,6195,7319,124967,124803,739,10.2,617,8.5,19195,7094,12101,5.7,15.4,18867,4805,14062,3.9,15.1,328,0.3,30.2,0,446,446,2621
2004,13140,6186,7321,130250,126732,751,10.3,670,9.2,24477,7348,17129,5.8,19.3,17440,4451,12989,3.5,13.8,7037,5.5,27.6,0,470,470,2742
2005,13140,6118,7295,129211,128979,694,9.5,648,8.9,20020,5568,14452,4.3,15.5,19555,5966,13589,4.6,15.2,465,0.3,30.4,0,456,456,2895
2006,13140,6003,7203,139443,135181,697,9.6,719,10,25241,7529,17712,5.6,18.7,16716,4959,11757,3.7,12.4,8525,6.3,24.8,0,436,438,2607
2007,13140,6160,7407,140315,139580,837,11.5,632,8.7,22861,8008,14853,5.7,16.4,21390,6117,15273,4.4,15.3,1471,1.1,30.6,0,390,407,3301
2008,13140,6130,7416,146882,143459,672,9.1,606,8.2,25292,10254,15038,7.1,17.6,18445,5043,13402,3.5,12.9,6847,4.7,25.8,0,445,445,2794
2009,13140,6010,7327,138830,141928,611,8.3,640,8.7,17452,5505,11947,3.9,12.3,23647,7484,16163,5.3,16.7,-6195,-4.4,24.6,0,450,451,5174
2010,13140,6042,7365,138057,138304,607,8.3,556,7.6,23235,5211,18024,3.8,16.8,23729,6473,17256,4.7,17.2,-494,-0.4,33.6,0,390,390,2728
2011,13140,5957,7294,142039,139928,598,8.2,630,8.6,20937,5792,15145,4.1,15,16715,4943,11772,3.5,11.9,4222,3.1,23.8,0,445,445,3399
2012,13140,5949,7278,147320,144368,611,8.4,634,8.7,23158,7953,15205,5.5,16,17254,4738,12516,3.3,12,5904,4,24,0,373,373,2658
2013,13140,5952,7294,145675,146386,577,7.9,560,7.7,16736,4078,12658,2.8,11.4,18157,5615,12542,3.8,12.4,-1421,-1,22.8,0,355,357,3612
2014,13140,5916,7267,145579,145318,558,7.7,535,7.4,18113,4135,13978,2.8,12.5,17590,5107,12483,3.5,12.1,523,0.4,24.2,0,370,370,2687
1977,13380,2061,2180,23174,22221,469,22.1,326,15.4,5696,3186,2510,14.3,25.6,3790,2109,1681,9.5,17.1,1906,8.5,34.2,0,208,208,1193
1978,13380,2226,2350,32324,27744,488,21.5,320,14.1,12146,5252,6894,18.9,43.8,2986,1593,1393,5.7,10.8,9160,33,21.6,0,210,210,1050
1979,13380,2310,2447,28320,30251,468,19.5,343,14.3,6060,3137,2923,10.4,20,9921,2592,7329,8.6,32.8,-3861,-12.8,40,0,239,239,1500
1980,13380,2360,2513,28139,28165,415,16.7,337,13.6,5348,2525,2823,9,19,5399,1728,3671,6.1,19.2,-51,-0.2,38,0,253,253,1253
1981,13380,2309,2457,27105,27447,358,14.4,386,15.5,4412,1817,2595,6.6,16.1,5095,2047,3048,7.5,18.6,-683,-2.5,32.2,0,239,239,1142
1982,13380,2341,2537,27927,27453,457,18.3,335,13.4,5818,2738,3080,10,21.2,4869,1718,3151,6.3,17.7,949,3.5,35.4,0,208,208,964
1983,13380,2423,2614,26881,27432,376,14.6,330,12.8,4908,2020,2888,7.4,17.9,6010,2676,3334,9.8,21.9,-1102,-4,35.8,0,223,223,1585
1984,13380,2522,2713,28491,27678,425,16,333,12.5,6161,2843,3318,10.3,22.3,4534,2129,2405,7.7,16.4,1627,5.9,32.8,0,206,206,1116
1985,13380,2550,2738,29252,29259,386,14.1,359,13.2,5372,2204,3168,7.5,18.4,5385,2513,2872,8.6,18.4,-13,0,36.8,0,244,245,1361
1986,13380,2662,2838,30966,30096,439,15.8,324,11.6,6581,2420,4161,8,21.9,4840,1968,2872,6.5,16.1,1741,5.8,32.2,0,207,208,1131
1987,13380,2789,2966,35226,33166,483,16.6,332,11.4,8489,3354,5135,10.1,25.6,4369,1789,2580,5.4,13.2,4120,12.4,26.4,0,230,230,1149
1988,13380,2777,2978,35582,34994,414,13.9,376,12.7,7822,3094,4728,8.8,22.4,6645,2874,3771,8.2,19,1177,3.4,38,0,249,249,1546
1989,13380,2455,2711,35322,35559,468,16.5,731,25.7,7782,3343,4439,9.4,21.9,8255,5384,2871,15.1,23.2,-473,-1.3,43.8,0,223,223,1305
1990,13380,3158,3439,43860,39565,1017,33.1,270,8.8,13368,7597,5771,19.2,33.8,4778,1910,2868,4.8,12.1,8590,21.7,24.2,0,184,184,913
1991,13380,3400,3686,46925,45440,594,16.7,345,9.7,10031,3582,6449,7.9,22.1,7061,2559,4502,5.6,15.5,2970,6.6,31,0,222,224,1741
1992,13380,3558,3870,48400,47620,625,16.5,420,11.1,9951,4405,5546,9.3,20.9,8390,3416,4974,7.2,17.6,1561,3.3,35.2,0,279,279,1602
1993,13380,3698,4005,50215,49278,598,15.2,441,11.2,9891,3960,5931,8,20.1,8016,2954,5062,6,16.3,1875,3.8,32.6,0,299,299,1510
1994,13380,3890,4212,50709,50389,618,15,392,9.5,9041,3427,5614,6.8,17.9,8401,2474,5927,4.9,16.7,640,1.2,33.4,0,269,269,1557
1995,13380,3986,4311,51680,51174,591,13.9,471,11.1,8767,3503,5264,6.8,17.1,7754,2805,4949,5.5,15.2,1013,1.9,30.4,0,329,330,1871
1996,13380,4043,4379,54617,53117,645,14.8,564,13,11283,5664,5619,10.7,21.2,8282,3385,4897,6.4,15.6,3001,5.6,31.2,0,391,391,2014
1997,13380,4113,4450,53868,54274,625,14.1,538,12.2,9621,3321,6300,6.1,17.7,10432,2803,7629,5.2,19.2,-811,-1.5,35.4,0,326,326,1514
1998,13380,4283,4614,54519,54132,662,14.6,480,10.6,10210,3914,6296,7.2,18.9,9435,4484,4951,8.3,17.4,775,1.5,34.8,0,349,349,2287
1999,13380,4287,4633,59319,57293,591,12.8,560,12.1,12978,3944,9034,6.9,22.7,8926,3800,5126,6.6,15.6,4052,7.1,31.2,0,364,364,2184
2000,13380,4272,4621,58880,58318,550,11.9,546,11.8,10164,3524,6640,6,17.4,9039,2974,6065,5.1,15.5,1125,1.9,31,0,357,357,1794
2001,13380,4340,4732,58627,59019,605,12.9,544,11.6,9167,3956,5211,6.7,15.5,9950,2862,7088,4.8,16.9,-783,-1.4,31,0,338,340,1536
2002,13380,4435,4802,58632,58478,682,14.3,590,12.4,10973,4357,6616,7.5,18.8,10665,3238,7427,5.5,18.2,308,0.6,36.4,0,334,335,1878
2003,13380,4562,4930,61643,59917,676,13.9,453,9.3,10964,3658,7306,6.1,18.3,7511,3078,4433,5.1,12.5,3453,5.8,25,0,301,301,1543
2004,13380,4708,5102,64823,63274,675,13.5,451,9,10162,3308,6854,5.2,16.1,7063,2054,5009,3.2,11.2,3099,4.9,22.4,0,311,311,1512
2005,13380,4865,5264,67085,65760,728,14.1,519,10,10005,3227,6778,4.9,15.2,7355,2591,4764,3.9,11.2,2650,4,22.4,0,360,360,1800
2006,13380,5061,5478,70119,68431,751,14,512,9.5,11338,3741,7597,5.5,16.6,7961,2419,5542,3.5,11.6,3377,5,23.2,0,363,363,1754
2007,13380,5263,5713,73128,71621,749,13.4,519,9.3,13347,4627,8720,6.5,18.6,10333,3304,7029,4.6,14.4,3014,4.2,28.8,0,333,334,1460
2008,13380,5317,5780,73788,73306,657,11.5,556,9.7,10679,3429,7250,4.7,14.6,9714,2444,7270,3.3,13.3,965,1.3,26.6,0,398,398,1867
2009,13380,5104,5578,70034,71585,502,8.8,641,11.3,9318,3257,6061,4.5,13,12419,2563,9856,3.6,17.3,-3101,-4.3,26,0,414,414,1644
2010,13380,5031,5502,66991,68221,469,8.5,511,9.2,7377,2377,5000,3.5,10.8,9836,2127,7709,3.1,14.4,-2459,-3.6,21.6,0,328,328,1328
2011,13380,4928,5422,66069,66468,521,9.6,561,10.3,8435,3162,5273,4.8,12.7,9233,2420,6813,3.6,13.9,-798,-1.2,25.4,0,371,371,1866
2012,13380,4900,5380,68793,67413,497,9.2,558,10.3,10534,3081,7453,4.6,15.6,7774,2775,4999,4.1,11.5,2760,4.1,23,0,308,308,1259
2013,13380,4957,5429,69817,69115,521,9.7,482,8.9,9469,2754,6715,4,13.7,8064,2670,5394,3.9,11.7,1405,2,23.4,0,291,291,1782
2014,13380,5050,5521,71828,70573,610,11.2,492,9,9921,2996,6925,4.2,14.1,7410,2534,4876,3.6,10.5,2511,3.6,21,0,343,343,1471
1977,13460,1341,1393,12891,12095,358,27.1,201,15.2,3650,1736,1914,14.4,30.2,2058,911,1147,7.5,17,1592,13.2,34,0,143,143,715
1978,13460,1545,1600,21331,17115,434,29,227,15.2,10255,2303,7952,13.5,59.9,1822,1175,647,6.9,10.6,8433,49.3,21.2,0,174,174,864
1979,13460,1696,1759,48797,35037,470,28,293,17.5,35412,2744,32668,7.8,101.1,7892,1482,6410,4.2,22.5,27520,78.6,45,0,227,227,1090
1980,13460,1770,1842,19107,33943,437,24.3,346,19.2,4217,2365,1852,7,12.4,33888,1691,32197,5,99.8,-29671,-87.4,24.8,0,265,265,1223
1981,13460,1684,1760,17132,17636,369,20.5,403,22.4,4817,3059,1758,17.3,27.3,5825,3184,2641,18.1,33,-1008,-5.7,54.6,0,289,290,2155
1982,13460,1600,1696,15888,16410,330,19.1,358,20.7,3837,2031,1806,12.4,23.4,4881,1848,3033,11.3,29.7,-1044,-6.3,46.8,0,213,213,989
1983,13460,1617,1702,15847,15798,291,17.1,297,17.5,3615,1417,2198,9,22.9,3516,1996,1520,12.6,22.3,99,0.6,44.6,0,199,200,1048
1984,13460,1747,1835,18634,17265,380,21.5,246,13.9,5838,2616,3222,15.2,33.8,3099,1428,1671,8.3,17.9,2739,15.9,35.8,0,168,168,922
1985,13460,1843,1930,20440,19782,360,19.1,270,14.3,4363,1638,2725,8.3,22.1,3046,1537,1509,7.8,15.4,1317,6.7,30.8,0,193,193,1050
1986,13460,1991,2080,21874,21145,438,21.9,276,13.8,4740,2091,2649,9.9,22.4,3281,1172,2109,5.5,15.5,1459,6.9,31,0,190,190,798
1987,13460,2067,2169,22258,22054,388,18.3,285,13.4,4620,1727,2893,7.8,20.9,4211,1973,2238,8.9,19.1,409,1.8,38.2,0,201,201,1084
1988,13460,2045,2163,22502,21905,372,17.2,351,16.3,4854,1933,2921,8.8,22.2,3659,1639,2020,7.5,16.7,1195,5.5,33.4,0,248,248,953
1989,13460,1919,2036,24673,23603,347,16.5,470,22.4,6414,2064,4350,8.7,27.2,4274,2819,1455,11.9,18.1,2140,9.1,36.2,0,209,211,1063
1990,13460,2281,2412,27385,25991,623,28,235,10.6,7182,4049,3133,15.6,27.6,4394,1734,2660,6.7,16.9,2788,10.7,33.8,0,163,164,1281
1991,13460,2413,2563,27726,27037,455,18.3,290,11.7,5771,2851,2920,10.5,21.3,4392,1729,2663,6.4,16.2,1379,5.1,32.4,0,204,205,1380
1992,13460,2467,2631,28474,28096,437,16.8,353,13.6,5652,2359,3293,8.4,20.1,4895,2017,2878,7.2,17.4,757,2.7,34.8,0,233,234,1516
1993,13460,2602,2770,29156,28818,449,16.6,300,11.1,5969,2743,3226,9.5,20.7,5293,1369,3924,4.8,18.4,676,2.3,36.8,0,210,210,854
1994,13460,2778,2955,31205,30111,487,17,287,10,6936,2671,4265,8.9,23,4747,1583,3164,5.3,15.8,2189,7.2,31.6,0,202,202,796
1995,13460,2919,3100,32548,31653,525,17.3,350,11.6,7089,3174,3915,10,22.4,5299,1780,3519,5.6,16.7,1790,5.7,33.4,0,240,240,1121
1996,13460,3017,3213,35306,34493,509,16.1,389,12.3,7025,2819,4206,8.2,20.4,5399,1693,3706,4.9,15.7,1626,4.7,31.4,0,274,274,1125
1997,13460,3133,3351,36970,36350,578,17.6,431,13.1,7392,2702,4690,7.4,20.3,6152,2608,3544,7.2,16.9,1240,3.4,33.8,0,294,294,1523
1998,13460,3214,3435,38245,37571,515,15.2,429,12.6,7060,2937,4123,7.8,18.8,5712,2454,3258,6.5,15.2,1348,3.6,30.4,0,272,272,1528
1999,13460,3375,3620,40041,39269,589,16.7,400,11.3,8112,3478,4634,8.9,20.7,6568,3011,3557,7.7,16.7,1544,4,33.4,0,275,275,2353
2000,13460,3469,3725,42674,41321,556,15.1,445,12.1,8618,3752,4866,9.1,20.9,5912,2386,3526,5.8,14.3,2706,6.6,28.6,0,286,286,1378
2001,13460,3617,3905,43379,43179,627,16.4,490,12.8,8065,3711,4354,8.6,18.7,7665,3090,4575,7.2,17.8,400,0.9,35.6,0,326,326,1973
2002,13460,3795,4119,44934,44187,735,18.3,518,12.9,9031,4674,4357,10.6,20.4,7537,2498,5039,5.7,17.1,1494,3.3,34.2,0,303,303,1401
2003,13460,4007,4329,46769,45575,734,17.4,434,10.3,8510,3106,5404,6.8,18.7,6121,2572,3549,5.6,13.4,2389,5.3,26.8,0,311,311,1584
2004,13460,4225,4569,50276,48395,749,16.9,474,10.7,9619,4147,5472,8.6,19.9,5856,2322,3534,4.8,12.1,3763,7.8,24.2,0,335,335,1555
2005,13460,4602,4979,54589,52274,903,19,463,9.7,13178,7179,5999,13.7,25.2,8547,4462,4085,8.5,16.4,4631,8.8,32.8,0,306,306,3754
2006,13460,5015,5426,60424,57189,1020,19.6,542,10.4,13277,5515,7762,9.6,23.2,6806,2966,3840,5.2,11.9,6471,11.3,23.8,0,397,397,2466
2007,13460,5263,5716,63085,61690,923,16.6,613,11,11945,4744,7201,7.7,19.4,9155,2702,6453,4.4,14.8,2790,4.6,29.6,0,413,416,1631
2008,13460,5116,5594,60044,61488,764,13.5,828,14.7,9654,3894,5760,6.3,15.7,12541,4082,8459,6.6,20.4,-2887,-4.7,31.4,0,593,593,3139
2009,13460,4654,5135,52026,55892,586,10.9,949,17.7,6896,3597,3299,6.4,12.3,14627,4435,10192,7.9,26.2,-7731,-13.9,24.6,0,681,681,2587
2010,13460,4470,4937,50686,51157,561,11.2,702,14,7182,3242,3940,6.3,14,8124,3065,5059,6,15.9,-942,-1.9,28,0,445,445,1805
2011,13460,4395,4874,50575,50529,599,12.2,622,12.7,7609,2778,4831,5.5,15.1,7517,2877,4640,5.7,14.9,92,0.2,29.8,0,403,403,1773
2012,13460,4519,4993,51229,50798,661,13.4,556,11.3,7580,2538,5042,5,14.9,6717,2291,4426,4.5,13.2,863,1.7,26.4,0,320,320,1202
2013,13460,4708,5190,53842,52600,632,12.4,451,8.9,8525,2824,5701,5.4,16.2,6040,1849,4191,3.5,11.5,2485,4.7,23,0,290,290,1106
2014,13460,4886,5358,56435,54967,693,13.2,486,9.2,8645,2675,5970,4.9,15.7,5708,2473,3235,4.5,10.4,2937,5.3,20.8,0,336,338,1427
1977,13740,2787,3042,35889,34575,613,20.8,415,14.1,8586,3961,4625,11.5,24.8,5957,2806,3151,8.1,17.2,2629,7.6,34.4,0,296,298,1966
1978,13740,2653,2922,38069,36935,455,15.3,543,18.2,8355,2742,5613,7.4,22.6,6087,3630,2457,9.8,16.5,2268,6.1,33,0,325,325,2006
1979,13740,2988,3268,42913,40533,568,18.4,245,7.9,9739,3811,5928,9.4,24,4979,1567,3412,3.9,12.3,4760,11.7,24.6,0,6,6,114
1980,13740,3000,3284,42821,42837,459,14,420,12.8,7800,3257,4543,7.6,18.2,7832,2725,5107,6.4,18.3,-32,-0.1,36.4,0,284,286,1785
1981,13740,2966,3237,41651,41767,474,14.6,472,14.5,7719,3325,4394,8,18.5,7951,3422,4529,8.2,19,-232,-0.5,37,0,278,278,2274
1982,13740,3058,3369,43076,42423,579,17.5,415,12.5,8075,3731,4344,8.8,19,6769,2524,4245,5.9,16,1306,3,32,0,220,220,1385
1983,13740,3213,3506,42511,42495,462,13.4,373,10.9,8002,3682,4320,8.7,18.8,7969,2474,5495,5.8,18.8,33,0,37.6,0,234,237,1564
1984,13740,3372,3701,43835,43106,594,16.5,392,10.9,8250,3251,4999,7.5,19.1,6792,2192,4600,5.1,15.8,1458,3.3,31.6,0,255,255,1241
1985,13740,3425,3741,43331,44028,523,14,506,13.6,7435,2754,4681,6.3,16.9,8828,3684,5144,8.4,20.1,-1393,-3.2,33.8,0,350,350,1557
1986,13740,3386,3719,42658,42960,540,14.5,540,14.5,7586,3480,4106,8.1,17.7,8190,3313,4877,7.7,19.1,-604,-1.4,35.4,0,379,379,2239
1987,13740,3336,3693,43027,42948,547,14.7,557,15,8599,3792,4807,8.8,20,8440,3470,4970,8.1,19.7,159,0.3,39.4,0,349,351,1845
1988,13740,3222,3606,41539,41699,471,13,525,14.4,7575,3181,4394,7.6,18.2,7895,2863,5032,6.9,18.9,-320,-0.7,36.4,0,347,347,1658
1989,13740,3207,3599,43336,42372,457,12.7,455,12.6,8177,2793,5384,6.6,19.3,6248,2664,3584,6.3,14.7,1929,4.6,29.4,0,306,306,1659
1990,13740,3261,3642,44934,44121,406,11.2,344,9.5,7189,2149,5040,4.9,16.3,5562,2000,3562,4.5,12.6,1627,3.7,25.2,0,239,239,1254
1991,13740,3381,3775,45517,45188,501,13.5,360,9.7,7497,3385,4112,7.5,16.6,6838,2286,4552,5.1,15.1,659,1.5,30.2,0,220,226,1445
1992,13740,3433,3830,48220,46788,486,12.8,429,11.3,9105,2764,6341,5.9,19.5,6241,2792,3449,6,13.3,2864,6.2,26.6,0,276,277,1792
1993,13740,3524,3924,47443,47155,451,11.6,341,8.8,6906,2299,4607,4.9,14.6,6329,1617,4712,3.4,13.4,577,1.2,26.8,0,232,232,980
1994,13740,3617,4028,49941,49379,493,12.4,374,9.4,7616,2551,5065,5.2,15.4,6491,2218,4273,4.5,13.1,1125,2.3,26.2,0,251,251,1197
1995,13740,3728,4147,52020,50871,501,12.3,353,8.6,8089,3203,4886,6.3,15.9,5791,2191,3600,4.3,11.4,2298,4.5,22.8,0,252,252,1400
1996,13740,3817,4229,51860,51946,535,12.8,432,10.3,8037,3079,4958,5.9,15.5,8209,3635,4574,7,15.8,-172,-0.3,31,0,272,272,1409
1997,13740,3945,4366,52826,52426,573,13.3,446,10.4,9085,3463,5622,6.6,17.3,8285,2816,5469,5.4,15.8,800,1.5,31.6,0,276,276,1400
1998,13740,3997,4433,53848,53293,551,12.5,457,10.4,8877,3553,5324,6.7,16.7,7766,2989,4777,5.6,14.6,1111,2.1,29.2,0,305,305,1360
1999,13740,4020,4477,57236,55575,506,11.4,452,10.1,10444,3534,6910,6.4,18.8,7122,2921,4201,5.3,12.8,3322,6,25.6,0,294,294,1394
2000,13740,4049,4513,59772,58472,508,11.3,461,10.3,10053,2939,7114,5,17.2,7452,2922,4530,5,12.7,2601,4.5,25.4,0,285,285,1353
2001,13740,4133,4661,61932,61007,565,12.3,456,9.9,9718,4053,5665,6.6,15.9,7867,2618,5249,4.3,12.9,1851,3,25.8,0,253,253,1354
2002,13740,4176,4661,60491,60471,569,12.2,555,11.9,10329,3820,6509,6.3,17.1,10288,3835,6453,6.3,17,41,0.1,34,0,267,268,1295
2003,13740,4328,4816,62650,61274,574,12.2,364,7.7,11103,5179,5924,8.5,18.1,8351,2048,6303,3.3,13.6,2752,4.5,27.2,0,222,222,978
2004,13740,4405,4896,62180,62155,571,11.8,447,9.2,9012,2818,6194,4.5,14.5,8962,3354,5608,5.4,14.4,50,0.1,28.8,0,296,296,1551
2005,13740,4486,4993,63909,62965,550,11.1,419,8.5,8664,3218,5446,5.1,13.8,6776,1884,4892,3,10.8,1888,3,21.6,0,299,299,1182
2006,13740,4559,5087,67886,65709,617,12.3,471,9.4,11680,5926,5754,9,17.8,7326,2441,4885,3.7,11.1,4354,6.7,22.2,0,301,301,1573
2007,13740,4680,5230,73304,70541,619,12,467,9.1,13847,3514,10333,5,19.6,8321,3132,5189,4.4,11.8,5526,7.8,23.6,0,298,302,1830
2008,13740,4760,5347,75703,74388,568,10.8,423,8,10733,3898,6835,5.2,14.4,8103,2378,5725,3.2,10.9,2630,3.5,21.8,0,276,277,1302
2009,13740,4635,5219,73750,74601,431,8.2,516,9.8,8793,2336,6457,3.1,11.8,10495,3084,7411,4.1,14.1,-1702,-2.3,23.6,0,320,320,1657
2010,13740,4600,5188,73085,73326,452,8.7,440,8.5,8077,3411,4666,4.7,11,8559,2130,6429,2.9,11.7,-482,-0.7,22,0,258,258,1413
2011,13740,4558,5149,72798,72871,462,9,457,8.9,8112,2295,5817,3.1,11.1,8258,2729,5529,3.7,11.3,-146,-0.2,22.2,0,276,276,1710
2012,13740,4654,5266,74952,73854,505,9.7,405,7.8,10136,3301,6835,4.5,13.7,7940,2058,5882,2.8,10.8,2196,2.9,21.6,0,218,221,923
2013,13740,4727,5326,77605,76036,485,9.2,432,8.2,9546,2975,6571,3.9,12.6,6408,1660,4748,2.2,8.4,3138,4.2,16.8,0,289,289,1215
2014,13740,4681,5275,81405,79362,473,9,487,9.2,12838,2547,10291,3.2,16.2,8751,3324,5427,4.2,11,4087,5.2,22,0,319,319,1679
1977,13780,3772,4302,79452,78255,665,15.8,499,11.8,11409,4827,6582,6.2,14.6,9015,3556,5459,4.5,11.5,2394,3.1,23,0,318,319,1434
1978,13780,3885,4387,86114,82704,543,12.5,455,10.5,14438,3758,10680,4.5,17.5,7618,2733,4885,3.3,9.2,6820,8.3,18.4,0,298,302,1432
1979,13780,3888,4393,88793,87418,480,10.9,449,10.2,13241,3981,9260,4.6,15.1,10491,5356,5135,6.1,12,2750,3.1,24,0,322,322,3704
1980,13780,3825,4327,90290,89516,412,9.5,461,10.6,11601,3899,7702,4.4,13,10053,3181,6872,3.6,11.2,1548,1.8,22.4,0,335,335,1413
1981,13780,3659,4154,86673,87729,370,8.7,505,11.9,10143,3254,6889,3.7,11.6,12254,5152,7102,5.9,14,-2111,-2.4,23.2,0,283,294,2274
1982,13780,3684,4244,90713,89414,544,12.9,424,10.1,12337,5857,6480,6.6,13.8,9738,3572,6166,4,10.9,2599,2.9,21.8,0,247,247,1513
1983,13780,3763,4336,88890,89901,439,10.2,394,9.2,11146,5127,6019,5.7,12.4,13167,4873,8294,5.4,14.6,-2021,-2.2,24.8,0,263,267,2064
1984,13780,3858,4436,94491,91687,442,10.1,344,7.8,13091,3649,9442,4,14.3,7482,2131,5351,2.3,8.2,5609,6.1,16.4,0,216,216,1106
1985,13780,4004,4578,96680,96320,541,12,418,9.3,10996,3665,7331,3.8,11.4,10276,4066,6210,4.2,10.7,720,0.7,21.4,0,273,273,1473
1986,13780,4098,4675,98337,97517,533,11.5,427,9.2,12944,5370,7574,5.5,13.3,11304,4781,6523,4.9,11.6,1640,1.7,23.2,0,269,269,2224
1987,13780,4127,4733,96197,97419,558,11.9,481,10.2,10278,3725,6553,3.8,10.6,12722,3887,8835,4,13.1,-2444,-2.5,21.2,0,328,328,1958
1988,13780,4143,4774,99468,97146,552,11.6,489,10.3,15987,5836,10151,6,16.5,11344,4380,6964,4.5,11.7,4643,4.8,23.4,0,333,333,1803
1989,13780,4206,4831,103320,101400,522,10.9,462,9.6,14494,4854,9640,4.8,14.3,10654,2625,8029,2.6,10.5,3840,3.8,21,0,296,304,1488
1990,13780,4193,4829,101807,102546,423,8.8,408,8.4,11925,3725,8200,3.6,11.6,13402,3253,10149,3.2,13.1,-1477,-1.5,23.2,0,277,279,1695
1991,13780,4255,4920,98723,100312,510,10.5,434,8.9,10565,4071,6494,4.1,10.5,13742,2578,11164,2.6,13.7,-3177,-3.2,21,0,275,276,1668
1992,13780,4192,4885,98147,98411,446,9.1,457,9.3,11967,3234,8733,3.3,12.2,12495,3567,8928,3.6,12.7,-528,-0.5,24.4,0,295,295,2235
1993,13780,4169,4860,94947,96495,396,8.1,413,8.5,11393,3363,8030,3.5,11.8,14489,4369,10120,4.5,15,-3096,-3.2,23.6,0,285,285,1442
1994,13780,4116,4797,93052,94092,396,8.2,438,9.1,10858,4333,6525,4.6,11.5,12937,3517,9420,3.7,13.7,-2079,-2.2,23,0,301,301,1876
1995,13780,4000,4689,91596,92244,393,8.3,480,10.1,10345,3054,7291,3.3,11.2,11641,4709,6932,5.1,12.6,-1296,-1.4,22.4,0,325,325,1794
1996,13780,3973,4644,89676,90674,383,8.2,417,8.9,9414,2652,6762,2.9,10.4,11409,3082,8327,3.4,12.6,-1995,-2.2,20.8,0,263,263,1446
1997,13780,3955,4650,88868,89362,458,9.8,465,10,10905,3960,6945,4.4,12.2,11893,4098,7795,4.6,13.3,-988,-1.1,24.4,0,263,263,1334
1998,13780,3932,4592,92111,90432,403,8.7,445,9.6,12642,3934,8708,4.4,14,9283,3211,6072,3.6,10.3,3359,3.7,20.6,0,271,271,1355
1999,13780,3906,4601,91311,91807,414,9,408,8.9,10386,3924,6462,4.3,11.3,11378,4732,6646,5.2,12.4,-992,-1.1,22.6,0,247,247,1477
2000,13780,3906,4600,95173,93249,430,9.3,432,9.4,17562,7936,9626,8.5,18.8,13714,8763,4951,9.4,14.7,3848,4.1,29.4,0,240,240,1189
2001,13780,3944,4663,96172,95723,429,9.2,402,8.7,10736,3197,7539,3.3,11.2,9837,3483,6354,3.6,10.3,899,0.9,20.6,0,239,239,1339
2002,13780,3926,4645,94092,95115,450,9.7,467,10,13303,6499,6804,6.8,14,15348,4689,10659,4.9,16.1,-2045,-2.1,28,0,242,243,1256
2003,13780,3907,4650,91815,92693,434,9.4,368,7.9,10631,4368,6263,4.7,11.5,12386,3407,8979,3.7,13.4,-1755,-1.9,23,0,266,266,1506
2004,13780,3848,4581,90632,91022,363,7.9,409,8.9,9552,2205,7347,2.4,10.5,10331,2833,7498,3.1,11.4,-779,-0.9,21,0,276,276,1621
2005,13780,3856,4619,88123,89247,378,8.2,307,6.7,8536,3186,5350,3.6,9.6,10783,1769,9014,2,12.1,-2247,-2.5,19.2,0,227,227,1201
2006,13780,3858,4643,88931,88438,416,9,375,8.1,9904,3583,6321,4.1,11.2,8918,2904,6014,3.3,10.1,986,1.1,20.2,0,261,261,1860
2007,13780,3905,4662,89573,89216,428,9.2,397,8.5,11736,4274,7462,4.8,13.2,11021,3434,7587,3.8,12.4,715,0.8,24.8,0,203,208,968
2008,13780,3890,4678,90478,89883,413,8.9,354,7.6,10360,3082,7278,3.4,11.5,9169,2358,6811,2.6,10.2,1191,1.3,20.4,0,236,236,1434
2009,13780,3817,4587,85928,87920,346,7.5,404,8.7,6424,1906,4518,2.2,7.3,10408,2728,7680,3.1,11.8,-3984,-4.5,14.6,0,263,263,1677
2010,13780,3842,4597,82312,83848,380,8.3,348,7.6,7092,2154,4938,2.6,8.5,10163,2215,7948,2.6,12.1,-3071,-3.6,17,0,213,213,1513
2011,13780,3848,4607,80708,81408,375,8.2,341,7.4,7096,2245,4851,2.8,8.7,8495,2308,6187,2.8,10.4,-1399,-1.7,17.4,0,213,213,1331
2012,13780,3893,4650,83095,81782,424,9.2,362,7.8,9971,2193,7778,2.7,12.2,7345,1929,5416,2.4,9,2626,3.2,18,0,230,231,1080
2013,13780,3872,4635,82489,82675,373,8.1,375,8.1,8695,3372,5323,4.1,10.5,9066,2325,6741,2.8,11,-371,-0.5,21,0,216,216,1103
2014,13780,3820,4599,83884,83018,380,8.3,386,8.4,10695,4686,6009,5.6,12.9,8963,2775,6188,3.3,10.8,1732,2.1,21.6,0,268,269,1942
1977,13820,13503,15960,283787,275326,2662,17.1,1899,12.2,58723,26053,32670,9.5,21.3,41800,16073,25727,5.8,15.2,16923,6.1,30.4,0,1292,1294,9194
1978,13820,13864,16380,299865,291810,2410,14.9,1982,12.3,60981,19396,41585,6.6,20.9,44870,16411,28459,5.6,15.4,16111,5.5,30.8,0,1358,1364,9328
1979,13820,14072,16632,318194,308616,2251,13.6,1901,11.5,69880,21697,48183,7,22.6,50724,18457,32267,6,16.4,19156,6.2,32.8,0,1356,1357,12099
1980,13820,13944,16534,316575,317246,2048,12.4,2072,12.5,52777,15555,37222,4.9,16.6,54121,16043,38078,5.1,17.1,-1344,-0.5,33.2,0,1463,1467,8798
1981,13820,13577,16038,300701,307307,1961,12.1,2282,14,45870,17539,28331,5.7,14.9,59083,22955,36128,7.5,19.2,-13213,-4.3,29.8,0,1387,1401,9846
1982,13820,13431,16096,297878,298633,2195,13.7,1925,12,48600,19136,29464,6.4,16.3,50110,15083,35027,5.1,16.8,-1510,-0.5,32.6,0,1120,1120,6693
1983,13820,13654,16245,285853,287680,1900,11.7,1831,11.3,49941,20950,28991,7.3,17.4,53594,16403,37191,5.7,18.6,-3653,-1.2,34.8,0,1163,1169,7225
1984,13820,14288,16928,306770,296662,2478,14.9,1801,10.9,62485,22498,39987,7.6,21.1,42268,15824,26444,5.3,14.2,20217,6.9,28.4,0,1126,1127,8542
1985,13820,14808,17499,321128,314976,2456,14.3,1919,11.1,57887,18913,38974,6,18.4,45584,16300,29284,5.2,14.5,12303,3.9,29,0,1233,1242,8120
1986,13820,15412,18274,339856,330544,2674,15,1837,10.3,63823,21600,42223,6.5,19.3,45199,15466,29733,4.7,13.7,18624,5.6,27.4,0,1210,1210,7844
1987,13820,15967,18980,343444,342278,2890,15.5,2144,11.5,63554,24909,38645,7.3,18.6,61224,19469,41755,5.7,17.9,2330,0.7,35.8,0,1356,1366,9439
1988,13820,15991,19091,346084,343744,2597,13.7,2320,12.2,61248,26931,34317,7.8,17.8,56568,20843,35725,6.1,16.5,4680,1.3,33,0,1504,1504,9145
1989,13820,16382,19625,366775,356921,2607,13.5,2109,10.9,69036,27184,41852,7.6,19.3,49327,17829,31498,5,13.8,19709,5.5,27.6,0,1420,1423,8444
1990,13820,16666,19980,376757,371479,2494,12.6,2034,10.3,61367,19745,41622,5.3,16.5,50810,16652,34158,4.5,13.7,10557,2.8,27.4,0,1405,1422,10159
1991,13820,16868,20345,384263,381526,2536,12.6,2200,10.9,63107,28786,34321,7.5,16.5,57633,22138,35495,5.8,15.1,5474,1.4,30.2,0,1381,1394,9548
1992,13820,16944,20587,384160,384919,2543,12.4,2230,10.9,59895,18998,40897,4.9,15.6,61413,20768,40645,5.4,16,-1518,-0.4,31.2,0,1433,1446,9911
1993,13820,17266,20904,391997,388755,2404,11.6,2050,9.9,62975,18816,44159,4.8,16.2,56491,19364,37127,5,14.5,6484,1.7,29,0,1357,1359,8291
1994,13820,17614,21303,404152,398227,2535,12,2071,9.8,63512,25162,38350,6.3,15.9,51661,17197,34464,4.3,13,11851,2.9,26,0,1372,1375,9728
1995,13820,18123,21901,427398,415454,2667,12.4,2011,9.3,72293,26633,45660,6.4,17.4,48405,15448,32957,3.7,11.7,23888,5.7,23.4,0,1360,1369,9099
1996,13820,18441,22317,429416,428686,2676,12.1,2217,10,66112,25427,40685,5.9,15.4,64652,20460,44192,4.8,15.1,1460,0.3,30.2,0,1458,1458,10637
1997,13820,18672,22758,437761,434118,2888,12.8,2433,10.8,79294,30818,48476,7.1,18.3,72009,26911,45098,6.2,16.6,7285,1.7,33.2,0,1576,1576,14542
1998,13820,18783,22874,441032,439197,2725,11.9,2552,11.2,70403,26323,44080,6,16,66734,29457,37277,6.7,15.2,3669,0.8,30.4,0,1611,1611,10775
1999,13820,18831,23083,450811,445689,2665,11.6,2395,10.4,73285,29154,44131,6.5,16.4,63040,23973,39067,5.4,14.1,10245,2.3,28.2,0,1554,1554,10708
2000,13820,18734,23072,462764,456697,2489,10.8,2513,10.9,73895,24306,49589,5.3,16.2,61763,22604,39159,4.9,13.5,12132,2.7,27,0,1563,1563,8408
2001,13820,18706,23243,454856,460174,2627,11.3,2650,11.4,63388,24411,38977,5.3,13.8,74025,25055,48970,5.4,16.1,-10637,-2.3,27.6,0,1587,1588,11887
2002,13820,18824,23412,450519,453717,2894,12.4,2683,11.5,72557,33362,39195,7.4,16,78952,25163,53789,5.5,17.4,-6395,-1.4,32,0,1421,1421,8108
2003,13820,18974,23539,447281,444668,2585,11.1,2017,8.6,64864,23242,41622,5.2,14.6,59637,19202,40435,4.3,13.4,5227,1.2,26.8,0,1401,1403,9467
2004,13820,19168,23725,457643,451087,2545,10.8,2099,8.9,69718,21739,47979,4.8,15.5,56605,19620,36985,4.3,12.5,13113,3,25,0,1372,1373,8792
2005,13820,19451,24173,467411,461747,2705,11.3,2058,8.6,76352,28210,48142,6.1,16.5,65023,19759,45264,4.3,14.1,11329,2.4,28.2,0,1450,1451,12217
2006,13820,19528,24415,476684,470918,2677,11,2209,9.1,73194,26669,46525,5.7,15.5,61661,18635,43026,4,13.1,11533,2.4,26.2,0,1481,1482,8391
2007,13820,20065,25214,488925,482092,3087,12.5,2253,9.1,80632,32867,47765,6.8,16.7,66966,21688,45278,4.5,13.9,13666,2.8,27.8,0,1376,1384,8624
2008,13820,19936,25188,486464,485670,2435,9.7,2196,8.8,67809,21522,46287,4.4,14,66221,20707,45514,4.3,13.6,1588,0.4,27.2,0,1585,1589,11723
2009,13820,19153,24268,458979,470159,1926,7.8,2564,10.4,55000,19202,35798,4.1,11.7,77359,18647,58712,4,16.5,-22359,-4.8,23.4,0,1796,1804,9260
2010,13820,18614,23685,438839,447379,1886,7.9,2251,9.4,46338,15969,30369,3.6,10.4,63418,20201,43217,4.5,14.2,-17080,-3.8,20.8,0,1558,1561,14949
2011,13820,18340,23423,436513,436518,2029,8.6,2115,9,53374,16717,36657,3.8,12.2,53383,15811,37572,3.6,12.2,-9,0,24.4,0,1412,1415,8016
2012,13820,18465,23526,440681,438289,2179,9.3,2039,8.7,59895,17288,42607,3.9,13.7,55110,16464,38646,3.8,12.6,4785,1.1,25.2,0,1206,1216,7712
2013,13820,18495,23495,450325,445996,1878,8,1882,8,57933,17727,40206,4,13,49274,17423,31851,3.9,11,8659,2,22,0,1220,1222,11186
2014,13820,18445,23487,453910,449654,1940,8.3,1774,7.6,57280,17988,39292,4,12.7,48767,13855,34912,3.1,10.8,8513,1.9,21.6,0,1234,1238,7964
1977,13900,1650,1762,22215,21661,325,18.9,228,13.3,4580,2075,2505,9.6,21.1,3471,1736,1735,8,16,1109,5.1,32,0,151,152,1397
1978,13900,1795,1904,24730,23470,334,18.2,189,10.3,5449,1827,3622,7.8,23.2,2929,1260,1669,5.4,12.5,2520,10.7,25,0,141,144,746
1979,13900,1879,1997,26962,25818,329,16.9,216,11.1,5706,2572,3134,10,22.1,3418,1754,1664,6.8,13.2,2288,8.9,26.4,0,166,166,1072
1980,13900,1946,2086,28274,27627,319,15.6,226,11.1,5797,2776,3021,10,21,4503,1623,2880,5.9,16.3,1294,4.7,32.6,0,160,160,1087
1981,13900,1883,2015,26934,27059,275,13.5,293,14.4,4736,2161,2575,8,17.5,4985,1910,3075,7.1,18.4,-249,-0.9,35,0,194,194,901
1982,13900,1854,2005,26395,26612,283,14.1,250,12.4,3995,1767,2228,6.6,15,4429,1527,2902,5.7,16.6,-434,-1.6,30,0,141,141,868
1983,13900,1910,2065,26076,25996,252,12.4,217,10.7,4466,1923,2543,7.4,17.2,4305,1832,2473,7,16.6,161,0.6,33.2,0,145,145,1200
1984,13900,1992,2153,28092,27213,307,14.6,232,11,5065,2207,2858,8.1,18.6,3307,1349,1958,5,12.2,1758,6.4,24.4,0,141,141,741
1985,13900,2057,2215,28758,28857,282,12.8,239,10.9,3934,1512,2422,5.2,13.6,4132,1259,2873,4.4,14.3,-198,-0.7,27.2,0,155,155,873
1986,13900,2062,2223,29174,28978,263,11.9,250,11.3,4195,1934,2261,6.7,14.5,3803,1299,2504,4.5,13.1,392,1.4,26.2,0,161,163,872
1987,13900,2069,2231,28776,28936,286,12.8,264,11.9,4064,1619,2445,5.6,14,4384,1961,2423,6.8,15.2,-320,-1.2,28,0,174,177,1293
1988,13900,2041,2211,28605,28104,268,12.1,266,12.1,4446,1748,2698,6.2,15.8,3444,1403,2041,5,12.3,1002,3.5,24.6,0,185,185,745
1989,13900,2076,2265,31216,29903,248,11.1,191,8.5,5968,2956,3012,9.9,20,3342,1251,2091,4.2,11.2,2626,8.8,22.4,0,133,133,800
1990,13900,2123,2307,31330,31253,235,10.3,185,8.1,4141,1039,3102,3.3,13.2,3987,1417,2570,4.5,12.8,154,0.4,25.6,0,138,138,679
1991,13900,2148,2353,32639,31983,252,10.8,209,9,5536,2781,2755,8.7,17.3,4224,993,3231,3.1,13.2,1312,4.1,26.4,0,135,139,595
1992,13900,2197,2410,33985,33317,257,10.8,191,8,5114,1456,3658,4.4,15.3,3778,995,2783,3,11.3,1336,4,22.6,0,139,141,656
1993,13900,2211,2425,34724,34342,229,9.5,207,8.6,4680,1604,3076,4.7,13.6,3915,1397,2518,4.1,11.4,765,2.2,22.8,0,154,154,1034
1994,13900,2271,2476,35472,35063,252,10.3,192,7.8,4542,1479,3063,4.2,13,3724,1016,2708,2.9,10.6,818,2.4,21.2,0,128,128,513
1995,13900,2315,2530,36059,35756,240,9.6,172,6.9,4148,1219,2929,3.4,11.6,3542,894,2648,2.5,9.9,606,1.7,19.8,0,111,111,578
1996,13900,2360,2563,36293,36192,252,9.9,225,8.8,5317,1811,3506,5,14.7,5115,2397,2718,6.6,14.1,202,0.6,28.2,0,132,132,703
1997,13900,2361,2587,37714,37002,285,11.1,255,9.9,5905,1661,4244,4.5,16,4480,1479,3001,4,12.1,1425,3.9,24.2,0,170,170,825
1998,13900,2361,2585,38854,38213,236,9.1,235,9.1,5178,1827,3351,4.8,13.6,3896,1401,2495,3.7,10.2,1282,3.4,20.4,0,153,153,775
1999,13900,2422,2662,40134,39564,256,9.8,181,6.9,5311,1913,3398,4.8,13.4,4170,941,3229,2.4,10.5,1141,2.9,21,0,126,126,581
2000,13900,2457,2707,41819,40977,258,9.6,216,8,5762,2350,3412,5.7,14.1,4078,1551,2527,3.8,10,1684,4.1,20,0,149,149,1011
2001,13900,2467,2723,41807,41865,221,8.1,228,8.4,4831,1954,2877,4.7,11.5,4947,1660,3287,4,11.8,-116,-0.3,23,0,128,128,818
2002,13900,2465,2731,41978,41880,269,9.9,255,9.4,6191,2615,3576,6.2,14.8,5995,2240,3755,5.3,14.3,196,0.5,28.6,0,132,132,1213
2003,13900,2509,2773,43491,42666,251,9.2,178,6.5,5933,1852,4081,4.3,13.9,4282,1289,2993,3,10,1651,3.9,20,0,102,102,506
2004,13900,2580,2839,44017,43558,244,8.7,159,5.7,4486,1163,3323,2.7,10.3,3568,940,2628,2.2,8.2,918,2.1,16.4,0,103,103,572
2005,13900,2581,2851,45594,44768,246,8.7,216,7.6,5975,2281,3694,5.1,13.3,4323,1423,2900,3.2,9.7,1652,3.6,19.4,0,148,148,641
2006,13900,2646,2932,48682,47064,326,11.3,225,7.8,7756,3642,4114,7.7,16.5,4520,1724,2796,3.7,9.6,3236,6.9,19.2,0,133,133,1251
2007,13900,2721,3034,49802,49224,318,10.7,210,7,6705,2157,4548,4.4,13.6,5549,2007,3542,4.1,11.3,1156,2.3,22.6,0,119,119,1131
2008,13900,2771,3083,52298,50964,282,9.2,212,6.9,6983,2263,4720,4.4,13.7,4315,1146,3169,2.2,8.5,2668,5.2,17,0,133,133,859
2009,13900,2752,3070,50419,51290,242,7.9,238,7.7,5369,1960,3409,3.8,10.5,7110,2735,4375,5.3,13.9,-1741,-3.4,21,0,152,152,2430
2010,13900,2780,3095,51012,50354,242,7.9,208,6.8,5128,1000,4128,2,10.2,3812,818,2994,1.6,7.6,1316,2.6,15.2,0,132,132,482
2011,13900,2817,3148,52036,51480,262,8.4,185,5.9,5236,1441,3795,2.8,10.2,4124,607,3517,1.2,8,1112,2.2,16,0,128,128,465
2012,13900,2938,3293,53920,52992,332,10.3,203,6.3,7753,2863,4890,5.4,14.6,5898,1683,4215,3.2,11.1,1855,3.5,22.2,0,121,121,659
2013,13900,3029,3389,56800,54768,314,9.4,218,6.5,8014,1614,6400,2.9,14.6,3950,1250,2700,2.3,7.2,4064,7.4,14.4,0,146,146,792
2014,13900,3072,3436,57090,56776,328,9.6,261,7.7,6150,1948,4202,3.4,10.8,5522,1994,3528,3.5,9.7,628,1.1,19.4,0,173,173,593
1977,13980,1649,1843,31162,30224,328,18.3,228,12.7,5601,2428,3173,8,18.5,3724,1286,2438,4.3,12.3,1877,6.2,24.6,0,149,150,820
1978,13980,1695,1885,32887,32020,297,15.9,254,13.6,5468,2312,3156,7.2,17.1,3734,1455,2279,4.5,11.7,1734,5.4,23.4,0,175,175,672
1979,13980,1710,1911,34918,33891,286,15.1,253,13.3,7008,2684,4324,7.9,20.7,4954,2683,2271,7.9,14.6,2054,6.1,29.2,0,178,178,1068
1980,13980,1708,1910,34264,34571,241,12.6,229,12,4435,1611,2824,4.7,12.8,5049,1752,3297,5.1,14.6,-614,-1.8,25.6,0,168,168,546
1981,13980,1641,1841,38698,36186,238,12.7,284,15.2,9881,2776,7105,7.7,27.3,4857,1884,2973,5.2,13.4,5024,13.9,26.8,0,183,183,996
1982,13980,1639,1881,33944,36366,279,15,212,11.4,4016,1909,2107,5.2,11,8860,973,7887,2.7,24.4,-4844,-13.4,22,0,133,133,501
1983,13980,1685,1921,33886,34030,219,11.5,206,10.8,4077,1448,2629,4.3,12,4365,1513,2852,4.4,12.8,-288,-0.8,24,0,127,127,628
1984,13980,1635,1868,35917,35193,219,11.6,250,13.2,4912,1225,3687,3.5,14,3463,1642,1821,4.7,9.8,1449,4.2,19.6,0,128,131,531
1985,13980,1785,2018,37564,37360,253,13,131,6.7,4358,1322,3036,3.5,11.7,3950,1772,2178,4.7,10.6,408,1.1,21.2,0,4,4,27
1986,13980,1841,2089,38385,37946,296,14.4,215,10.5,4955,2462,2493,6.5,13.1,4076,1425,2651,3.8,10.7,879,2.4,21.4,0,136,136,479
1987,13980,1910,2189,39359,39061,340,15.9,231,10.8,5154,2038,3116,5.2,13.2,4557,1575,2982,4,11.7,597,1.5,23.4,0,158,159,753
1988,13980,1963,2250,41440,40267,281,12.7,214,9.7,6392,2426,3966,6,15.9,4046,1271,2775,3.2,10,2346,5.9,20,0,134,134,561
1989,13980,2004,2303,43087,42268,296,13,243,10.7,7171,3493,3678,8.3,17,5532,2654,2878,6.3,13.1,1639,3.9,26.2,0,154,157,1066
1990,13980,2052,2366,42596,42830,298,12.8,227,9.7,4631,1744,2887,4.1,10.8,5098,1536,3562,3.6,11.9,-467,-1.1,21.6,0,154,154,662
1991,13980,2068,2390,41168,41952,280,11.8,248,10.4,5134,1951,3183,4.7,12.2,6701,2379,4322,5.7,16,-1567,-3.8,24.4,0,150,152,741
1992,13980,2077,2412,40387,40762,265,11,230,9.6,4769,1790,2979,4.4,11.7,5519,1475,4044,3.6,13.5,-750,-1.8,23.4,0,155,163,995
1993,13980,2121,2441,40745,40548,232,9.6,201,8.3,5788,1789,3999,4.4,14.3,5393,1221,4172,3,13.3,395,1,26.6,0,128,128,620
1994,13980,2159,2496,42600,41687,249,10.1,188,7.6,6047,1712,4335,4.1,14.5,4221,1293,2928,3.1,10.1,1826,4.4,20.2,0,127,127,1019
1995,13980,2236,2564,43861,43222,286,11.3,211,8.3,5987,1986,4001,4.6,13.9,4709,1437,3272,3.3,10.9,1278,3,21.8,0,133,134,712
1996,13980,2304,2634,43767,43757,306,11.8,220,8.5,5378,2314,3064,5.3,12.3,5358,1020,4338,2.3,12.2,20,0.1,24.4,0,151,151,602
1997,13980,2359,2726,45815,44795,330,12.3,234,8.7,7443,2765,4678,6.2,16.6,5402,1590,3812,3.5,12.1,2041,4.5,24.2,0,164,164,1041
1998,13980,2391,2778,46712,46245,302,11,244,8.9,6226,1780,4446,3.8,13.5,5291,1873,3418,4.1,11.4,935,2.1,22.8,0,145,145,941
1999,13980,2399,2789,47843,47289,289,10.4,282,10.1,6684,2275,4409,4.8,14.1,5576,2312,3264,4.9,11.8,1108,2.3,23.6,0,178,178,987
2000,13980,2455,2838,48907,48370,297,10.6,242,8.6,6928,2561,4367,5.3,14.3,5854,1883,3971,3.9,12.1,1074,2.2,24.2,0,164,164,925
2001,13980,2463,2867,47682,48351,298,10.4,294,10.3,6776,3632,3144,7.5,14,8114,2754,5360,5.7,16.8,-1338,-2.8,28,0,176,176,787
2002,13980,2494,2895,45155,46394,338,11.7,307,10.7,5888,3010,2878,6.5,12.7,8366,2724,5642,5.9,18,-2478,-5.3,25.4,0,136,136,648
2003,13980,2519,2929,45977,45351,322,11.1,229,7.9,6573,2646,3927,5.8,14.5,5320,1517,3803,3.3,11.7,1253,2.8,23.4,0,160,160,828
2004,13980,2524,2927,46628,45633,258,8.8,219,7.5,6611,2050,4561,4.5,14.5,4620,1089,3531,2.4,10.1,1991,4.4,20.2,0,148,148,652
2005,13980,2557,2981,47105,46753,298,10.1,216,7.3,5705,2001,3704,4.3,12.2,5001,1469,3532,3.1,10.7,704,1.5,21.4,0,141,141,1061
2006,13980,2580,3029,49734,48372,313,10.4,254,8.5,8550,2463,6087,5.1,17.7,5825,2634,3191,5.4,12,2725,5.7,24,0,170,170,1453
2007,13980,2591,3077,47244,48427,318,10.4,262,8.6,6692,2488,4204,5.1,13.8,9058,2118,6940,4.4,18.7,-2366,-4.9,27.6,0,158,159,999
2008,13980,2585,3080,48377,47694,274,8.9,248,8.1,7036,2036,5000,4.3,14.8,5669,1487,4182,3.1,11.9,1367,2.9,23.8,0,168,169,789
2009,13980,2529,3018,45665,46893,246,8.1,286,9.4,5964,2214,3750,4.7,12.7,8420,2419,6001,5.2,18,-2456,-5.3,25.4,0,187,187,1010
2010,13980,2508,2985,42915,43472,227,7.6,243,8.1,4390,1606,2784,3.7,10.1,5504,2003,3501,4.6,12.7,-1114,-2.6,20.2,0,155,155,1149
2011,13980,2462,2942,44014,43397,253,8.6,267,9,5749,2379,3370,5.5,13.2,4514,1352,3162,3.1,10.4,1235,2.8,20.8,0,180,180,870
2012,13980,2468,2929,45787,44921,240,8.2,243,8.3,6615,1688,4927,3.8,14.7,4883,1336,3547,3,10.9,1732,3.8,21.8,0,136,137,566
2013,13980,2436,2901,47268,46458,225,7.7,244,8.4,6212,2266,3946,4.9,13.4,4592,1344,3248,2.9,9.9,1620,3.5,19.8,0,163,163,1042
2014,13980,2428,2895,46621,46580,223,7.7,204,7.1,5812,2387,3425,5.1,12.5,5730,1355,4375,2.9,12.3,82,0.2,24.6,0,140,143,701
1977,14020,2041,2194,29316,29399,382,17.8,279,13,4941,2335,2606,7.9,16.8,5107,1651,3456,5.6,17.4,-166,-0.6,33.6,0,195,198,1241
1978,14020,2106,2271,31420,30361,348,15.6,270,12.1,6025,2279,3746,7.5,19.8,3907,1581,2326,5.2,12.9,2118,6.9,25.8,0,188,189,906
1979,14020,2116,2293,32114,31706,348,15.3,296,13,5656,1928,3728,6.1,17.8,4840,1556,3284,4.9,15.3,816,2.5,30.6,0,217,224,949
1980,14020,2120,2297,31972,31996,335,14.6,311,13.6,4669,1925,2744,6,14.6,4716,1802,2914,5.6,14.7,-47,-0.1,29.2,0,224,225,1051
1981,14020,2042,2215,33766,32218,289,12.9,337,15,7277,2339,4938,7.3,22.6,4180,1944,2236,6,13,3097,9.6,26,0,212,212,905
1982,14020,2098,2312,35174,34414,363,16,238,10.5,6439,2816,3623,8.2,18.7,4919,1723,3196,5,14.3,1520,4.4,28.6,0,158,158,1185
1983,14020,1999,2215,31517,33331,265,11.7,333,14.7,4769,1951,2818,5.9,14.3,8397,4936,3461,14.8,25.2,-3628,-10.9,28.6,0,200,202,988
1984,14020,2216,2443,35071,33441,353,15.2,186,8,6642,2021,4621,6,19.9,3382,1399,1983,4.2,10.1,3260,9.8,20.2,1,2,3,
1985,14020,2366,2597,35681,35632,413,16.4,277,11,6188,2699,3489,7.6,17.4,6089,1958,4131,5.5,17.1,99,0.3,34.2,0,182,182,1343
1986,14020,2441,2674,36812,36246,390,14.8,304,11.5,7852,4079,3773,11.3,21.7,6719,3562,3157,9.8,18.5,1133,3.2,37,0,172,172,2427
1987,14020,2530,2767,59370,47992,403,14.8,293,10.8,28392,3006,25386,6.3,59.2,5636,2145,3491,4.5,11.7,22756,47.5,23.4,0,187,191,1075
1988,14020,2525,2769,40193,49397,338,12.2,309,11.2,7385,2663,4722,5.4,15,25792,,3591,,52.2,-18407,-37.2,30,1,199,199,
1989,14020,2642,2918,43771,42145,430,15.1,283,10,8664,3397,5267,8.1,20.6,5411,1883,3528,4.5,12.8,3253,7.8,25.6,0,195,195,1275
1990,14020,2705,2992,45795,44717,398,13.5,305,10.3,7478,2769,4709,6.2,16.7,5321,1778,3543,4,11.9,2157,4.8,23.8,0,202,202,1040
1991,14020,2770,3080,43766,44379,386,12.7,303,10,6035,2508,3527,5.7,13.6,7260,2336,4924,5.3,16.4,-1225,-2.8,27.2,0,197,197,1507
1992,14020,2795,3140,45355,44653,400,12.8,329,10.6,7155,2387,4768,5.3,16,5751,2003,3748,4.5,12.9,1404,3.1,25.8,0,228,229,1298
1993,14020,2901,3250,47191,46269,389,12.2,275,8.6,6987,2427,4560,5.2,15.1,5143,1517,3626,3.3,11.1,1844,4,22.2,0,199,200,1138
1994,14020,2948,3286,48726,47906,362,11.1,316,9.7,7648,2773,4875,5.8,16,6007,1970,4037,4.1,12.5,1641,3.5,25,0,212,214,1058
1995,14020,3035,3384,50141,49452,407,12.2,304,9.1,7511,2398,5113,4.8,15.2,6133,2687,3446,5.4,12.4,1378,2.8,24.8,0,205,205,1247
1996,14020,3062,3430,51052,50577,415,12.2,354,10.4,7772,2831,4941,5.6,15.4,6822,2111,4711,4.2,13.5,950,1.9,27,0,255,255,1474
1997,14020,3067,3466,53191,52206,434,12.6,395,11.4,9582,3413,6169,6.5,18.4,7612,2498,5114,4.8,14.6,1970,3.8,29.2,0,248,248,1131
1998,14020,3058,3442,53540,53289,381,11,388,11.2,7795,2918,4877,5.5,14.6,7292,3169,4123,5.9,13.7,503,0.9,27.4,0,263,263,1711
1999,14020,3088,3485,54697,54348,350,10.1,315,9.1,7706,2599,5107,4.8,14.2,7007,2701,4306,5,12.9,699,1.3,25.8,0,212,212,1244
2000,14020,3073,3485,56577,55469,336,9.6,327,9.4,8236,2562,5674,4.6,14.8,6020,1802,4218,3.2,10.9,2216,3.9,21.8,0,225,225,952
2001,14020,3066,3487,55978,56568,329,9.4,366,10.5,6947,2126,4821,3.8,12.3,8127,2987,5140,5.3,14.4,-1180,-2.1,24.6,0,227,227,1030
2002,14020,3077,3484,55237,55553,403,11.6,397,11.4,8921,4167,4754,7.5,16.1,9553,3605,5948,6.5,17.2,-632,-1.1,32.2,0,205,205,1480
2003,14020,3121,3542,59112,56948,377,10.8,284,8.1,10095,2818,7277,4.9,17.7,5767,1772,3995,3.1,10.1,4328,7.6,20.2,0,204,205,1303
2004,14020,3131,3548,60247,59570,356,10.1,317,9,8131,2476,5655,4.2,13.6,6776,1930,4846,3.2,11.4,1355,2.2,22.8,0,202,202,944
2005,14020,3164,3595,61076,60259,375,10.5,300,8.4,8497,2987,5510,5,14.1,6862,2193,4669,3.6,11.4,1635,2.7,22.8,0,213,213,1578
2006,14020,3192,3646,60901,60866,403,11.1,336,9.3,8279,3016,5263,5,13.6,8209,3377,4832,5.5,13.5,70,0.1,27,0,223,223,1381
2007,14020,3228,3694,62452,61700,388,10.6,334,9.1,9513,3499,6014,5.7,15.4,8008,1921,6087,3.1,13,1505,2.4,26,0,214,214,1154
2008,14020,3166,3635,61154,61477,306,8.4,320,8.8,7777,2272,5505,3.7,12.7,8422,3003,5419,4.9,13.7,-645,-1,25.4,0,230,230,2039
2009,14020,3062,3527,58237,59604,260,7.3,335,9.4,6842,1977,4865,3.3,11.5,9576,4051,5525,6.8,16.1,-2734,-4.6,23,0,218,222,1337
2010,14020,3064,3532,56611,57351,274,7.8,252,7.2,6068,2287,3781,4,10.6,7547,1950,5597,3.4,13.2,-1479,-2.6,21.2,0,165,165,1241
2011,14020,3029,3510,56314,56393,281,8,278,7.9,6610,2647,3963,4.7,11.7,6768,1947,4821,3.5,12,-158,-0.3,23.4,0,188,188,1509
2012,14020,3008,3487,57327,56793,300,8.6,335,9.6,8277,2281,5996,4,14.6,7209,3068,4141,5.4,12.7,1068,1.9,25.4,0,196,198,1336
2013,14020,2962,3437,57455,57473,272,7.9,334,9.7,6183,2313,3870,4,10.8,6218,2044,4174,3.6,10.8,-35,0,21.6,0,219,223,1641
2014,14020,2942,3415,56734,57012,283,8.3,282,8.3,5898,1834,4064,3.2,10.3,6454,1315,5139,2.3,11.3,-556,-1,20.6,0,183,183,853
1977,14060,1957,2145,39770,38168,365,17.3,286,13.6,7491,3194,4297,8.4,19.6,4287,1866,2421,4.9,11.2,3204,8.4,22.4,0,171,171,1127
1978,14060,2067,2260,40876,40327,371,16.8,257,11.7,6531,2356,4175,5.8,16.2,5432,1954,3478,4.8,13.5,1099,2.7,27,0,167,167,1260
1979,14060,2059,2251,42703,41770,283,12.5,280,12.4,6603,1838,4765,4.4,15.8,4737,1575,3162,3.8,11.3,1866,4.5,22.6,0,180,180,734
1980,14060,2046,2253,43656,43188,271,12,266,11.8,6124,1801,4323,4.2,14.2,5187,1413,3774,3.3,12,937,2.2,24,0,182,182,733
1981,14060,2024,2226,46325,44635,318,14.3,316,14.2,9330,2684,6646,6,20.9,5950,2276,3674,5.1,13.3,3380,7.6,26.6,0,182,184,1420
1982,14060,2001,2222,45963,46114,280,12.6,248,11.1,5818,2371,3447,5.1,12.6,6119,1704,4415,3.7,13.3,-301,-0.7,25.2,0,154,154,749
1983,14060,1998,2233,43273,44645,243,10.9,251,11.3,5422,1821,3601,4.1,12.1,8166,1947,6219,4.4,18.3,-2744,-6.2,24.2,0,137,137,891
1984,14060,2116,2371,48071,45679,354,15.4,220,9.6,10369,4138,6231,9.1,22.7,5585,1488,4097,3.3,12.2,4784,10.5,24.4,0,127,127,664
1985,14060,2130,2391,46399,47535,274,11.5,270,11.3,5134,1892,3242,4,10.8,7406,2987,4419,6.3,15.6,-2272,-4.8,21.6,0,168,169,992
1986,14060,2171,2426,48558,47081,266,11,223,9.3,6707,2004,4703,4.3,14.2,3753,1420,2333,3,8,2954,6.2,16,0,138,139,801
1987,14060,2261,2526,49860,49201,377,15.2,266,10.7,7467,2865,4602,5.8,15.2,6151,3361,2790,6.8,12.5,1316,2.7,25,0,155,157,913
1988,14060,2281,2574,50332,49722,325,12.8,250,9.8,8249,3876,4373,7.8,16.6,7030,2778,4252,5.6,14.1,1219,2.5,28.2,0,179,179,2052
1989,14060,2311,2630,56384,53372,298,11.5,235,9,11740,3991,7749,7.5,22,5715,2042,3673,3.8,10.7,6025,11.3,21.4,0,140,141,1310
1990,14060,2368,2689,61339,58846,267,10,199,7.5,10141,2311,7830,3.9,17.2,5154,1612,3542,2.7,8.8,4987,8.4,17.6,0,130,130,858
1991,14060,2475,2840,63410,62323,381,13.8,232,8.4,8291,3503,4788,5.6,13.3,6116,1713,4403,2.7,9.8,2175,3.5,19.6,0,118,119,988
1992,14060,2498,2886,64012,63684,320,11.2,264,9.2,7957,3141,4816,4.9,12.5,7300,2730,4570,4.3,11.5,657,1,23,0,158,161,984
1993,14060,2539,2917,65226,64694,272,9.4,241,8.3,8092,3184,4908,4.9,12.5,7028,2250,4778,3.5,10.9,1064,1.6,21.8,0,128,128,775
1994,14060,2599,2981,68525,66590,347,11.8,272,9.2,10570,2472,8098,3.7,15.9,6700,2532,4168,3.8,10.1,3870,5.8,20.2,0,165,165,1062
1995,14060,2668,3066,69288,68886,346,11.4,247,8.2,7921,2338,5583,3.4,11.5,7117,1520,5597,2.2,10.3,804,1.2,20.6,0,153,153,824
1996,14060,2730,3131,70131,69622,372,12,305,9.8,9701,3130,6571,4.5,13.9,8683,2369,6314,3.4,12.5,1018,1.4,25,0,177,177,1294
1997,14060,2778,3185,70928,70545,394,12.5,343,10.8,9951,3348,6603,4.7,14.1,9185,2879,6306,4.1,13,766,1.1,26,0,182,182,1175
1998,14060,2768,3179,76130,73500,341,10.7,349,11,16345,4608,11737,6.3,22.2,11084,2172,8912,3,15.1,5261,7.1,30.2,0,216,216,1002
1999,14060,2772,3211,79483,77986,344,10.8,311,9.7,10380,3389,6991,4.3,13.3,7385,2649,4736,3.4,9.5,2995,3.8,19,0,185,185,957
2000,14060,2792,3196,80964,79990,298,9.3,313,9.8,18933,3509,15424,4.4,23.7,16986,5092,11894,6.4,21.2,1947,2.5,42.4,0,147,147,573
2001,14060,2768,3184,81265,81190,290,9.1,326,10.2,9187,2926,6261,3.6,11.3,9037,2361,6676,2.9,11.1,150,0.2,22.2,0,178,178,1133
2002,14060,2760,3166,78371,78624,354,11.2,366,11.5,9469,4089,5380,5.2,12,9975,3562,6413,4.5,12.7,-506,-0.7,24,0,168,169,1582
2003,14060,2799,3229,79292,78587,337,10.6,220,6.9,8740,2563,6177,3.3,11.1,7329,1897,5432,2.4,9.3,1411,1.8,18.6,0,150,150,881
2004,14060,2843,3270,79315,79091,321,9.9,250,7.7,6988,2278,4710,2.9,8.8,6540,1544,4996,2,8.3,448,0.5,16.6,0,155,155,659
2005,14060,2893,3330,79534,79295,360,11,255,7.8,8164,3543,4621,4.5,10.3,7685,2255,5430,2.8,9.7,479,0.6,19.4,0,156,156,1037
2006,14060,2912,3385,80539,79853,388,11.6,295,8.8,9450,3373,6077,4.2,11.8,8078,2767,5311,3.5,10.1,1372,1.7,20.2,0,192,192,1213
2007,14060,2952,3437,81243,80904,365,10.7,305,9,8705,3177,5528,3.9,10.8,8027,2503,5524,3.1,9.9,678,0.9,19.8,0,182,182,1168
2008,14060,2984,3467,81808,81357,334,9.7,269,7.8,8262,3244,5018,4,10.2,7360,2271,5089,2.8,9,902,1.2,18,0,177,177,1153
2009,14060,2918,3387,79227,80356,259,7.6,307,9,6114,1869,4245,2.3,7.6,8372,2345,6027,2.9,10.4,-2258,-2.8,15.2,0,209,211,1434
2010,14060,2889,3370,76710,77912,273,8.1,276,8.2,6066,2672,3394,3.4,7.8,8469,3102,5367,4,10.9,-2403,-3.1,15.6,0,165,165,1985
2011,14060,2835,3344,77154,76826,274,8.2,268,8,6777,1977,4800,2.6,8.8,6121,2005,4116,2.6,8,656,0.8,16,0,168,169,1232
2012,14060,2872,3379,77953,77477,332,9.9,282,8.4,7419,2081,5338,2.7,9.6,6467,1783,4684,2.3,8.3,952,1.3,16.6,0,156,157,851
2013,14060,2856,3365,78142,77954,265,7.9,272,8.1,7056,2116,4940,2.7,9.1,6680,2577,4103,3.3,8.6,376,0.5,17.2,0,172,172,1405
2014,14060,2851,3365,77810,77830,297,8.9,266,7.9,6869,2455,4414,3.2,8.8,6908,1949,4959,2.5,8.9,-39,-0.1,17.6,0,186,186,1390
1977,14260,5068,5791,83828,78577,1178,21.1,733,13.2,23782,8526,15256,10.9,30.3,13279,5256,8023,6.7,16.9,10503,13.4,33.8,0,510,512,2980
1978,14260,5029,5748,81853,82705,1009,17.5,983,17,21407,7719,13688,9.3,25.9,23111,7474,15637,9,27.9,-1704,-2,51.8,0,559,559,3049
1979,14260,5570,6329,87914,85329,1070,17.7,538,8.9,20255,8565,11690,10,23.7,15084,5300,9784,6.2,17.7,5171,6,35.4,0,10,10,260
1980,14260,5597,6375,87679,87747,956,15.1,879,13.8,17410,6218,11192,7.1,19.8,17546,5644,11902,6.4,20,-136,-0.2,39.6,0,635,635,3368
1981,14260,5267,6026,104439,95603,824,13.3,1064,17.2,34824,24799,10025,25.9,36.4,17151,6406,10745,6.7,17.9,17673,18.5,35.8,0,674,688,3275
1982,14260,5353,6222,98350,101379,1100,18,830,13.5,28167,20798,7369,20.5,27.8,34225,5482,28743,5.4,33.8,-6058,-6,55.6,0,428,428,2441
1983,14260,5467,6314,84102,90098,846,13.5,789,12.6,15440,6569,8871,7.3,17.1,27432,5907,21525,6.6,30.4,-11992,-13.3,34.2,0,513,516,2927
1984,14260,5700,6578,91951,88148,973,15.1,718,11.1,21030,7139,13891,8.1,23.9,13424,4804,8620,5.4,15.2,7606,8.7,30.4,0,505,507,2701
1985,14260,5810,6711,91181,91806,905,13.6,794,11.9,16191,5692,10499,6.2,17.6,17440,5661,11779,6.2,19,-1249,-1.4,35.2,0,533,534,3261
1986,14260,5944,6856,93943,92499,940,13.9,766,11.3,16957,6835,10122,7.4,18.3,14068,4686,9382,5.1,15.2,2889,3.1,30.4,0,493,493,3094
1987,14260,6059,6978,94838,94688,1017,14.7,851,12.3,18463,7393,11070,7.8,19.5,18162,8190,9972,8.6,19.2,301,0.3,38.4,0,494,502,3793
1988,14260,6010,6989,98840,96005,940,13.5,849,12.2,20195,7263,12932,7.6,21,14524,5809,8715,6.1,15.1,5671,5.9,30.2,0,571,571,3110
1989,14260,6225,7256,110909,105105,1015,14.3,752,10.6,24879,11671,13208,11.1,23.7,13271,5244,8027,5,12.6,11608,11.1,25.2,0,464,464,3201
1990,14260,6599,7681,115868,113269,1128,15.1,667,8.9,21322,7040,14282,6.2,18.8,16123,4781,11342,4.2,14.2,5199,4.6,28.4,0,469,470,2902
1991,14260,6903,8062,121428,118630,1156,14.7,764,9.7,23525,9447,14078,8,19.8,17929,6173,11756,5.2,15.1,5596,4.7,30.2,0,488,490,3469
1992,14260,7221,8412,130715,126278,1211,14.7,823,10,27340,12447,14893,9.9,21.7,18465,6320,12145,5,14.6,8875,7.1,29.2,0,503,507,3723
1993,14260,7541,8742,133914,132270,1190,13.9,831,9.7,23654,7792,15862,5.9,17.9,20365,5189,15176,3.9,15.4,3289,2.5,30.8,0,509,509,2720
1994,14260,8109,9385,148777,141312,1522,16.8,850,9.4,31565,9546,22019,6.8,22.3,16634,5832,10802,4.1,11.8,14931,10.5,23.6,0,600,601,3624
1995,14260,8461,9741,157331,152658,1387,14.5,987,10.3,28930,9558,19372,6.3,19,19583,6212,13371,4.1,12.8,9347,6.2,25.6,0,664,664,3361
1996,14260,8772,10117,160600,158863,1530,15.4,1090,11,29943,12606,17337,7.9,18.8,26469,9889,16580,6.2,16.7,3474,2.1,33.4,0,759,759,5841
1997,14260,9144,10590,166322,163528,1705,16.4,1250,12,32613,12653,19960,7.7,19.9,27025,10208,16817,6.2,16.5,5588,3.4,33,0,764,764,3980
1998,14260,9387,10918,176435,171449,1562,14.5,1206,11.2,34499,12982,21517,7.6,20.1,24526,8147,16379,4.8,14.3,9973,5.8,28.6,0,810,810,4293
1999,14260,9657,11390,185505,180968,1695,15.2,1196,10.7,34377,14778,19599,8.2,19,25302,9109,16193,5,14,9075,5,28,0,756,756,5078
2000,14260,9865,11694,195035,190154,1641,14.2,1348,11.7,35995,16750,19245,8.8,18.9,26233,10487,15746,5.5,13.8,9762,5.1,27.6,0,785,785,4256
2001,14260,10183,12062,207634,201674,1830,15.4,1582,13.3,41327,16912,24415,8.4,20.5,29406,11376,18030,5.6,14.6,11921,5.9,29.2,0,825,825,4780
2002,14260,10516,12405,199507,203530,1878,15.4,1515,12.4,40631,18958,21673,9.3,20,48676,17191,31485,8.4,23.9,-8045,-3.9,40,0,772,786,9554
2003,14260,10827,12766,203156,199693,1854,14.8,1263,10.1,35647,12702,22945,6.4,17.9,28721,8936,19785,4.5,14.4,6926,3.5,28.8,0,860,860,4943
2004,14260,11297,13218,215523,208659,1868,14.4,1276,9.8,43612,23948,19664,11.5,20.9,29885,11365,18520,5.4,14.3,13727,6.6,28.6,0,810,813,3850
2005,14260,12058,14093,228615,221591,2219,16.3,1235,9.1,40170,15985,24185,7.2,18.1,26122,7986,18136,3.6,11.8,14048,6.3,23.6,0,824,824,4772
2006,14260,13069,15209,247653,237523,2583,17.7,1384,9.5,47083,17402,29681,7.3,19.8,26823,8433,18390,3.6,11.3,20260,8.5,22.6,0,933,933,5257
2007,14260,13707,16001,245345,246254,2502,16,1711,11,47638,17694,29944,7.2,19.3,49456,11900,37556,4.8,20.1,-1818,-0.8,38.6,0,1121,1125,6292
2008,14260,13259,15678,234758,239234,1895,12,2031,12.9,32121,13222,18899,5.5,13.4,41073,12349,28724,5.2,17.2,-8952,-3.8,26.8,0,1495,1502,9283
2009,14260,12253,14667,214849,224196,1428,9.4,2244,14.8,23839,11333,12506,5.1,10.6,42533,11154,31379,5,19,-18694,-8.4,21.2,0,1543,1543,6923
2010,14260,11992,14413,211580,212782,1514,10.4,1708,11.8,32554,12542,20012,5.9,15.3,34958,9894,25064,4.6,16.4,-2404,-1.1,30.6,0,1110,1113,5367
2011,14260,11681,14109,212439,211632,1430,10,1640,11.5,29293,8817,20476,4.2,13.8,27679,7924,19755,3.7,13.1,1614,0.7,26.2,0,1045,1048,4980
2012,14260,11873,14315,221508,217034,1588,11.2,1427,10.1,34292,11401,22891,5.3,15.8,25345,10676,14669,4.9,11.7,8947,4.1,23.4,0,858,868,4029
2013,14260,12082,14539,233451,227109,1603,11.1,1391,9.7,33895,11226,22669,4.9,14.9,21211,7335,13876,3.2,9.3,12684,5.6,18.6,0,879,879,5085
2014,14260,12383,14865,238204,234626,1691,11.5,1275,8.7,37779,10934,26845,4.7,16.1,30622,13509,17113,5.8,13.1,7157,3,26.2,0,858,869,4271
1977,14460,65080,74997,1378941,1328889,10413,14.1,8369,11.3,283944,116439,167505,8.8,21.4,183839,74189,109650,5.6,13.8,100105,7.6,27.6,0,5493,5508,38834
1978,14460,66262,76211,1482855,1430694,9332,12.3,8122,10.7,288002,84193,203809,5.9,20.1,183680,78400,105280,5.5,12.8,104322,7.3,25.6,0,5388,5413,34095
1979,14460,67604,77822,1583623,1532606,9475,12.3,7531,9.8,290902,81414,209488,5.3,19,188868,62648,126220,4.1,12.3,102034,6.7,24.6,0,5151,5162,31606
1980,14460,68350,78610,1634477,1608657,8916,11.4,7877,10.1,273222,81352,191870,5.1,17,221582,74691,146891,4.6,13.8,51640,3.2,27.6,0,5310,5348,36344
1981,14460,67322,77330,1630068,1627313,8676,11.1,9375,12,264758,89190,175568,5.5,16.3,259250,105582,153668,6.5,15.9,5508,0.4,31.8,0,5251,5277,44799
1982,14460,68902,80249,1699925,1672383,10814,13.7,7368,9.3,276759,112458,164301,6.7,16.5,221675,69574,152101,4.2,13.3,55084,3.2,26.6,0,4155,4161,30678
1983,14460,71351,82831,1726003,1713670,9428,11.6,7370,9,268008,97313,170695,5.7,15.6,243341,71353,171988,4.2,14.2,24667,1.4,28.4,0,4770,4793,32836
1984,14460,74133,86026,1854984,1789521,10701,12.7,7648,9.1,336051,100795,235256,5.6,18.8,205124,68249,136875,3.8,11.5,130927,7.3,23,0,4912,4921,31002
1985,14460,77120,89418,1945089,1906746,11675,13.3,8365,9.5,338459,103368,235091,5.4,17.8,261772,94850,166922,5,13.7,76687,4.1,27.4,0,5364,5383,43042
1986,14460,80417,93073,2004942,1973517,13077,14.3,9114,10,366228,139993,226235,7.1,18.6,303378,107534,195844,5.4,15.4,62850,3.2,30.8,0,5771,5783,48527
1987,14460,83265,96769,2038475,2029139,14206,15,10164,10.7,351929,127093,224836,6.3,17.3,333258,120886,212372,6,16.4,18671,0.9,32.8,0,6592,6626,52291
1988,14460,84859,98709,2074716,2052357,12720,13,10448,10.7,364021,127610,236411,6.2,17.7,319303,115575,203728,5.6,15.6,44718,2.1,31.2,0,6911,6911,56056
1989,14460,85635,100350,2116722,2097075,11969,12,10646,10.7,366340,126096,240244,6,17.5,327046,106415,220631,5.1,15.6,39294,1.9,31.2,0,7323,7408,56492
1990,14460,83538,98589,2047306,2085889,10414,10.5,11347,11.4,270279,96980,173299,4.6,13,347446,106001,241445,5.1,16.7,-77167,-3.7,26,0,7934,7964,59352
1991,14460,81449,97052,1912479,1970927,10296,10.5,11805,12.1,252212,97566,154646,5,12.8,369108,119938,249170,6.1,18.7,-116896,-5.9,25.6,0,7225,7319,60559
1992,14460,80548,96690,1895595,1902906,10894,11.2,10754,11.1,294530,103707,190823,5.4,15.5,309152,100304,208848,5.3,16.2,-14622,-0.7,31,0,6620,6740,48637
1993,14460,81315,97205,1932690,1913319,10101,10.4,9419,9.7,311452,98174,213278,5.1,16.3,272710,87466,185244,4.6,14.3,38742,2,28.6,0,6011,6087,39450
1994,14460,82854,98900,1959742,1945234,11159,11.4,9256,9.4,303735,96181,207554,4.9,15.6,274719,89464,185255,4.6,14.1,29016,1.5,28.2,0,5946,5968,43470
1995,14460,84835,101329,2021867,1990449,11965,12,9316,9.3,310788,102821,207967,5.2,15.6,247953,84489,163464,4.2,12.5,62835,3.1,25,0,5984,6032,41658
1996,14460,86335,103007,2063458,2042833,11524,11.3,9707,9.5,314699,101619,213080,5,15.4,273449,106025,167424,5.2,13.4,41250,2,26.8,0,6153,6153,45902
1997,14460,88104,105558,2122958,2094015,12694,12.2,10156,9.7,363978,129564,234414,6.2,17.4,306093,107434,198659,5.1,14.6,57885,2.8,29.2,0,6155,6155,48443
1998,14460,89302,106972,2172901,2147397,11814,11.1,10104,9.5,349635,120277,229358,5.6,16.3,298626,99039,199587,4.6,13.9,51009,2.4,27.8,0,6529,6529,45152
1999,14460,89836,107806,2227972,2201695,11394,10.6,10425,9.7,354625,120766,233859,5.5,16.1,302071,108091,193980,4.9,13.7,52554,2.4,27.4,0,6547,6547,46447
2000,14460,90537,109244,2321455,2272667,11728,10.8,10377,9.6,399305,133586,265719,5.9,17.6,301729,117250,184479,5.2,13.3,97576,4.3,26.6,0,6265,6265,46112
2001,14460,91989,111216,2370360,2349937,11622,10.5,11136,10.1,384302,126245,258057,5.4,16.4,343456,117435,226021,5,14.6,40846,1.8,29.2,0,6551,6556,54775
2002,14460,92075,111954,2285247,2322215,12963,11.6,12039,10.8,371897,151688,220209,6.5,16,445833,144984,300849,6.2,19.2,-73936,-3.2,32,0,6391,6398,49986
2003,14460,92696,112550,2246640,2247162,12447,11.1,10115,9.1,324795,107236,217559,4.8,14.5,325838,108626,217212,4.8,14.5,-1043,0,29,0,6469,6478,46934
2004,14460,91833,111637,2256534,2246031,11392,10.2,11346,10.1,305883,107562,198321,4.8,13.6,284878,89330,195548,4,12.7,21005,0.9,25.4,0,7807,7825,42413
2005,14460,92359,112641,2269627,2254354,11815,10.6,9945,8.9,298624,104880,193744,4.7,13.2,268079,89279,178800,4,11.9,30545,1.3,23.8,0,6655,6671,44071
2006,14460,92807,113969,2336261,2296762,12326,10.9,10062,8.9,363197,137529,225668,6,15.8,284199,96503,187696,4.2,12.4,78998,3.4,24.8,0,6694,6697,49592
2007,14460,92718,114294,2346473,2340357,11506,10.1,10959,9.6,327695,99014,228681,4.2,14,315464,97528,217936,4.2,13.5,12231,0.5,27,0,6554,6623,41090
2008,14460,91851,113831,2353134,2342494,10493,9.2,9949,8.8,315534,106451,209083,4.5,13.5,294254,85942,208312,3.7,12.6,21280,0.9,25.2,0,6779,6780,43762
2009,14460,89123,111076,2253640,2294016,8981,8,10606,9.5,238392,85710,152682,3.7,10.4,319145,81700,237445,3.6,13.9,-80753,-3.5,20.8,0,6705,6752,42371
2010,14460,88025,110281,2228388,2233426,9597,8.7,9565,8.7,266169,89007,177162,4,11.9,276245,71529,204716,3.2,12.4,-10076,-0.5,23.8,0,6006,6037,38383
2011,14460,87886,110482,2252196,2236154,9792,8.9,8892,8.1,264492,76380,188112,3.4,11.8,232408,65867,166541,2.9,10.4,32084,1.4,20.8,0,5623,5626,34163
2012,14460,89206,111729,2311764,2277516,10704,9.7,9302,8.4,300379,82119,218260,3.6,13.2,231882,75071,156811,3.3,10.2,68497,3,20.4,0,5318,5395,35638
2013,14460,90109,112798,2361671,2334315,9942,8.9,8874,7.9,273248,79401,193847,3.4,11.7,218536,71227,147309,3.1,9.4,54712,2.3,18.8,0,5297,5331,39059
2014,14460,90782,113605,2397035,2371432,10241,9.1,8659,7.7,281676,86417,195259,3.6,11.9,230470,73192,157278,3.1,9.7,51206,2.2,19.4,0,5680,5730,41530
1977,14500,3522,3750,46691,44315,889,24.8,538,15,13137,6948,6189,15.7,29.6,8385,4119,4266,9.3,18.9,4752,10.7,37.8,0,401,402,2385
1978,14500,3517,3747,55963,51210,774,20.6,734,19.6,16372,4791,11581,9.4,32,6865,4090,2775,8,13.4,9507,18.6,26.8,0,473,475,2144
1979,14500,3988,4236,64618,60238,872,21.8,403,10.1,17142,6123,11019,10.2,28.5,8382,2957,5425,4.9,13.9,8760,14.6,27.8,0,7,7,65
1980,14500,4128,4376,65138,64817,849,19.7,675,15.7,12776,5660,7116,8.7,19.7,12133,5118,7015,7.9,18.7,643,1,37.4,0,493,494,2949
1981,14500,4032,4276,64708,64874,755,17.5,821,19,14568,6569,7999,10.1,22.5,14900,8983,5917,13.8,23,-332,-0.5,45,0,521,527,4292
1982,14500,4189,4502,71580,68050,897,20.4,629,14.3,17516,8777,8739,12.9,25.7,10455,4505,5950,6.6,15.4,7061,10.3,30.8,0,358,358,1977
1983,14500,4455,4781,74370,72978,837,18,581,12.5,15589,5634,9955,7.7,21.4,12804,4475,8329,6.1,17.5,2785,3.9,35,0,401,403,2468
1984,14500,4878,5233,83236,78685,1062,21.2,610,12.2,18670,6727,11943,8.5,23.7,9567,3935,5632,5,12.2,9103,11.5,24.4,0,426,427,2400
1985,14500,5093,5455,80212,81694,971,18.2,735,13.8,15979,7104,8875,8.7,19.6,18943,6567,12376,8,23.2,-2964,-3.6,39.2,0,524,527,3732
1986,14500,5211,5628,83343,81792,991,17.9,794,14.3,18194,8708,9486,10.6,22.2,15091,5701,9390,7,18.5,3103,3.7,37,0,545,545,3544
1987,14500,5357,5815,81957,82599,1042,18.2,823,14.4,14279,6425,7854,7.8,17.3,15563,6854,8709,8.3,18.8,-1284,-1.5,34.6,0,556,557,4168
1988,14500,5348,5816,84761,83271,897,15.4,862,14.8,16586,6477,10109,7.8,19.9,13605,6385,7220,7.7,16.3,2981,3.6,32.6,0,596,596,2901
1989,14500,5463,5936,92668,88792,925,15.7,796,13.5,19083,7284,11799,8.2,21.5,11330,5061,6269,5.7,12.8,7753,8.7,25.6,0,548,548,3250
1990,14500,5640,6152,95273,93907,926,15.3,671,11.1,16673,5654,11019,6,17.8,13940,4293,9647,4.6,14.8,2733,3,29.6,0,470,470,2879
1991,14500,5961,6504,98040,96713,1001,15.8,659,10.4,20329,7886,12443,8.2,21,17675,4990,12685,5.2,18.3,2654,2.7,36.6,0,436,436,3097
1992,14500,6192,6730,103477,100752,1079,16.3,829,12.5,21441,9534,11907,9.5,21.3,15991,7732,8259,7.7,15.9,5450,5.4,31.8,0,531,533,3887
1993,14500,6646,7180,108240,105819,1127,16.2,662,9.5,21954,7951,14003,7.5,20.7,17112,4846,12266,4.6,16.2,4842,4.5,32.4,0,433,435,2549
1994,14500,7033,7585,115542,111826,1210,16.4,800,10.8,23420,7506,15914,6.7,20.9,15988,6914,9074,6.2,14.3,7432,6.6,28.6,0,532,535,3404
1995,14500,7322,7916,123426,119482,1226,15.8,842,10.9,24592,7417,17175,6.2,20.6,16704,6542,10162,5.5,14,7888,6.6,28,0,602,602,3395
1996,14500,7620,8217,126931,125178,1233,15.3,904,11.2,23558,7890,15668,6.3,18.8,20051,6356,13695,5.1,16,3507,2.8,32,0,621,621,3631
1997,14500,7747,8424,128905,128073,1248,15,1028,12.3,25356,10099,15257,7.9,19.8,23692,12606,11086,9.8,18.5,1664,1.3,37,0,674,674,5814
1998,14500,8014,8731,135510,131950,1259,14.7,931,10.9,27113,8720,18393,6.6,20.5,19992,8090,11902,6.1,15.2,7121,5.3,30.4,0,617,617,3962
1999,14500,8178,8923,142385,139027,1248,14.1,1028,11.6,29014,11592,17422,8.3,20.9,22298,9912,12386,7.1,16,6716,4.9,32,0,671,671,3678
2000,14500,8332,9112,148468,145392,1263,14,1055,11.7,28717,10762,17955,7.4,19.8,22565,10881,11684,7.5,15.5,6152,4.3,31,0,659,659,4261
2001,14500,8515,9357,157100,153118,1285,13.9,1117,12.1,33344,12303,21041,8,21.8,25379,8628,16751,5.6,16.6,7965,5.2,33.2,0,671,671,4166
2002,14500,8443,9260,149440,154044,1303,14,1392,15,24188,8371,15817,5.4,15.7,33396,12504,20892,8.1,21.7,-9208,-6,31.4,0,714,714,4299
2003,14500,8448,9259,140410,143849,1265,13.7,1064,11.6,19015,7365,11650,5.1,13.2,25892,10248,15644,7.1,18,-6877,-4.8,26.4,0,692,694,4704
2004,14500,8557,9360,138758,138985,1203,13,999,10.8,19754,6993,12761,5,14.2,20207,7811,12396,5.6,14.5,-453,-0.3,28.4,0,662,662,4352
2005,14500,8733,9559,138595,138533,1315,13.9,1044,11.1,20234,8100,12134,5.8,14.6,20110,7076,13034,5.1,14.5,124,0.1,29,0,689,693,4300
2006,14500,8875,9766,142913,139760,1341,13.9,1034,10.7,24763,11131,13632,8,17.7,18456,5775,12681,4.1,13.2,6307,4.5,26.4,0,645,645,3965
2007,14500,9030,9969,142700,142542,1330,13.5,1111,11.3,25611,10912,14699,7.7,18,25294,12036,13258,8.4,17.7,317,0.3,35.4,0,646,648,4629
2008,14500,9172,10109,148132,144730,1295,13,1076,10.8,24950,9753,15197,6.7,17.2,18146,6186,11960,4.3,12.5,6804,4.7,25,0,712,712,3793
2009,14500,8954,9845,138577,142924,1040,10.5,1202,12.1,16937,6773,10164,4.7,11.9,25631,9408,16223,6.6,17.9,-8694,-6,23.8,0,714,714,4001
2010,14500,8929,9821,137475,137743,1141,11.6,1117,11.4,19107,6735,12372,4.9,13.9,19642,5814,13828,4.2,14.3,-535,-0.4,27.8,0,687,687,3924
2011,14500,9009,9888,137547,137111,1174,11.9,1047,10.6,20135,7519,12616,5.5,14.7,19263,7105,12158,5.2,14,872,0.7,28,0,653,653,3170
2012,14500,9143,10008,141345,139043,1139,11.5,1017,10.2,20145,6611,13534,4.8,14.5,15540,6623,8917,4.8,11.2,4605,3.3,22.4,0,611,616,2824
2013,14500,9266,10120,145089,143139,1142,11.4,1043,10.4,22791,6961,15830,4.9,15.9,18890,7343,11547,5.1,13.2,3901,2.7,26.4,0,627,629,3007
2014,14500,9426,10292,151394,147730,1219,12,978,9.6,25491,6884,18607,4.7,17.3,18163,7053,11110,4.8,12.3,7328,5,24.6,0,652,652,3515
1977,14540,1398,1509,20949,20871,271,18.3,208,14.1,3865,1960,1905,9.4,18.5,3709,1166,2543,5.6,17.8,156,0.7,35.6,0,134,134,797
1978,14540,1420,1531,23220,22093,220,14.5,201,13.2,5246,1932,3314,8.7,23.7,2992,837,2155,3.8,13.5,2254,10.2,27,0,139,139,575
1979,14540,1456,1576,25851,24518,236,15.2,182,11.7,5346,1736,3610,7.1,21.8,2679,1157,1522,4.7,10.9,2667,10.9,21.8,0,137,137,671
1980,14540,1494,1629,25359,25589,239,14.9,181,11.3,3746,1950,1796,7.6,14.6,4206,1056,3150,4.1,16.4,-460,-1.8,29.2,0,128,128,559
1981,14540,1449,1592,23742,24279,203,12.7,204,12.7,4844,2943,1901,12.1,20,5917,1519,4398,6.3,24.4,-1073,-4.4,40,0,118,118,677
1982,14540,1454,1619,25231,24444,256,15.9,215,13.4,5351,3608,1743,14.8,21.9,3776,1385,2391,5.7,15.4,1575,6.5,30.8,0,127,127,782
1983,14540,1509,1669,27283,26265,229,13.9,192,11.7,6429,4551,1878,17.3,24.5,4392,1126,3266,4.3,16.7,2037,7.8,33.4,0,130,130,632
1984,14540,1559,1721,27935,27614,258,15.2,204,12,4011,1870,2141,6.8,14.5,3369,1264,2105,4.6,12.2,642,2.3,24.4,0,141,141,609
1985,14540,1598,1761,30198,29371,228,13.1,198,11.3,5103,1677,3426,5.7,17.4,3449,1544,1905,5.3,11.7,1654,5.7,23.4,0,130,131,560
1986,14540,1605,1768,30359,30266,239,13.5,225,12.8,4510,2333,2177,7.7,14.9,4323,1820,2503,6,14.3,187,0.6,28.6,0,149,149,847
1987,14540,1657,1814,30345,29892,253,14.1,199,11.1,4928,1588,3340,5.3,16.5,4022,1603,2419,5.4,13.5,906,3,27,0,127,127,897
1988,14540,1667,1837,26687,26593,250,13.7,212,11.7,4821,2115,2706,8,18.1,4632,1622,3010,6.1,17.4,189,0.7,34.8,0,146,146,837
1989,14540,1698,1878,29224,27935,224,12.1,181,9.7,6115,2909,3206,10.4,21.9,3537,1507,2030,5.4,12.7,2578,9.2,25.4,0,119,119,737
1990,14540,1699,1888,30653,29756,213,11.3,195,10.4,6242,2568,3674,8.6,21,4447,2043,2404,6.9,14.9,1795,6.1,29.8,0,132,132,1349
1991,14540,1741,1950,31917,31428,256,13.3,195,10.2,7115,3821,3294,12.2,22.6,6137,2753,3384,8.8,19.5,978,3.1,39,0,124,124,1658
1992,14540,1826,2037,32736,32381,281,14.1,195,9.8,5626,1828,3798,5.6,17.4,4915,2538,2377,7.8,15.2,711,2.2,30.4,0,137,137,1973
1993,14540,1867,2075,35321,34156,243,11.8,200,9.7,6527,2429,4098,7.1,19.1,4197,1442,2755,4.2,12.3,2330,6.8,24.6,0,128,128,892
1994,14540,1909,2127,36443,35824,263,12.5,202,9.6,5930,1647,4283,4.6,16.6,4691,1529,3162,4.3,13.1,1239,3.5,26.2,0,135,135,819
1995,14540,1975,2213,38276,37331,255,11.8,158,7.3,6961,2602,4359,7,18.6,5070,1206,3864,3.2,13.6,1891,5,27.2,0,102,102,626
1996,14540,2034,2274,39087,38670,270,12,205,9.1,6446,2649,3797,6.9,16.7,5612,1296,4316,3.4,14.5,834,2.2,29,0,136,136,743
1997,14540,2079,2313,40643,39883,297,12.9,257,11.2,7757,3056,4701,7.7,19.4,6236,2196,4040,5.5,15.6,1521,3.8,31.2,0,148,148,843
1998,14540,2104,2342,41019,40815,276,11.9,238,10.2,6613,2341,4272,5.7,16.2,6204,2361,3843,5.8,15.2,409,1,30.4,0,160,160,750
1999,14540,2119,2368,41538,41281,256,10.9,231,9.8,6424,1956,4468,4.7,15.6,5909,2141,3768,5.2,14.3,515,1.3,28.6,0,150,150,721
2000,14540,2122,2375,43645,42394,243,10.2,235,9.9,7401,2558,4843,6,17.5,4899,2064,2835,4.9,11.6,2502,5.9,23.2,0,148,148,912
2001,14540,2114,2376,43227,43646,222,9.3,234,9.8,5694,2246,3448,5.1,13,6532,2114,4418,4.8,15,-838,-2,26,0,135,135,1013
2002,14540,2144,2424,43319,43204,314,13.1,261,10.9,6450,2197,4253,5.1,14.9,6220,1754,4466,4.1,14.4,230,0.5,28.8,0,151,151,693
2003,14540,2170,2472,44561,43811,261,10.7,176,7.2,6072,2100,3972,4.8,13.9,4572,1361,3211,3.1,10.4,1500,3.5,20.8,0,129,129,647
2004,14540,2202,2501,45306,44622,262,10.6,200,8.1,6384,2382,4002,5.3,14.3,5016,1572,3444,3.5,11.2,1368,3.1,22.4,0,137,137,1169
2005,14540,2259,2583,47336,46372,284,11.2,186,7.3,6614,2473,4141,5.3,14.3,4686,973,3713,2.1,10.1,1928,4.2,20.2,0,138,138,676
2006,14540,2254,2593,48663,47845,271,10.5,238,9.2,6888,2834,4054,5.9,14.4,5251,1868,3383,3.9,11,1637,3.4,22,0,166,166,1223
2007,14540,2299,2648,49130,48821,302,11.6,241,9.2,7142,2488,4654,5.1,14.6,6524,2440,4084,5,13.4,618,1.2,26.8,0,163,164,1460
2008,14540,2276,2636,49956,49280,221,8.4,213,8.1,6926,2958,3968,6,14.1,5574,1172,4402,2.4,11.3,1352,2.8,22.6,0,161,161,783
2009,14540,2216,2560,46681,47909,216,8.3,261,10.1,4799,2084,2715,4.3,10,7255,1479,5776,3.1,15.1,-2456,-5.1,20,0,172,172,893
2010,14540,2229,2590,45918,46011,250,9.7,202,7.9,5744,1809,3935,3.9,12.5,5929,2091,3838,4.5,12.9,-185,-0.4,25,0,141,145,1306
2011,14540,2220,2592,46186,45886,223,8.6,187,7.2,5111,1499,3612,3.3,11.1,4511,1453,3058,3.2,9.8,600,1.3,19.6,0,139,139,614
2012,14540,2271,2649,47994,47060,244,9.3,199,7.6,6138,2071,4067,4.4,13,4269,1105,3164,2.3,9.1,1869,3.9,18.2,0,111,111,440
2013,14540,2339,2714,49442,48684,269,10.1,202,7.6,6379,2218,4161,4.6,13.1,4862,2028,2834,4.2,10,1517,3.1,20,0,137,137,1106
2014,14540,2397,2781,50361,49702,302,11,216,7.9,6681,2369,4312,4.8,13.4,5363,1950,3413,3.9,10.8,1318,2.6,21.6,0,156,156,1587
1977,14740,1885,2011,17906,16549,469,24.7,242,12.8,5706,3418,2288,20.7,34.5,2991,1776,1215,10.7,18.1,2715,16.4,36.2,0,162,163,996
1978,14740,2005,2142,20491,19192,433,20.9,300,14.4,5559,2154,3405,11.2,29,2960,1549,1411,8.1,15.4,2599,13.6,30.8,0,195,196,890
1979,14740,2120,2253,20893,20672,450,20.5,324,14.7,5062,2117,2945,10.2,24.5,4619,2695,1924,13,22.3,443,2.2,44.6,0,214,219,1435
1980,14740,2135,2269,22346,21591,367,16.2,338,15,5668,2128,3540,9.9,26.3,4158,1698,2460,7.9,19.3,1510,7,38.6,0,237,237,1009
1981,14740,2118,2255,21752,21875,369,16.4,351,15.6,4802,2247,2555,10.3,22,5048,2233,2815,10.2,23.1,-246,-1.1,44,0,226,226,1156
1982,14740,2189,2362,21759,21755,424,18.4,285,12.3,4265,2439,1826,11.2,19.6,4257,1177,3080,5.4,19.6,8,0,39.2,0,160,160,702
1983,14740,2236,2418,21985,21828,336,14.1,301,12.6,4231,1717,2514,7.9,19.4,3916,1655,2261,7.6,17.9,315,1.5,35.8,0,218,218,1008
1984,14740,2395,2585,23735,22781,416,16.6,253,10.1,4958,2234,2724,9.8,21.8,3050,1308,1742,5.7,13.4,1908,8.4,26.8,0,171,171,739
1985,14740,2527,2725,33221,28735,439,16.5,301,11.3,13541,10932,2609,38,47.1,4569,1502,3067,5.2,15.9,8972,31.2,31.8,0,196,200,996
1986,14740,2641,2861,27134,30116,505,18.1,335,12,6563,2997,3566,10,21.8,12527,1850,10677,6.1,41.6,-5964,-19.8,43.6,0,217,219,1223
1987,14740,2677,2921,28184,27613,482,16.7,393,13.6,5920,2594,3326,9.4,21.4,4778,2188,2590,7.9,17.3,1142,4.1,34.6,0,262,262,1431
1988,14740,2732,2999,29458,28459,439,14.9,336,11.4,6978,3365,3613,11.8,24.5,4979,1435,3544,5,17.5,1999,7,35,0,227,227,751
1989,14740,2325,2610,39566,34492,403,14.4,803,28.6,18560,2839,15721,8.2,53.8,8412,5725,2687,16.6,24.4,10148,29.4,48.8,0,240,240,1403
1990,14740,3006,3318,34980,37199,971,32.8,246,8.3,12130,7623,4507,20.5,32.6,16568,1691,14877,4.5,44.5,-4438,-11.9,65.2,0,159,159,776
1991,14740,3194,3535,36542,35699,577,16.9,352,10.3,7624,3748,3876,10.5,21.4,5937,1735,4202,4.9,16.6,1687,4.8,33.2,0,221,221,1057
1992,14740,3360,3756,38826,37717,634,17.4,395,10.8,8601,3767,4834,10,22.8,6382,2611,3771,6.9,16.9,2219,5.9,33.8,0,246,247,1473
1993,14740,3489,3895,39858,39315,553,14.5,400,10.5,7361,3173,4188,8.1,18.7,6274,2293,3981,5.8,16,1087,2.7,32,0,266,266,1263
1994,14740,3604,4012,41099,40404,614,15.5,461,11.7,7180,3000,4180,7.4,17.8,5790,2104,3686,5.2,14.3,1390,3.5,28.6,0,316,317,1324
1995,14740,3633,4054,42368,41679,579,14.4,502,12.5,7897,3083,4814,7.4,18.9,6518,2562,3956,6.1,15.6,1379,3.3,31.2,0,348,348,1590
1996,14740,3717,4156,42833,42559,615,15,503,12.3,7853,3491,4362,8.2,18.5,7305,3195,4110,7.5,17.2,548,1.3,34.4,0,330,330,1782
1997,14740,3772,4236,43386,43073,667,15.9,575,13.7,9043,3993,5050,9.3,21,8416,3080,5336,7.2,19.5,627,1.5,39,0,334,334,1404
1998,14740,3889,4357,44176,43728,618,14.4,487,11.3,7687,2584,5103,5.9,17.6,6791,2414,4377,5.5,15.5,896,2.1,31,0,310,310,1450
1999,14740,3967,4440,46916,45541,629,14.3,528,12,9387,4897,4490,10.8,20.6,6636,2673,3963,5.9,14.6,2751,6,29.2,0,345,345,1447
2000,14740,4055,4533,49622,48281,600,13.4,509,11.3,9536,3723,5813,7.7,19.8,6854,2661,4193,5.5,14.2,2682,5.6,28.4,0,302,302,1055
2001,14740,4156,4674,49648,49676,654,14.2,546,11.8,9265,4792,4473,9.6,18.7,9321,3404,5917,6.9,18.8,-56,-0.1,37.4,0,286,286,1470
2002,14740,4242,4768,51456,50482,740,15.7,628,13.3,10845,5843,5002,11.6,21.5,8897,3760,5137,7.4,17.6,1948,3.9,35.2,0,355,355,1644
2003,14740,4284,4811,52183,51452,644,13.5,504,10.6,8875,3081,5794,6,17.2,7412,2648,4764,5.1,14.4,1463,2.8,28.8,0,349,349,1542
2004,14740,4357,4874,55156,53415,633,13.1,535,11.1,9778,3774,6004,7.1,18.3,6296,2294,4002,4.3,11.8,3482,6.5,23.6,0,347,347,1451
2005,14740,4531,5076,56453,55537,729,14.7,472,9.5,9105,3926,5179,7.1,16.4,7273,2155,5118,3.9,13.1,1832,3.3,26.2,0,325,325,1368
2006,14740,4636,5220,59650,57908,726,14.1,544,10.6,11348,5014,6334,8.7,19.6,7863,2680,5183,4.6,13.6,3485,6,27.2,0,369,369,1831
2007,14740,4773,5365,60496,60014,695,13.1,571,10.8,10592,3205,7387,5.3,17.6,9628,2911,6717,4.9,16,964,1.6,32,0,383,385,1729
2008,14740,4733,5322,60790,60558,577,10.8,580,10.9,8323,2515,5808,4.2,13.7,7858,2314,5544,3.8,13,465,0.7,26,0,393,393,1672
2009,14740,4419,4995,56966,58693,412,8,671,13,6415,2141,4274,3.6,10.9,9868,2652,7216,4.5,16.8,-3453,-5.9,21.8,0,450,450,1670
2010,14740,4340,4918,56077,56353,492,10,531,10.7,7533,3560,3973,6.3,13.4,8084,2674,5410,4.7,14.3,-551,-0.9,26.8,0,347,347,1674
2011,14740,4203,4788,55034,55442,447,9.2,550,11.4,6842,1888,4954,3.4,12.3,7657,2567,5090,4.6,13.8,-815,-1.5,24.6,0,363,363,1910
2012,14740,4228,4809,55578,55452,504,10.5,485,10.1,8217,2504,5713,4.5,14.8,7964,2534,5430,4.6,14.4,253,0.4,28.8,0,279,280,1276
2013,14740,4269,4852,57230,56403,496,10.3,478,9.9,8254,3189,5065,5.7,14.6,6599,2359,4240,4.2,11.7,1655,2.9,23.4,0,307,307,1593
2014,14740,4267,4841,56554,56754,497,10.3,479,9.9,7527,2102,5425,3.7,13.3,7927,3585,4342,6.3,14,-400,-0.7,26.6,0,325,325,1198
1977,14860,16087,17722,301782,286341,2744,15.9,1833,10.6,63256,20827,42429,7.3,22.1,32373,12819,19554,4.5,11.3,30883,10.8,22.6,0,1202,1208,7290
1978,14860,16575,18281,309086,305427,2411,13.4,1837,10.2,55495,16129,39366,5.3,18.2,48177,16427,31750,5.4,15.8,7318,2.4,31.6,0,1232,1234,5122
1979,14860,17094,18847,330411,319601,2480,13.4,1821,9.8,59799,20080,39719,6.3,18.7,38179,14278,23901,4.5,11.9,21620,6.8,23.8,0,1262,1264,5846
1980,14860,17323,19142,347144,338512,2281,12,1915,10.1,62266,19013,43253,5.6,18.4,45002,14836,30166,4.4,13.3,17264,5.1,26.6,0,1322,1325,6539
1981,14860,17035,18791,348617,346413,2220,11.7,2411,12.7,57639,20342,37297,5.9,16.6,53231,20251,32980,5.8,15.4,4408,1.2,30.8,0,1363,1364,7323
1982,14860,17526,19542,368711,358712,2742,14.3,1866,9.7,71023,31803,39220,8.9,19.8,51025,16018,35007,4.5,14.2,19998,5.6,28.4,0,1063,1063,7476
1983,14860,18051,20102,359374,364141,2325,11.7,1910,9.6,55271,19519,35752,5.4,15.2,64805,15027,49778,4.1,17.8,-9534,-2.6,30.4,0,1214,1216,6446
1984,14860,18667,20721,369694,364453,2541,12.5,1931,9.5,64011,23183,40828,6.4,17.6,53528,20990,32538,5.8,14.7,10483,2.9,29.4,0,1228,1232,7844
1985,14860,19271,21320,385429,378892,2685,12.8,2093,10,64152,19121,45031,5,16.9,51078,20788,30290,5.5,13.5,13074,3.4,27,0,1343,1343,7583
1986,14860,19940,22001,391421,388276,2973,13.7,2224,10.3,65697,24744,40953,6.4,16.9,59407,20149,39258,5.2,15.3,6290,1.6,30.6,0,1415,1415,9413
1987,14860,20560,22845,402407,397145,3548,15.8,2601,11.6,72422,31169,41253,7.8,18.2,61898,23864,38034,6,15.6,10524,2.6,31.2,0,1679,1682,11688
1988,14860,20922,23386,407152,403276,3233,14,2600,11.3,86507,41145,45362,10.2,21.5,78757,37277,41480,9.2,19.5,7750,2,39,0,1729,1729,9175
1989,14860,21150,23670,417208,412770,2947,12.5,2668,11.3,77798,29754,48044,7.2,18.8,68922,27112,41810,6.6,16.7,8876,2.1,33.4,0,1746,1752,13025
1990,14860,21131,23718,412480,413191,2738,11.6,2511,10.6,65844,23429,42415,5.7,15.9,67267,20572,46695,5,16.3,-1423,-0.4,31.8,0,1691,1700,11074
1991,14860,20835,23476,410241,411194,2638,11.2,2868,12.2,71649,30237,41412,7.4,17.4,73554,25078,48476,6.1,17.9,-1905,-0.5,34.8,0,1810,1824,11995
1992,14860,20581,23286,403396,406879,2637,11.3,2665,11.4,64282,20818,43464,5.1,15.8,71248,21665,49583,5.3,17.5,-6966,-1.7,31.6,0,1680,1701,10387
1993,14860,20645,23264,405550,404027,2496,10.7,2455,10.6,73136,19228,53908,4.8,18.1,70090,17028,53062,4.2,17.3,3046,0.8,34.6,0,1567,1574,7868
1994,14860,20868,23523,394650,399725,2694,11.5,2347,10,63556,20915,42641,5.2,15.9,73706,27655,46051,6.9,18.4,-10150,-2.5,31.8,0,1505,1505,18829
1995,14860,21257,23973,396924,395315,2761,11.6,2231,9.4,58579,19404,39175,4.9,14.8,55360,14801,40559,3.7,14,3219,0.8,28,0,1428,1433,7149
1996,14860,21479,24232,410609,404393,2628,10.9,2342,9.7,66765,24991,41774,6.2,16.5,54333,19482,34851,4.8,13.4,12432,3.1,26.8,0,1516,1516,10378
1997,14860,21653,24540,423392,417312,2814,11.5,2517,10.3,75178,24110,51068,5.8,18,63017,22826,40191,5.5,15.1,12161,2.9,30.2,0,1495,1495,9900
1998,14860,21833,24689,424791,423848,2739,11.1,2534,10.3,69958,25471,44487,6,16.5,68071,23870,44201,5.6,16.1,1887,0.4,32.2,0,1524,1524,10944
1999,14860,21890,24830,435173,429856,2578,10.4,2412,9.7,70277,21650,48627,5,16.3,59642,22322,37320,5.2,13.9,10635,2.4,27.8,0,1541,1541,9740
2000,14860,21924,24958,441931,439076,2623,10.5,2522,10.1,67471,21489,45982,4.9,15.4,61761,22098,39663,5,14.1,5710,1.3,28.2,0,1560,1560,8220
2001,14860,21852,25263,466387,455667,2724,10.8,2592,10.3,81690,30572,51118,6.7,17.9,60250,21042,39208,4.6,13.2,21440,4.7,26.4,0,1504,1504,8983
2002,14860,21589,24871,465742,463231,2810,11.2,3138,12.5,84206,32653,51553,7,18.2,79184,27238,51946,5.9,17.1,5022,1.1,34.2,0,1514,1515,9567
2003,14860,21472,24717,463941,461342,2574,10.4,2361,9.6,67702,20933,46769,4.5,14.7,62503,20459,42044,4.4,13.5,5199,1.2,27,0,1465,1465,8950
2004,14860,21535,24947,457794,459368,2698,10.9,2232,9,61689,19564,42125,4.3,13.4,64839,19832,45007,4.3,14.1,-3150,-0.7,26.8,0,1396,1398,8532
2005,14860,21757,25172,446386,450988,2828,11.3,2419,9.7,67390,29372,38018,6.5,14.9,76595,34708,41887,7.7,17,-9205,-2.1,29.8,0,1460,1460,14379
2006,14860,21847,25385,455851,449248,2733,10.8,2337,9.3,65104,21856,43248,4.9,14.5,51897,17334,34563,3.9,11.6,13207,2.9,23.2,0,1598,1598,11731
2007,14860,21667,25349,441382,448256,2662,10.5,2624,10.4,69976,28132,41844,6.3,15.6,83724,22464,61260,5,18.7,-13748,-3.1,31.2,0,1603,1614,8276
2008,14860,21512,25294,459421,447903,2515,10,2373,9.4,82667,26655,56012,6,18.5,59631,18689,40942,4.2,13.3,23036,5.2,26.6,0,1598,1599,11558
2009,14860,20720,24494,419723,438315,2036,8.2,2610,10.5,50277,18705,31572,4.3,11.5,87461,21794,65667,5,20,-37184,-8.5,23,0,1708,1709,12147
2010,14860,20293,24030,404761,410462,2044,8.5,2345,9.7,42285,14366,27919,3.5,10.3,53686,14797,38889,3.6,13.1,-11401,-2.8,20.6,0,1494,1497,8171
2011,14860,20020,23761,409102,406245,2093,8.8,2267,9.5,52532,17934,34598,4.4,12.9,46817,16002,30815,3.9,11.5,5715,1.4,23,0,1431,1431,8028
2012,14860,20211,23977,427857,418107,2352,9.9,2108,8.8,66886,18503,48383,4.4,16,47385,14746,32639,3.5,11.3,19501,4.7,22.6,0,1253,1268,6699
2013,14860,20246,24029,428129,427598,2211,9.2,2173,9.1,48819,16039,32780,3.8,11.4,47756,16886,30870,3.9,11.2,1063,0.2,22.4,0,1282,1287,9377
2014,14860,20165,24024,425227,425991,2216,9.2,2082,8.7,48117,15728,32389,3.7,11.3,49644,14294,35350,3.4,11.7,-1527,-0.4,22.6,0,1360,1363,7797
1977,15180,2937,3300,38573,39150,590,17.9,544,16.5,7768,4051,3717,10.3,19.8,8921,3179,5742,8.1,22.8,-1153,-3,39.6,0,399,400,2012
1978,15180,2787,3141,41012,39745,482,15,609,18.9,9967,3344,6623,8.4,25.1,7432,5215,2217,13.1,18.7,2535,6.4,37.4,0,379,381,2384
1979,15180,3058,3435,46640,43866,544,16.5,282,8.6,11112,4807,6305,11,25.3,5564,1909,3655,4.4,12.7,5548,12.6,25.4,0,9,9,27
1980,15180,2363,2781,43473,43840,193,6.2,501,16.1,6866,1650,5216,3.8,15.7,7599,3443,4156,7.9,17.3,-733,-1.6,31.4,0,387,389,2273
1981,15180,3231,3638,50043,48173,674,21.1,295,9.2,10018,4631,5387,9.6,20.8,6277,2547,3730,5.3,13,3741,7.8,26,0,130,130,964
1982,15180,3481,3975,55195,52374,772,20.3,393,10.3,12765,6134,6631,11.7,24.4,7123,2564,4559,4.9,13.6,5642,10.8,27.2,0,250,250,1565
1983,15180,3579,4052,50108,52446,575,14.3,512,12.8,9787,4140,5647,7.9,18.7,14463,5062,9401,9.7,27.6,-4676,-8.9,37.4,0,334,334,1909
1984,15180,3504,4010,50804,50411,528,13.1,567,14.1,10304,4379,5925,8.7,20.4,9517,3668,5849,7.3,18.9,787,1.5,37.8,0,388,389,1979
1985,15180,3537,4039,54037,52836,520,12.9,499,12.4,10495,4098,6397,7.8,19.9,8092,3236,4856,6.1,15.3,2403,4.6,30.6,0,325,326,1813
1986,15180,3569,4102,53576,53628,576,14.2,488,12,10032,4420,5612,8.2,18.7,10135,3321,6814,6.2,18.9,-103,-0.2,37.4,0,337,337,2128
1987,15180,3556,4101,52724,53263,601,14.6,584,14.2,9273,3921,5352,7.4,17.4,10350,4160,6190,7.8,19.4,-1077,-2,34.8,0,363,369,2128
1988,15180,3534,4099,53707,53075,537,13.1,522,12.8,10355,3672,6683,6.9,19.5,9090,3493,5597,6.6,17.1,1265,2.4,34.2,0,326,326,1982
1989,15180,3565,4150,57547,55436,542,13.1,483,11.7,12314,5672,6642,10.2,22.2,8091,3286,4805,5.9,14.6,4223,7.6,29.2,0,295,302,1613
1990,15180,3660,4274,58325,57890,550,13.1,406,9.6,9234,3532,5702,6.1,16,8364,2559,5805,4.4,14.4,870,1.6,28.8,0,292,293,1460
1991,15180,3778,4423,60753,59296,583,13.4,450,10.4,13176,6161,7015,10.4,22.2,10261,3606,6655,6.1,17.3,2915,4.9,34.6,0,267,268,2145
1992,15180,3920,4636,65156,63017,689,15.2,468,10.3,14521,7160,7361,11.4,23,10243,2760,7483,4.4,16.3,4278,6.7,32.6,0,321,324,1629
1993,15180,4001,4719,69238,67120,597,12.8,507,10.8,13719,4977,8742,7.4,20.4,9482,3704,5778,5.5,14.1,4237,6.3,28.2,0,325,325,2147
1994,15180,4104,4853,70551,69763,612,12.8,439,9.2,10615,4380,6235,6.3,15.2,9039,2856,6183,4.1,13,1576,2.2,26,0,313,313,1674
1995,15180,4204,4979,71668,70875,591,12,451,9.2,10808,5026,5782,7.1,15.2,9222,3157,6065,4.5,13,1586,2.2,26,0,322,327,2160
1996,15180,4245,5008,74025,73011,589,11.8,537,10.8,11439,5043,6396,6.9,15.7,9410,3517,5893,4.8,12.9,2029,2.8,25.8,0,355,355,2021
1997,15180,4315,5080,75396,74741,652,12.9,573,11.3,13536,5385,8151,7.2,18.1,12226,3330,8896,4.5,16.4,1310,1.7,32.8,0,364,364,1971
1998,15180,4311,5105,79579,77397,616,12.1,579,11.4,14537,4553,9984,5.9,18.8,10172,4054,6118,5.2,13.1,4365,5.7,26.2,0,396,396,2356
1999,15180,4353,5188,83082,81161,593,11.5,495,9.6,13456,4659,8797,5.7,16.6,9614,3603,6011,4.4,11.8,3842,4.8,23.6,0,332,332,1762
2000,15180,4333,5154,85234,84390,564,10.9,598,11.6,14425,5076,9349,6,17.1,12737,4249,8488,5,15.1,1688,2,30.2,0,335,335,1354
2001,15180,4458,5322,87815,86617,647,12.3,533,10.2,14553,5593,8960,6.5,16.8,12157,4808,7349,5.6,14,2396,2.8,28,0,308,308,1680
2002,15180,4551,5441,88159,88003,765,14.2,651,12.1,19540,11787,7753,13.4,22.2,19228,8721,10507,9.9,21.8,312,0.4,43.6,0,324,324,1592
2003,15180,4630,5542,93596,89970,697,12.7,511,9.3,17554,5184,12370,5.8,19.5,10302,3359,6943,3.7,11.5,7252,8,23,0,363,363,2014
2004,15180,4627,5568,93373,92920,648,11.7,565,10.2,15624,6337,9287,6.8,16.8,14718,6042,8676,6.5,15.8,906,1,31.6,0,398,398,2812
2005,15180,4723,5708,90806,90786,693,12.3,506,9,16748,7390,9358,8.1,18.4,16707,7437,9270,8.2,18.4,41,0,36.8,0,375,376,6380
2006,15180,4723,5757,94090,92101,654,11.4,553,9.7,15144,4873,10271,5.3,16.4,11165,3145,8020,3.4,12.1,3979,4.3,24.2,0,365,365,1592
2007,15180,4758,5862,97520,95650,713,12.3,581,10,17397,7003,10394,7.3,18.2,13657,5181,8476,5.4,14.3,3740,3.9,28.6,0,366,368,2372
2008,15180,4764,5882,100452,98462,598,10.2,504,8.6,15280,5250,10030,5.3,15.5,11300,3662,7638,3.7,11.5,3980,4,23,0,388,388,2766
2009,15180,4695,5816,98304,99179,527,9,557,9.6,14607,7059,7548,7.1,14.7,16356,4026,12330,4.1,16.5,-1749,-1.8,29.4,0,391,391,2131
2010,15180,4676,5839,98458,97923,578,10,511,8.8,13822,6196,7626,6.3,14.1,12752,4422,8330,4.5,13,1070,1.1,26,0,359,359,2081
2011,15180,4629,5773,99496,98883,513,8.9,553,9.6,14051,4957,9094,5,14.2,12825,3578,9247,3.6,13,1226,1.2,26,0,377,381,1809
2012,15180,4642,5800,103033,101803,564,9.8,524,9.1,13389,4692,8697,4.6,13.2,10928,3455,7473,3.4,10.7,2461,2.5,21.4,0,326,328,2282
2013,15180,4666,5814,103163,103072,524,9,514,8.9,13684,4059,9625,3.9,13.3,13501,4583,8918,4.4,13.1,183,0.2,26.2,0,324,326,1982
2014,15180,4704,5866,103157,102307,541,9.3,442,7.6,14684,5316,9368,5.2,14.4,12983,2928,10055,2.9,12.7,1701,1.7,25.4,0,322,324,1833
1977,15260,1324,1442,19282,18651,277,19.3,254,17.7,4437,2458,1979,13.2,23.8,3175,1819,1356,9.8,17,1262,6.8,34,0,166,166,1366
1978,15260,1397,1520,20847,20062,284,19.2,203,13.7,4170,1918,2252,9.6,20.8,2600,1104,1496,5.5,13,1570,7.8,26,0,139,140,697
1979,15260,1437,1558,21875,21343,248,16.1,205,13.3,3930,1586,2344,7.4,18.4,2866,1163,1703,5.4,13.4,1064,5,26.8,0,163,163,637
1980,15260,1441,1564,21923,21915,221,14.2,204,13.1,4019,1695,2324,7.7,18.3,4003,1530,2473,7,18.3,16,0,36.6,0,159,159,889
1981,15260,1382,1499,20822,20981,201,13.2,232,15.2,4030,1437,2593,6.8,19.2,4348,2128,2220,10.1,20.7,-318,-1.5,38.4,0,143,145,918
1982,15260,1411,1559,23950,22368,260,17,183,12,7081,2487,4594,11.1,31.7,3917,1586,2331,7.1,17.5,3164,14.2,35,0,105,105,835
1983,15260,1452,1599,20426,21890,196,12.4,169,10.7,3817,1590,2227,7.3,17.4,6745,3355,3390,15.3,30.8,-2928,-13.4,34.8,0,119,119,687
1984,15260,1537,1674,22907,21676,281,17.2,209,12.8,5325,2053,3272,9.5,24.6,2862,1304,1558,6,13.2,2463,11.4,26.4,0,129,130,690
1985,15260,1603,1748,24667,24080,284,16.6,212,12.4,5239,2181,3058,9.1,21.8,4064,1343,2721,5.6,16.9,1175,4.9,33.8,0,151,152,945
1986,15260,1707,1864,24957,24780,343,19,221,12.2,4910,2369,2541,9.6,19.8,4555,1770,2785,7.1,18.4,355,1.4,36.8,0,152,152,1189
1987,15260,1743,1925,25445,25267,340,17.9,268,14.1,5381,2460,2921,9.7,21.3,5026,2220,2806,8.8,19.9,355,1.4,39.8,0,182,183,973
1988,15260,1763,1950,26206,25378,269,13.9,226,11.7,5387,2330,3057,9.2,21.2,3732,1223,2509,4.8,14.7,1655,6.5,29.4,0,156,156,560
1989,15260,1816,2009,27563,26906,268,13.5,215,10.9,5372,2028,3344,7.5,20,4057,1511,2546,5.6,15.1,1315,4.9,30.2,0,151,151,1109
1990,15260,1820,2015,27243,27395,244,12.1,233,11.6,4301,1807,2494,6.6,15.7,4605,1646,2959,6,16.8,-304,-1.1,31.4,0,162,162,769
1991,15260,1836,2042,26275,26703,269,13.3,238,11.7,3992,1578,2414,5.9,14.9,4847,1474,3373,5.5,18.2,-855,-3.3,29.8,0,156,156,945
1992,15260,1820,2018,27325,26792,221,10.9,235,11.6,4917,1487,3430,5.6,18.4,3850,1304,2546,4.9,14.4,1067,4,28.8,0,144,150,730
1993,15260,1856,2069,28022,27647,264,12.9,200,9.8,4709,1889,2820,6.8,17,3960,1846,2114,6.7,14.3,749,2.7,28.6,0,146,146,733
1994,15260,1972,2176,27862,27935,303,14.3,192,9,4486,1561,2925,5.6,16.1,4632,1815,2817,6.5,16.6,-146,-0.5,32.2,0,123,124,972
1995,15260,2011,2236,29586,28694,285,12.9,210,9.5,4866,1921,2945,6.7,17,3081,1192,1889,4.2,10.7,1785,6.3,21.4,0,143,144,766
1996,15260,2102,2327,43846,36715,309,13.5,219,9.6,18988,2017,16971,5.5,51.7,4725,1935,2790,5.3,12.9,14263,38.8,25.8,0,153,153,824
1997,15260,2179,2414,31191,37517,323,13.6,236,9.9,5577,2412,3165,6.4,14.9,18229,,2970,,48.6,-12652,-33.7,29.8,1,141,141,
1998,15260,2212,2455,32608,31886,342,14,290,11.9,6473,3417,3056,10.7,20.3,5029,2055,2974,6.4,15.8,1444,4.5,31.6,0,192,192,1342
1999,15260,2202,2455,33582,32994,322,13.1,311,12.7,6462,2899,3563,8.8,19.6,5286,2258,3028,6.8,16,1176,3.6,32,0,210,210,1051
2000,15260,2185,2441,34256,33956,300,12.3,319,13,6136,2443,3693,7.2,18.1,5535,2314,3221,6.8,16.3,601,1.8,32.6,0,187,187,1224
2001,15260,2205,2467,34013,34170,286,11.6,277,11.3,4946,1756,3190,5.1,14.5,5259,1878,3381,5.5,15.4,-313,-0.9,29,0,171,171,855
2002,15260,2258,2497,34361,34135,353,14.3,313,12.6,6226,2535,3691,7.4,18.2,5773,1809,3964,5.3,16.9,453,1.3,33.8,0,152,152,625
2003,15260,2302,2536,34306,33963,353,14.1,256,10.2,5993,2699,3294,7.9,17.6,5306,1656,3650,4.9,15.6,687,2,31.2,0,182,182,1082
2004,15260,2331,2560,34246,34001,292,11.5,234,9.2,5547,1921,3626,5.6,16.3,5056,2408,2648,7.1,14.9,491,1.4,29.8,0,161,161,1568
2005,15260,2409,2646,34710,34402,328,12.6,229,8.8,5388,2279,3109,6.6,15.7,4771,1478,3293,4.3,13.9,617,1.8,27.8,0,161,161,762
2006,15260,2475,2727,36494,35545,342,12.8,236,8.8,6047,2492,3555,7,17,4148,1398,2750,3.9,11.7,1899,5.3,23.4,0,165,165,909
2007,15260,2548,2820,36212,36177,388,14,274,9.9,5915,2625,3290,7.3,16.4,5845,2348,3497,6.5,16.2,70,0.2,32.4,0,186,186,1565
2008,15260,2544,2807,37383,36739,301,10.7,285,10.2,5845,2271,3574,6.2,15.9,4556,1451,3105,3.9,12.4,1289,3.5,24.8,0,200,200,823
2009,15260,2401,2666,34830,35972,229,8.4,344,12.6,4156,1566,2590,4.4,11.6,6439,1939,4500,5.4,17.9,-2283,-6.3,23.2,0,253,254,1406
2010,15260,2338,2602,32909,33816,243,9.3,290,11,3685,1798,1887,5.3,10.9,5499,1916,3583,5.7,16.3,-1814,-5.4,21.8,0,201,201,1176
2011,15260,2251,2514,31881,32318,222,8.7,294,11.5,3921,1604,2317,5,12.1,4794,1886,2908,5.8,14.8,-873,-2.7,24.2,0,208,208,1175
2012,15260,2245,2501,32848,32388,245,9.8,252,10.1,4657,1696,2961,5.2,14.4,3737,1715,2022,5.3,11.5,920,2.9,23,0,155,156,1012
2013,15260,2248,2511,33568,33152,234,9.4,222,8.9,4362,1597,2765,4.8,13.2,3530,1226,2304,3.7,10.6,832,2.6,21.2,0,146,146,933
2014,15260,2251,2512,34442,33946,249,9.9,236,9.4,4720,1896,2824,5.6,13.9,3727,1441,2286,4.2,11,993,2.9,22,0,156,156,964
1977,15380,18485,21483,427728,401958,2945,13.9,2369,11.2,102942,29196,73746,7.3,25.6,51401,19631,31770,4.9,12.8,51541,12.8,25.6,0,1466,1477,9312
1978,15380,18841,21696,404129,415915,2639,12.2,2446,11.3,62590,20012,42578,4.8,15,86161,21702,64459,5.2,20.7,-23571,-5.7,30,0,1490,1496,7458
1979,15380,18774,21802,421736,412548,2415,11.1,2207,10.1,67136,21663,45473,5.3,16.3,48760,16948,31812,4.1,11.8,18376,4.5,23.6,0,1565,1566,9381
1980,15380,18699,21749,415423,418416,2227,10.2,2216,10.2,55786,19957,35829,4.8,13.3,61773,20884,40889,5,14.8,-5987,-1.5,26.6,0,1526,1528,9147
1981,15380,18135,21054,397161,404046,2098,9.8,2606,12.2,49479,19106,30373,4.7,12.2,63249,24029,39220,5.9,15.7,-13770,-3.5,24.4,0,1476,1482,8204
1982,15380,18167,21415,388821,392602,2698,12.7,2169,10.2,57680,27481,30199,7,14.7,65241,18506,46735,4.7,16.6,-7561,-1.9,29.4,0,1223,1225,7608
1983,15380,18395,21657,373217,380831,2076,9.6,2013,9.3,48052,17821,30231,4.7,12.6,63279,19112,44167,5,16.6,-15227,-4,25.2,0,1288,1300,8273
1984,15380,18559,21808,381149,377121,2334,10.7,2180,10,58201,18852,39349,5,15.4,50144,17614,32530,4.7,13.3,8057,2.1,26.6,0,1342,1344,7664
1985,15380,18988,22282,402840,393766,2430,11,2045,9.3,64599,22988,41611,5.8,16.4,46451,19794,26657,5,11.8,18148,4.6,23.6,0,1308,1320,9135
1986,15380,19283,22644,415928,408914,2627,11.7,2201,9.8,66137,26167,39970,6.4,16.2,52109,19823,32286,4.8,12.7,14028,3.5,25.4,0,1346,1349,7089
1987,15380,19492,23212,429654,427191,2924,12.7,2299,10,66834,24482,42352,5.7,15.6,61907,22217,39690,5.2,14.5,4927,1.1,29,0,1460,1463,13745
1988,15380,19706,23619,441225,432419,2694,11.5,2210,9.4,70613,23638,46975,5.5,16.3,53002,16090,36912,3.7,12.3,17611,4,24.6,0,1439,1439,7286
1989,15380,20045,24084,455986,448934,2708,11.4,2264,9.5,72908,26381,46527,5.9,16.2,58805,19486,39319,4.3,13.1,14103,3.1,26.2,0,1461,1482,10271
1990,15380,20420,24636,468083,461579,2690,11,2052,8.4,69219,27195,42024,5.9,15,56210,17449,38761,3.8,12.2,13009,2.8,24.4,0,1357,1385,9198
1991,15380,20679,24990,448158,457986,2655,10.7,2254,9.1,58260,25888,32372,5.7,12.7,77916,24395,53521,5.3,17,-19656,-4.3,25.4,0,1350,1380,10028
1992,15380,20628,24943,456475,452894,2539,10.2,2491,10,70869,24770,46099,5.5,15.6,63708,22007,41701,4.9,14.1,7161,1.5,28.2,0,1559,1638,13322
1993,15380,20707,24993,447979,451963,2244,9,2164,8.7,59688,20916,38772,4.6,13.2,67657,17471,50186,3.9,15,-7969,-1.8,26.4,0,1385,1389,7259
1994,15380,20689,24960,452839,449990,2287,9.2,2232,8.9,59553,20521,39032,4.6,13.2,53855,16178,37677,3.6,12,5698,1.2,24,0,1468,1474,7736
1995,15380,20718,24946,457994,454871,2343,9.4,2306,9.2,60129,21305,38824,4.7,13.2,53882,16989,36893,3.7,11.8,6247,1.4,23.6,0,1488,1497,7757
1996,15380,20696,24897,460309,459233,2345,9.4,2344,9.4,59681,19765,39916,4.3,13,57529,20558,36971,4.5,12.5,2152,0.5,25,0,1526,1526,8305
1997,15380,20518,24646,462320,461617,2385,9.6,2649,10.7,65728,24917,40811,5.4,14.2,64321,24340,39981,5.3,13.9,1407,0.3,27.8,0,1602,1602,9118
1998,15380,20331,24495,464940,463249,2296,9.3,2401,9.8,61419,20536,40883,4.4,13.3,58037,19334,38703,4.2,12.5,3382,0.8,25,0,1573,1573,8849
1999,15380,20049,24328,466209,470025,2138,8.8,2287,9.4,63629,24091,39538,5.1,13.5,71260,25977,45283,5.5,15.2,-7631,-1.7,27,0,1465,1465,12538
2000,15380,19825,24133,469295,466440,2137,8.8,2313,9.5,67936,25353,42583,5.4,14.6,62226,25109,37117,5.4,13.3,5710,1.3,26.6,0,1361,1361,9586
2001,15380,19942,24664,468761,470730,2518,10.3,2196,9,66222,27243,38979,5.8,14.1,70160,20470,49690,4.3,14.9,-3938,-0.8,28.2,0,1311,1316,7866
2002,15380,19761,24488,468158,467913,2564,10.4,2677,10.9,71288,32823,38465,7,15.2,70797,24964,45833,5.3,15.1,491,0.1,30.2,0,1325,1327,9001
2003,15380,19888,24687,469605,466287,2427,9.9,1893,7.7,61862,22390,39472,4.8,13.3,55225,15401,39824,3.3,11.8,6637,1.5,23.6,0,1272,1272,8566
2004,15380,19808,24597,471157,467183,2119,8.6,1992,8.1,62073,18720,43353,4,13.3,54125,17883,36242,3.8,11.6,7948,1.7,23.2,0,1312,1319,10292
2005,15380,19923,24705,468976,467609,2283,9.3,2004,8.1,59819,24973,34846,5.3,12.8,57084,18345,38739,3.9,12.2,2735,0.6,24.4,0,1351,1351,10844
2006,15380,19783,24754,471948,469671,2311,9.4,2069,8.4,62278,25628,36650,5.5,13.3,57723,22411,35312,4.8,12.3,4555,1,24.6,0,1489,1489,14235
2007,15380,19848,24687,471195,470748,2391,9.7,2381,9.6,65100,22338,42762,4.7,13.8,64206,24142,40064,5.1,13.6,894,0.2,27.2,0,1290,1297,8260
2008,15380,19791,24740,476594,471054,2108,8.6,1869,7.6,63459,19411,44048,4.1,13.5,52379,14162,38217,3,11.1,11080,2.4,22.2,0,1308,1311,8102
2009,15380,19536,24445,466270,470064,1849,7.5,2012,8.2,50999,13894,37105,3,10.8,58586,14460,44126,3.1,12.5,-7587,-1.7,21.6,0,1311,1323,8181
2010,15380,19528,24443,460954,463043,1880,7.7,1783,7.3,47191,14223,32968,3.1,10.2,51369,11102,40267,2.4,11.1,-4178,-0.9,20.4,0,1171,1174,7134
2011,15380,19351,24333,469346,464558,1919,7.9,1882,7.7,55447,14852,40595,3.2,11.9,45871,14491,31380,3.1,9.9,9576,2,19.8,0,1243,1250,10086
2012,15380,19596,24562,479048,473139,2050,8.4,1820,7.5,57189,13099,44090,2.8,12.1,45371,12254,33117,2.6,9.6,11818,2.5,19.2,0,1127,1141,6674
2013,15380,19431,24401,482562,480304,1940,7.9,2054,8.4,55350,20621,34729,4.3,11.5,50833,14638,36195,3,10.6,4517,0.9,21.2,0,1269,1278,9198
2014,15380,19430,24400,480127,479047,2091,8.6,1901,7.8,53879,17978,35901,3.8,11.2,51719,17921,33798,3.7,10.8,2160,0.4,21.6,0,1288,1295,9104
1977,15500,1747,1915,35517,35745,299,15.9,224,11.9,5220,2317,2903,6.5,14.6,5676,1678,3998,4.7,15.9,-456,-1.3,29.2,0,146,147,934
1978,15500,1801,1973,37257,36391,247,12.7,195,10,5804,1247,4557,3.4,15.9,4071,1710,2361,4.7,11.2,1733,4.7,22.4,0,143,144,606
1979,15500,1869,2051,40512,38855,283,14.1,196,9.7,7324,3122,4202,8,18.8,4010,1366,2644,3.5,10.3,3314,8.5,20.6,0,136,136,976
1980,15500,1880,2055,40461,40474,231,11.3,216,10.5,5404,1812,3592,4.5,13.4,5429,2076,3353,5.1,13.4,-25,0,26.8,0,154,154,1387
1981,15500,1844,2013,40247,40020,251,12.4,280,13.8,5785,2197,3588,5.5,14.5,5331,2179,3152,5.4,13.3,454,1.2,26.6,0,180,182,1114
1982,15500,1837,2037,40142,39872,282,13.9,227,11.2,5818,2863,2955,7.2,14.6,5277,2058,3219,5.2,13.2,541,1.4,26.4,0,147,147,776
1983,15500,1786,1989,39109,39359,244,12.1,268,13.3,6899,3008,3891,7.6,17.5,7398,4232,3166,10.8,18.8,-499,-1.3,35,0,154,154,1011
1984,15500,2005,2209,44846,42103,304,14.5,127,6.1,9247,2818,6429,6.7,22,3761,956,2805,2.3,8.9,5486,13.1,17.8,0,5,5,12
1985,15500,2073,2280,47036,46218,299,13.3,232,10.3,7504,1985,5519,4.3,16.2,5868,2736,3132,5.9,12.7,1636,3.5,25.4,0,150,150,1268
1986,15500,2181,2395,47815,47459,337,14.4,215,9.2,8242,2965,5277,6.2,17.4,7529,2832,4697,6,15.9,713,1.5,31.8,0,150,150,1591
1987,15500,2296,2541,48657,48305,373,15.1,227,9.2,8098,2730,5368,5.7,16.8,7393,3015,4378,6.2,15.3,705,1.5,30.6,0,144,144,874
1988,15500,2328,2585,50783,49457,344,13.4,289,11.3,8990,3846,5144,7.8,18.2,6337,3172,3165,6.4,12.8,2653,5.4,25.6,0,172,172,861
1989,15500,2358,2623,52065,51439,275,10.6,238,9.1,9612,4173,5439,8.1,18.7,8359,2828,5531,5.5,16.3,1253,2.4,32.6,0,142,142,807
1990,15500,2402,2690,52671,52499,315,11.9,228,8.6,7276,2510,4766,4.8,13.9,6932,3054,3878,5.8,13.2,344,0.7,26.4,0,165,165,2262
1991,15500,2394,2687,50715,51560,274,10.2,274,10.2,6394,2758,3636,5.3,12.4,8083,2334,5749,4.5,15.7,-1689,-3.3,24.8,0,170,170,1178
1992,15500,2397,2688,50764,50689,279,10.4,267,9.9,6858,1987,4871,3.9,13.5,6708,3073,3635,6.1,13.2,150,0.3,26.4,0,172,174,2077
1993,15500,2392,2687,50770,50786,238,8.9,242,9,6260,1942,4318,3.8,12.3,6291,1728,4563,3.4,12.4,-31,-0.1,24.6,0,169,169,929
1994,15500,2428,2733,52361,51544,271,10,219,8.1,6464,2026,4438,3.9,12.5,4830,1681,3149,3.3,9.4,1634,3.1,18.8,0,154,154,1008
1995,15500,2470,2779,54770,53531,287,10.4,238,8.6,8087,2262,5825,4.2,15.1,5609,2468,3141,4.6,10.5,2478,4.6,21,0,158,158,824
1996,15500,2534,2853,57599,56385,320,11.4,239,8.5,10098,3716,6382,6.6,17.9,7670,3432,4238,6.1,13.6,2428,4.3,27.2,0,157,157,693
1997,15500,2583,2909,57197,57387,330,11.4,274,9.5,8579,3046,5533,5.3,14.9,8958,4560,4398,7.9,15.6,-379,-0.7,29.8,0,162,162,867
1998,15500,2610,2948,57655,57420,330,11.3,277,9.5,7140,2669,4471,4.6,12.4,6669,1914,4755,3.3,11.6,471,0.8,23.2,0,192,192,961
1999,15500,2637,2976,57112,57330,308,10.4,270,9.1,7397,2672,4725,4.7,12.9,7833,2721,5112,4.7,13.7,-436,-0.8,25.8,0,175,175,1103
2000,15500,2643,3007,60224,58660,319,10.7,285,9.5,11203,5944,5259,10.1,19.1,8075,3909,4166,6.7,13.8,3128,5.3,27.6,0,172,172,1032
2001,15500,2671,3038,60386,60421,302,10,294,9.7,8849,3385,5464,5.6,14.6,8918,3185,5733,5.3,14.8,-69,-0.2,29.2,0,177,178,1127
2002,15500,2657,3040,57009,58644,324,10.7,321,10.6,7528,3510,4018,6,12.8,10797,3769,7028,6.4,18.4,-3269,-5.6,25.6,0,178,178,906
2003,15500,2661,2991,57415,56966,292,9.7,297,9.9,11278,7137,4141,12.5,19.8,10379,5266,5113,9.2,18.2,899,1.6,36.4,0,161,161,1712
2004,15500,2658,2971,57174,56969,274,9.2,270,9.1,7430,2277,5153,4,13,7019,2952,4067,5.2,12.3,411,0.7,24.6,0,184,184,1798
2005,15500,2669,3033,53672,55220,352,11.7,269,9,8425,4178,4247,7.6,15.3,11521,6619,4902,12,20.9,-3096,-5.6,30.6,0,193,193,1276
2006,15500,2668,3023,52969,52939,328,10.9,309,10.2,7697,3410,4287,6.4,14.5,7637,3195,4442,6,14.4,60,0.1,28.8,0,202,202,1016
2007,15500,2689,3075,53977,53314,348,11.4,279,9.2,8441,2918,5523,5.5,15.8,7115,2396,4719,4.5,13.3,1326,2.5,26.6,0,176,179,1052
2008,15500,2664,3053,53646,53527,305,10,292,9.6,6811,2637,4174,4.9,12.7,6572,2157,4415,4,12.3,239,0.4,24.6,0,216,216,1232
2009,15500,2592,2979,50403,51495,249,8.3,295,9.8,5848,2879,2969,5.6,11.4,8031,1854,6177,3.6,15.6,-2183,-4.2,22.8,0,205,205,1039
2010,15500,2523,2931,48217,49133,237,8,262,8.9,4685,1949,2736,4,9.5,6517,2377,4140,4.8,13.3,-1832,-3.8,19,0,189,189,1719
2011,15500,2500,2930,51179,49610,247,8.4,227,7.8,7533,2304,5229,4.6,15.2,4395,1472,2923,3,8.9,3138,6.3,17.8,0,153,153,1136
2012,15500,2510,2945,51752,51395,245,8.4,226,7.7,6424,2412,4012,4.7,12.5,5709,1903,3806,3.7,11.1,715,1.4,22.2,0,132,132,667
2013,15500,2493,2936,51891,51762,224,7.7,223,7.6,5225,1938,3287,3.7,10.1,4966,1533,3433,3,9.6,259,0.5,19.2,0,153,153,973
2014,15500,2473,2912,51972,51813,230,7.9,231,7.9,5218,1714,3504,3.3,10.1,4900,1591,3309,3.1,9.5,318,0.6,19,0,159,159,943
1977,15540,2765,2993,44965,42830,511,17.6,315,10.9,9198,3208,5990,7.5,21.5,4928,2222,2706,5.2,11.5,4270,10,23,0,208,208,1246
1978,15540,2957,3204,47406,46187,547,17.7,335,10.8,11339,4813,6526,10.4,24.6,8901,6175,2726,13.4,19.3,2438,5.3,38.6,0,240,242,1098
1979,15540,3016,3282,51409,49365,466,14.4,370,11.4,10209,3507,6702,7.1,20.7,6120,2273,3847,4.6,12.4,4089,8.3,24.8,0,291,292,1780
1980,15540,3083,3362,53781,52578,446,13.4,347,10.5,8560,2419,6141,4.6,16.3,6153,1832,4321,3.5,11.7,2407,4.6,23.4,0,261,261,1003
1981,15540,3006,3282,53871,52940,432,13.1,439,13.3,7529,2313,5216,4.4,14.2,5666,2352,3314,4.4,10.7,1863,3.5,21.4,0,266,267,1251
1982,15540,3128,3453,57194,55527,570,16.9,355,10.5,10301,3502,6799,6.3,18.6,6967,2707,4260,4.9,12.5,3334,6.1,25,0,205,209,1286
1983,15540,3238,3556,55764,56604,443,12.6,370,10.6,6751,2655,4096,4.7,11.9,8430,2047,6383,3.6,14.9,-1679,-3,23.8,0,263,264,1353
1984,15540,3488,3818,60537,58169,603,16.4,339,9.2,9953,4105,5848,7.1,17.1,5217,2001,3216,3.4,9,4736,8.1,18,0,213,215,972
1985,15540,3712,4050,64593,63873,615,15.6,426,10.8,9427,3334,6093,5.2,14.8,7987,3839,4148,6,12.5,1440,2.3,25,0,285,285,1321
1986,15540,3956,4316,68048,66141,701,16.8,410,9.8,10814,4563,6251,6.9,16.3,7000,2378,4622,3.6,10.6,3814,5.7,21.2,0,271,271,1340
1987,15540,4176,4609,74274,71286,801,17.9,508,11.4,13972,5965,8007,8.4,19.6,7996,3383,4613,4.7,11.2,5976,8.4,22.4,0,368,369,2234
1988,15540,4272,4739,71929,71824,698,15,500,10.7,11360,4513,6847,6.3,15.8,11150,3576,7574,5,15.5,210,0.3,31,0,339,339,1898
1989,15540,4453,4978,76943,74552,763,15.7,537,11.1,13255,5547,7708,7.4,17.8,8472,3384,5088,4.5,11.4,4783,6.4,22.8,0,382,388,2298
1990,15540,4536,5079,76937,76836,642,12.8,506,10.1,11836,4392,7444,5.7,15.4,11633,3890,7743,5.1,15.1,203,0.3,30.2,0,377,377,2055
1991,15540,4589,5170,74817,75798,585,11.4,503,9.8,10013,4065,5948,5.4,13.2,11974,3592,8382,4.7,15.8,-1961,-2.6,26.4,0,330,331,2318
1992,15540,4586,5170,75123,74729,590,11.4,553,10.7,11166,3716,7450,5,14.9,10377,3599,6778,4.8,13.9,789,1,27.8,0,363,364,2282
1993,15540,4710,5291,77444,76136,618,11.8,497,9.5,11137,4024,7113,5.3,14.6,8520,3045,5475,4,11.2,2617,3.4,22.4,0,326,328,1501
1994,15540,4787,5375,79905,78621,592,11.1,488,9.2,11323,3722,7601,4.7,14.4,8755,3130,5625,4,11.1,2568,3.3,22.2,0,334,334,1489
1995,15540,4849,5436,80925,80396,556,10.3,483,8.9,11811,3496,8315,4.3,14.7,10752,5122,5630,6.4,13.4,1059,1.3,26.8,0,327,327,2787
1996,15540,4907,5495,79858,80314,618,11.3,547,10,12697,4941,7756,6.2,15.8,13609,8025,5584,10,16.9,-912,-1.1,31.6,0,382,382,2174
1997,15540,5019,5644,84765,82429,695,12.5,559,10,16191,8757,7434,10.6,19.6,11518,4396,7122,5.3,14,4673,5.6,28,0,366,366,2124
1998,15540,5037,5641,87531,86111,593,10.5,584,10.4,13234,4471,8763,5.2,15.4,10393,3833,6560,4.5,12.1,2841,3.3,24.2,0,390,390,2170
1999,15540,5109,5773,91685,89629,627,11,500,8.8,14196,5105,9091,5.7,15.8,10083,4001,6082,4.5,11.2,4113,4.6,22.4,0,349,349,2760
2000,15540,5141,5815,96743,94144,597,10.3,547,9.4,16213,4428,11785,4.7,17.2,11014,4336,6678,4.6,11.7,5199,5.5,23.4,0,350,350,2265
2001,15540,5161,5866,101627,99355,539,9.2,541,9.2,14541,5313,9228,5.3,14.6,9997,2973,7024,3,10.1,4544,4.5,20.2,0,331,331,1719
2002,15540,5174,5883,99738,100717,655,11.1,640,10.9,15400,7619,7781,7.6,15.3,17357,5865,11492,5.8,17.2,-1957,-1.9,30.6,0,321,321,2364
2003,15540,5202,5931,97138,98056,611,10.4,479,8.1,14159,5114,9045,5.2,14.4,15995,4580,11415,4.7,16.3,-1836,-1.9,28.8,0,318,318,2146
2004,15540,5267,6007,95502,96187,589,9.9,468,7.9,9754,3074,6680,3.2,10.1,11123,3444,7679,3.6,11.6,-1369,-1.5,20.2,0,303,303,2016
2005,15540,5328,6078,96174,95529,592,9.8,485,8,11965,4486,7479,4.7,12.5,10675,2956,7719,3.1,11.2,1290,1.3,22.4,0,329,329,2086
2006,15540,5329,6115,96705,96110,636,10.5,541,8.9,12414,4342,8072,4.5,12.9,11224,3784,7440,3.9,11.7,1190,1.2,23.4,0,362,366,2171
2007,15540,5434,6214,99561,98116,681,11.1,568,9.2,15097,6167,8930,6.3,15.4,12208,4148,8060,4.2,12.4,2889,3,24.8,0,325,329,1835
2008,15540,5411,6197,101325,100128,577,9.3,553,8.9,13522,4678,8844,4.7,13.5,11129,3480,7649,3.5,11.1,2393,2.4,22.2,0,350,350,2242
2009,15540,5219,6031,98132,99371,493,8.1,604,9.9,9638,3008,6630,3,9.7,12115,2601,9514,2.6,12.2,-2477,-2.5,19.4,0,377,377,1405
2010,15540,5221,6030,97534,97798,478,7.9,456,7.6,9558,3316,6242,3.4,9.8,10086,2190,7896,2.2,10.3,-528,-0.5,19.6,0,274,274,1292
2011,15540,5165,5945,97102,97165,460,7.7,512,8.6,9883,2370,7513,2.4,10.2,10009,3190,6819,3.3,10.3,-126,-0.1,20.4,0,326,328,1598
2012,15540,5227,6035,99021,97935,544,9.1,465,7.8,12514,3859,8655,3.9,12.8,10342,3077,7265,3.1,10.6,2172,2.2,21.2,0,272,274,1588
2013,15540,5215,6008,98008,98533,460,7.7,475,7.9,11512,2767,8745,2.8,11.7,12562,5485,7077,5.6,12.7,-1050,-1,23.4,0,274,274,4513
2014,15540,5260,6053,98837,98278,524,8.7,454,7.5,10645,2974,7671,3,10.8,9526,2923,6603,3,9.7,1119,1.1,19.4,0,302,307,2162
1977,15940,6091,6958,128707,127214,943,13.7,797,11.6,18430,7404,11026,5.8,14.5,15444,5590,9854,4.4,12.1,2986,2.4,24.2,0,524,526,3474
1978,15940,6317,7189,139662,134146,944,13.3,706,10,22339,5663,16676,4.2,16.7,11306,4794,6512,3.6,8.4,11033,8.3,16.8,0,463,465,2117
1979,15940,6338,7219,146569,143043,818,11.4,750,10.4,20812,6103,14709,4.3,14.5,13760,4835,8925,3.4,9.6,7052,4.9,19.2,0,506,507,2584
1980,15940,6431,7297,144103,145273,797,11,694,9.6,16979,5259,11720,3.6,11.7,19319,5069,14250,3.5,13.3,-2340,-1.6,23.4,0,492,492,2447
1981,15940,6210,7044,136732,138899,729,10.2,920,12.9,15997,5523,10474,4,11.5,20331,6503,13828,4.7,14.6,-4334,-3.1,23,0,528,529,2844
1982,15940,6231,7100,132622,134526,870,12.3,706,10,16414,6376,10038,4.7,12.2,20222,5527,14695,4.1,15,-3808,-2.8,24.4,0,378,378,2078
1983,15940,6311,7153,125264,128864,655,9.2,668,9.4,14037,4061,9976,3.2,10.9,21237,4176,17061,3.2,16.5,-7200,-5.6,21.8,0,405,407,2150
1984,15940,6513,7357,130233,127866,865,11.9,678,9.3,20597,5762,14835,4.5,16.1,15862,5416,10446,4.2,12.4,4735,3.7,24.8,0,409,409,2020
1985,15940,6704,7578,134301,132239,898,12,679,9.1,20017,7481,12536,5.7,15.1,15892,5816,10076,4.4,12,4125,3.1,24,0,463,466,3213
1986,15940,6856,7745,136292,135201,907,11.8,719,9.4,20436,7065,13371,5.2,15.1,18255,5284,12971,3.9,13.5,2181,1.6,27,0,476,476,2954
1987,15940,6971,7931,138516,138655,1071,13.7,852,10.9,22345,8102,14243,5.8,16.1,22624,11182,11442,8.1,16.3,-279,-0.2,32.2,0,530,530,5347
1988,15940,7013,7989,142352,140292,890,11.2,822,10.3,21156,7618,13538,5.4,15.1,17036,5102,11934,3.6,12.1,4120,3,24.2,0,479,479,2315
1989,15940,7113,8152,148856,145873,914,11.3,761,9.4,24015,9253,14762,6.3,16.5,18048,6156,11892,4.2,12.4,5967,4.1,24.8,0,505,506,2962
1990,15940,7157,8226,148566,148579,861,10.5,743,9.1,18765,6968,11797,4.7,12.6,18791,5037,13754,3.4,12.6,-26,0,25.2,0,516,522,3288
1991,15940,7226,8306,152239,150625,804,9.7,722,8.7,23089,6468,16621,4.3,15.3,19860,5670,14190,3.8,13.2,3229,2.1,26.4,0,470,475,3611
1992,15940,7295,8390,145999,147029,846,10.1,736,8.8,16353,5357,10996,3.6,11.1,18412,6114,12298,4.2,12.5,-2059,-1.4,22.2,0,450,453,2656
1993,15940,7379,8435,147837,146535,817,9.7,755,9,19088,5057,14031,3.5,13,16484,5478,11006,3.7,11.2,2604,1.8,22.4,0,499,504,2679
1994,15940,7501,8593,152068,149979,849,10,675,7.9,20172,6983,13189,4.7,13.4,15994,4802,11192,3.2,10.7,4178,2.7,21.4,0,469,469,2357
1995,15940,7664,8780,155955,153946,867,10,656,7.6,20691,7153,13538,4.6,13.4,16673,5933,10740,3.9,10.8,4018,2.6,21.6,0,452,453,3269
1996,15940,7642,8766,157495,156795,804,9.2,800,9.1,22578,9194,13384,5.9,14.4,21177,5302,15875,3.4,13.5,1401,0.9,27,0,545,545,2904
1997,15940,7700,8870,156259,156811,854,9.7,752,8.5,21463,8180,13283,5.2,13.7,22566,7138,15428,4.6,14.4,-1103,-0.7,27.4,0,471,471,2478
1998,15940,7678,8870,162630,159442,809,9.1,798,9,25244,7530,17714,4.7,15.8,18868,7055,11813,4.4,11.8,6376,4,23.6,0,529,529,3697
1999,15940,7729,8959,162094,162270,828,9.3,729,8.2,19024,6047,12977,3.7,11.7,19375,5388,13987,3.3,11.9,-351,-0.2,23.4,0,490,490,2300
2000,15940,7697,8968,168863,166974,796,8.9,783,8.7,26225,9188,17037,5.5,15.7,22447,7487,14960,4.5,13.4,3778,2.3,26.8,0,490,490,2855
2001,15940,7675,8983,168248,167689,802,8.9,836,9.3,21115,7301,13814,4.4,12.6,19996,5977,14019,3.6,11.9,1119,0.7,23.8,0,484,486,2680
2002,15940,7626,8917,164455,166137,855,9.6,910,10.2,21687,7209,14478,4.3,13.1,25051,8772,16279,5.3,15.1,-3364,-2,26.2,0,480,481,2945
2003,15940,7593,8855,163722,163275,770,8.7,679,7.7,19869,6790,13079,4.2,12.2,18974,5545,13429,3.4,11.6,895,0.6,23.2,0,476,478,3129
2004,15940,7557,8859,157437,160099,811,9.2,731,8.3,18048,6410,11638,4,11.3,23372,11646,11726,7.3,14.6,-5324,-3.3,22.6,0,473,474,3038
2005,15940,7539,8862,161265,158931,836,9.5,757,8.6,23792,11574,12218,7.3,15,19124,5490,13634,3.5,12,4668,3,24,0,520,520,3592
2006,15940,7458,8835,160595,160778,811,9.2,781,8.8,17917,6889,11028,4.3,11.1,18282,6348,11934,3.9,11.4,-365,-0.3,22.2,0,518,518,3518
2007,15940,7394,8817,160953,160746,797,9,801,9.1,18999,6518,12481,4.1,11.8,18585,5909,12676,3.7,11.6,414,0.2,23.2,0,496,502,3029
2008,15940,7206,8644,156975,158337,666,7.7,769,8.8,17283,6201,11082,3.9,10.9,20007,5293,14714,3.3,12.6,-2724,-1.7,21.8,0,544,544,3561
2009,15940,6930,8342,143772,150335,528,6.2,757,8.9,11897,2998,8899,2,7.9,25023,5690,19333,3.8,16.6,-13126,-8.7,15.8,0,502,504,2635
2010,15940,6804,8199,138961,141079,535,6.5,624,7.6,12457,3815,8642,2.7,8.8,16693,3217,13476,2.3,11.8,-4236,-3,17.6,0,392,394,2285
2011,15940,6683,8055,140136,139359,565,7,665,8.2,15453,4187,11266,3,11.1,13898,4653,9245,3.3,10,1555,1.1,20,0,402,405,2914
2012,15940,6704,8099,143307,141712,641,7.9,589,7.3,18161,5231,12930,3.7,12.8,14970,3749,11221,2.6,10.6,3191,2.2,21.2,0,363,364,1931
2013,15940,6680,8044,142565,142716,548,6.8,596,7.4,16405,3909,12496,2.7,11.5,16707,3723,12984,2.6,11.7,-302,-0.2,23,0,387,388,2374
2014,15940,6623,8005,143404,142773,585,7.3,567,7.1,14899,4078,10821,2.9,10.4,13636,3463,10173,2.4,9.6,1263,0.8,19.2,0,391,393,2057
1977,15980,3551,3832,40094,37562,846,22.7,606,16.3,11329,5911,5418,15.7,30.2,6265,3203,3062,8.5,16.7,5064,13.5,33.4,0,467,467,2222
1978,15980,3863,4180,47172,43657,923,23,581,14.5,13763,6544,7219,15,31.5,6732,2783,3949,6.4,15.4,7031,16.1,30.8,0,426,427,2008
1979,15980,4231,4586,53775,50439,1006,23,571,13,14886,6836,8050,13.6,29.5,8214,3562,4652,7.1,16.3,6672,13.2,32.6,0,452,452,2795
1980,15980,4458,4857,71596,62630,950,20.1,650,13.8,27420,19557,7863,31.2,43.8,9487,4143,5344,6.6,15.1,17933,28.7,30.2,0,531,533,3233
1981,15980,4594,5012,75521,73132,955,19.4,741,15,15316,6498,8818,8.9,20.9,10538,4841,5697,6.6,14.4,4778,6.5,28.8,0,502,503,3028
1982,15980,4981,5520,62287,68746,1243,23.6,695,13.2,14060,7824,6236,11.4,20.5,26977,4244,22733,6.2,39.2,-12917,-18.7,41,0,425,426,2513
1983,15980,5180,5788,64374,63326,1089,19.3,852,15.1,14791,8091,6700,12.8,23.4,12694,5105,7589,8.1,20,2097,3.4,40,0,519,519,2887
1984,15980,5672,6315,71672,68101,1281,21.2,748,12.4,17675,7548,10127,11.1,26,10532,4029,6503,5.9,15.5,7143,10.5,31,0,529,530,2709
1985,15980,5985,6688,75716,73769,1261,19.4,880,13.5,17558,8377,9181,11.4,23.8,13664,5784,7880,7.8,18.5,3894,5.3,37,0,622,622,3555
1986,15980,6354,7057,82361,78906,1312,19.1,919,13.4,20787,9495,11292,12,26.3,13876,6504,7372,8.2,17.6,6911,8.7,35.2,0,646,646,4235
1987,15980,6824,7617,89203,86258,1604,21.8,1004,13.7,21716,10956,10760,12.7,25.2,15825,7253,8572,8.4,18.3,5891,6.9,36.6,0,715,720,5091
1988,15980,7164,8019,95981,92327,1494,19.1,1052,13.5,23747,10266,13481,11.1,25.7,16439,7181,9258,7.8,17.8,7308,7.9,35.6,0,775,775,4259
1989,15980,7422,8335,106257,102410,1369,16.7,1062,13,24095,9748,14347,9.5,23.5,16400,6496,9904,6.3,16,7695,7.5,32,0,771,771,4360
1990,15980,7688,8680,105807,105883,1388,16.3,974,11.5,20874,9261,11613,8.7,19.7,21025,9402,11623,8.9,19.9,-151,-0.2,39.4,0,729,729,5194
1991,15980,7911,8982,109394,107654,1469,16.6,1162,13.2,24208,10996,13212,10.2,22.5,20728,6874,13854,6.4,19.3,3480,3.2,38.6,0,810,818,4849
1992,15980,8008,9074,106867,108234,1435,15.9,1288,14.3,22456,11846,10610,10.9,20.7,25189,11854,13335,11,23.3,-2733,-2.6,41.4,0,856,864,5227
1993,15980,8088,9124,113610,110145,1263,13.9,1159,12.7,23902,8240,15662,7.5,21.7,16972,6777,10195,6.2,15.4,6930,6.3,30.8,0,837,840,4310
1994,15980,8215,9306,118416,115864,1398,15.2,1175,12.8,24707,10167,14540,8.8,21.3,19602,8043,11559,6.9,16.9,5105,4.4,33.8,0,866,867,5707
1995,15980,8311,9413,124541,121245,1380,14.8,1212,13,29527,14842,14685,12.2,24.4,22934,9795,13139,8.1,18.9,6593,5.5,37.8,0,837,838,4966
1996,15980,8408,9516,123062,123571,1335,14.1,1176,12.4,21783,9515,12268,7.7,17.6,22801,8864,13937,7.2,18.5,-1018,-0.9,35.2,0,816,816,5549
1997,15980,8648,9827,125807,124403,1526,15.8,1232,12.7,25629,10505,15124,8.4,20.6,22820,10491,12329,8.4,18.3,2809,2.3,36.6,0,793,793,4515
1998,15980,8842,10042,131163,128386,1458,14.7,1206,12.1,24974,10842,14132,8.4,19.5,19420,8142,11278,6.3,15.1,5554,4.4,30.2,0,820,820,4269
1999,15980,9086,10444,137551,134220,1638,16,1219,11.9,29323,14352,14971,10.7,21.8,22661,11204,11457,8.3,16.9,6662,4.9,33.8,0,794,794,5602
2000,15980,9227,10639,143880,141770,1559,14.8,1376,13.1,30584,13152,17432,9.3,21.6,26365,11642,14723,8.2,18.6,4219,3,37.2,0,833,833,5590
2001,15980,9662,11191,153581,149363,1698,15.5,1225,11.2,30255,12561,17694,8.4,20.3,21819,9229,12590,6.2,14.6,8436,5.7,29.2,0,707,708,3985
2002,15980,10092,11656,159050,157395,1877,16.4,1401,12.3,34085,14636,19449,9.3,21.7,30774,13999,16775,8.9,19.6,3311,2.1,39.2,0,743,743,6130
2003,15980,10447,12090,168047,161972,1935,16.4,1268,10.7,37391,15793,21598,9.8,23.1,25241,8919,16322,5.5,15.6,12150,7.5,31.2,0,885,885,4977
2004,15980,11034,12694,173812,170058,2083,16.8,1331,10.8,34509,13145,21364,7.7,20.3,27000,9084,17916,5.3,15.9,7509,4.4,31.8,0,956,957,5360
2005,15980,11773,13546,181943,177354,2397,18.3,1421,10.9,38090,15588,22502,8.8,21.5,28911,10234,18677,5.8,16.3,9179,5.2,32.6,0,1023,1023,7004
2006,15980,12492,14381,197414,189115,2471,17.7,1489,10.7,40831,17707,23124,9.4,21.6,24232,8638,15594,4.6,12.8,16599,8.8,25.6,0,1032,1032,5744
2007,15980,12644,14744,200726,198241,2334,16.1,1905,13.1,42522,20524,21998,10.4,21.4,37552,11888,25664,6,18.9,4970,2.5,37.8,0,1339,1343,6648
2008,15980,12024,14183,188155,193581,1936,13.4,2297,16,32792,17274,15518,8.9,16.9,43644,13989,29655,7.2,22.5,-10852,-5.6,33.8,0,1765,1774,10288
2009,15980,11331,13435,171820,179057,1641,11.9,2194,16,27079,11594,15485,6.5,15.1,41553,12089,29464,6.8,23.2,-14474,-8.1,30.2,0,1575,1579,7311
2010,15980,11217,13278,171084,169086,1667,12.5,1707,12.8,30802,11067,19735,6.5,18.2,26805,9965,16840,5.9,15.9,3997,2.3,31.8,0,1154,1154,5590
2011,15980,11325,13393,179453,175074,1757,13.2,1574,11.8,33145,12822,20323,7.3,18.9,24387,10318,14069,5.9,13.9,8758,5,27.8,0,1082,1086,5589
2012,15980,11664,13796,200058,189605,1948,14.4,1537,11.3,54595,11451,43144,6,28.8,33689,20705,12984,10.9,17.8,20906,11,35.6,0,995,1010,17676
2013,15980,12063,14192,208621,204203,1765,12.7,1403,10.1,31106,15176,15930,7.4,15.2,22270,8337,13933,4.1,10.9,8836,4.3,21.8,0,971,974,5573
2014,15980,12347,14487,210610,209233,1874,13.1,1491,10.4,30535,12032,18503,5.8,14.6,27781,8840,18941,4.2,13.3,2754,1.3,26.6,0,1041,1045,4927
1977,16020,1707,1808,23370,23041,296,16.5,260,14.5,4619,2053,2566,8.9,20,3960,2270,1690,9.9,17.2,659,2.8,34.4,0,169,169,1358
1978,16020,1773,1884,24447,23906,293,15.9,218,11.8,4566,1683,2883,7,19.1,3484,1398,2086,5.8,14.6,1082,4.5,29.2,0,154,154,920
1979,16020,1787,1900,29318,26875,226,11.9,202,10.7,7928,1011,6917,3.8,29.5,3041,994,2047,3.7,11.3,4887,18.2,22.6,0,134,134,640
1980,16020,1764,1866,25992,27639,229,12.2,245,13,3352,1156,2196,4.2,12.1,6646,983,5663,3.6,24,-3294,-11.9,24.2,0,179,179,645
1981,16020,1678,1786,25522,25048,209,11.5,248,13.7,4691,2831,1860,11.3,18.7,3743,1355,2388,5.4,14.9,948,3.8,29.8,0,171,171,634
1982,16020,1675,1807,24846,25068,242,13.5,197,11,3808,1682,2126,6.7,15.2,4251,952,3299,3.8,17,-443,-1.8,30.4,0,118,118,524
1983,16020,1728,1854,24594,24699,212,11.6,187,10.2,4308,1668,2640,6.8,17.4,4518,2232,2286,9,18.3,-210,-0.9,34.8,0,117,117,898
1984,16020,1765,1910,26278,25961,260,13.8,223,11.8,4306,1676,2630,6.5,16.6,3671,1041,2630,4,14.1,635,2.5,28.2,0,135,136,578
1985,16020,1839,1985,28003,27282,269,13.8,201,10.3,4874,2144,2730,7.9,17.9,3431,1310,2121,4.8,12.6,1443,5.3,25.2,0,136,137,804
1986,16020,1933,2068,29487,28659,268,13.2,175,8.6,4921,1534,3387,5.4,17.2,3264,880,2384,3.1,11.4,1657,5.8,22.8,0,103,103,466
1987,16020,1990,2135,30437,29865,292,13.9,215,10.2,5004,1646,3358,5.5,16.8,3860,1770,2090,5.9,12.9,1144,3.9,25.8,0,138,138,876
1988,16020,1957,2093,29861,29644,227,10.8,246,11.7,4553,1614,2939,5.4,15.4,4119,1584,2535,5.3,13.9,434,1.5,27.8,0,158,158,705
1989,16020,2028,2176,30923,30431,298,14,217,10.2,5055,1777,3278,5.8,16.6,4070,1634,2436,5.4,13.4,985,3.2,26.8,0,144,144,765
1990,16020,2044,2202,31734,31304,233,10.6,196,9,5451,1974,3477,6.3,17.4,4591,1420,3171,4.5,14.7,860,2.7,29.4,0,128,128,667
1991,16020,2050,2231,31361,31509,239,10.8,204,9.2,4528,1626,2902,5.2,14.4,4824,1526,3298,4.8,15.3,-296,-0.9,28.8,0,131,131,1104
1992,16020,2092,2276,32225,31792,263,11.7,209,9.3,5660,2345,3315,7.4,17.8,4794,2195,2599,6.9,15.1,866,2.7,30.2,0,140,140,799
1993,16020,2084,2274,33109,32675,217,9.5,216,9.5,4992,1811,3181,5.5,15.3,4123,1570,2553,4.8,12.6,869,2.7,25.2,0,157,157,1040
1994,16020,2105,2292,33757,33414,233,10.2,205,9,4861,1659,3202,5,14.5,4174,1788,2386,5.4,12.5,687,2,25,0,152,152,853
1995,16020,2150,2336,36170,34956,253,10.9,196,8.5,6159,2328,3831,6.7,17.6,3730,1450,2280,4.1,10.7,2429,6.9,21.4,0,130,130,555
1996,16020,2168,2361,36767,36473,260,11.1,225,9.6,5726,2311,3415,6.3,15.7,5138,1763,3375,4.8,14.1,588,1.6,28.2,0,156,156,978
1997,16020,2173,2376,35956,36409,236,9.9,232,9.8,4283,1360,2923,3.7,11.8,5188,1278,3910,3.5,14.2,-905,-2.4,23.6,0,160,160,992
1998,16020,2192,2407,37546,36715,255,10.7,208,8.7,5593,2192,3401,6,15.2,3931,1173,2758,3.2,10.7,1662,4.5,21.4,0,136,136,653
1999,16020,2200,2417,39461,38528,246,10.2,239,9.9,6018,2006,4012,5.2,15.6,4152,1629,2523,4.2,10.8,1866,4.8,21.6,0,157,157,681
2000,16020,2223,2440,39154,39295,248,10.2,228,9.4,4929,1977,2952,5,12.5,5210,1694,3516,4.3,13.3,-281,-0.8,25,0,153,153,787
2001,16020,2218,2442,40028,39634,218,8.9,237,9.7,4764,1769,2995,4.5,12,3976,1228,2748,3.1,10,788,2,20,0,146,146,560
2002,16020,2219,2464,39258,39612,264,10.8,238,9.7,5776,2666,3110,6.7,14.6,6486,2573,3913,6.5,16.4,-710,-1.8,29.2,0,133,133,629
2003,16020,2238,2482,38949,38928,252,10.2,199,8.1,5184,1749,3435,4.5,13.3,5143,1726,3417,4.4,13.2,41,0.1,26.4,0,130,130,705
2004,16020,2261,2506,39803,39242,262,10.5,215,8.6,4884,1482,3402,3.8,12.4,3762,1098,2664,2.8,9.6,1122,2.8,19.2,0,151,151,596
2005,16020,2277,2534,40264,39962,258,10.2,214,8.5,4558,1462,3096,3.7,11.4,3954,1309,2645,3.3,9.9,604,1.5,19.8,0,167,167,1098
2006,16020,2256,2522,42407,41245,260,10.3,245,9.7,6350,2625,3725,6.4,15.4,4026,1161,2865,2.8,9.8,2324,5.6,19.6,0,168,168,683
2007,16020,2322,2597,41776,42014,284,11.1,207,8.1,5615,2162,3453,5.1,13.4,6091,1686,4405,4,14.5,-476,-1.1,26.8,0,135,137,745
2008,16020,2329,2597,42559,42054,233,9,214,8.3,5855,1605,4250,3.8,13.9,4845,1690,3155,4,11.5,1010,2.4,23,0,161,161,1226
2009,16020,2414,2667,40706,41552,306,11.7,223,8.5,4245,1311,2934,3.2,10.2,5936,2001,3935,4.8,14.3,-1691,-4.1,20.4,0,151,151,993
2010,16020,2495,2757,40592,40633,333,12.3,236,8.7,4160,1542,2618,3.8,10.2,4241,1156,3085,2.8,10.4,-81,-0.2,20.4,0,180,180,688
2011,16020,2158,2428,39748,40140,189,7.3,499,19.3,4412,1334,3078,3.3,11,5196,967,4229,2.4,12.9,-784,-1.9,22,0,435,435,762
2012,16020,2164,2446,40144,39943,226,9.3,212,8.7,4909,1328,3581,3.3,12.3,4506,1295,3211,3.2,11.3,403,1,22.6,0,140,140,832
2013,16020,2170,2445,41229,40678,180,7.4,185,7.6,4250,1510,2740,3.7,10.4,3148,725,2423,1.8,7.7,1102,2.7,15.4,0,138,138,518
2014,16020,2146,2422,40350,40761,196,8.1,206,8.5,3965,958,3007,2.4,9.7,4786,953,3833,2.3,11.7,-821,-2,19.4,0,151,151,612
1977,16180,686,710,6073,5692,180,27,95,14.3,1977,1162,815,20.4,34.7,1215,389,826,6.8,21.3,762,13.4,42.6,0,69,69,271
1978,16180,694,715,7452,6741,190,26.7,173,24.3,2603,1270,1333,18.8,38.6,1180,738,442,10.9,17.5,1423,21.1,35,0,98,98,362
1979,16180,800,823,9578,8518,186,24.2,83,10.8,3563,1605,1958,18.8,41.8,1442,592,850,6.9,16.9,2121,24.9,33.8,0,7,7,11
1980,16180,853,882,9899,9584,195,22.9,129,15.1,2650,1396,1254,14.6,27.7,2020,595,1425,6.2,21.1,630,6.6,42.2,0,95,95,419
1981,16180,862,886,8692,9303,181,20.5,171,19.3,2137,947,1190,10.2,23,3358,1991,1367,21.4,36.1,-1221,-13.1,46,0,100,100,795
1982,16180,882,922,9074,8838,205,22.7,147,16.3,2818,1900,918,21.5,31.9,2346,981,1365,11.1,26.5,472,5.4,53,0,83,83,439
1983,16180,878,922,9199,9112,139,15.1,143,15.5,2261,1060,1201,11.6,24.8,2086,844,1242,9.3,22.9,175,1.9,45.8,0,91,91,503
1984,16180,979,1019,10883,10048,212,21.8,122,12.6,3137,1494,1643,14.9,31.2,1466,528,938,5.3,14.6,1671,16.6,29.2,0,76,76,279
1985,16180,975,1012,11976,11414,175,17.2,175,17.2,3806,2093,1713,18.3,33.3,2681,1256,1425,11,23.5,1125,9.8,47,0,105,105,382
1986,16180,1016,1050,12459,12166,197,19.1,156,15.1,3036,1096,1940,9,25,2450,1551,899,12.7,20.1,586,4.9,40.2,0,96,96,784
1987,16180,1075,1115,13763,13311,232,21.4,157,14.5,3788,1944,1844,14.6,28.5,2883,1024,1859,7.7,21.7,905,6.8,43.4,0,102,102,486
1988,16180,1097,1143,16337,15039,200,17.7,167,14.8,5012,2412,2600,16,33.3,2416,778,1638,5.2,16.1,2596,17.2,32.2,0,116,116,451
1989,16180,1167,1215,16690,16518,203,17.2,130,11,2960,1043,1917,6.3,17.9,2616,1088,1528,6.6,15.8,344,2.1,31.6,0,78,78,695
1990,16180,1193,1238,14992,15754,184,15,148,12.1,3251,1393,1858,8.8,20.6,4775,2639,2136,16.8,30.3,-1524,-9.7,41.2,0,97,97,406
1991,16180,1262,1311,15191,15039,220,17.3,145,11.4,3097,1608,1489,10.7,20.6,2792,826,1966,5.5,18.6,305,2,37.2,0,88,88,380
1992,16180,1268,1307,15724,15434,196,15,189,14.4,3810,2069,1741,13.4,24.7,3230,1071,2159,6.9,20.9,580,3.8,41.8,0,125,125,468
1993,16180,1286,1327,15304,15263,189,14.4,156,11.9,2839,814,2025,5.3,18.6,2757,1105,1652,7.2,18.1,82,0.5,36.2,0,103,103,566
1994,16180,1353,1395,16066,15703,206,15.1,143,10.5,3534,1088,2446,6.9,22.5,2807,1339,1468,8.5,17.9,727,4.6,35.8,0,88,88,348
1995,16180,1460,1507,17832,16965,269,18.5,160,11,4415,2382,2033,14,26,2681,1041,1640,6.1,15.8,1734,10.2,31.6,0,117,117,577
1996,16180,1540,1589,19489,18867,268,17.3,182,11.8,4519,2654,1865,14.1,24,3275,1070,2205,5.7,17.4,1244,6.6,34.8,0,124,124,735
1997,16180,1623,1685,19620,19558,287,17.5,191,11.7,3882,1973,1909,10.1,19.8,3757,1557,2200,8,19.2,125,0.6,38.4,0,128,128,719
1998,16180,1706,1781,21265,20428,312,18,207,11.9,4554,1954,2600,9.6,22.3,2880,1006,1874,4.9,14.1,1674,8.2,28.2,0,149,149,699
1999,16180,1769,1858,23052,22558,330,18.1,248,13.6,4391,2197,2194,9.7,19.5,3402,1281,2121,5.7,15.1,989,4.4,30.2,0,165,165,799
2000,16180,1821,1911,23684,23366,327,17.4,274,14.5,4121,1563,2558,6.7,17.6,3484,1546,1938,6.6,14.9,637,2.7,29.8,0,178,178,810
2001,16180,1807,1892,23147,23420,287,15.1,320,16.8,3618,1675,1943,7.2,15.4,4164,1580,2584,6.7,17.8,-546,-2.4,30.8,0,213,213,1022
2002,16180,1778,1868,22634,22886,289,15.4,309,16.5,4656,2236,2420,9.8,20.3,5160,2467,2693,10.8,22.5,-504,-2.2,40.6,0,198,198,1744
2003,16180,1849,1943,24773,23645,324,17.1,214,11.3,4743,2163,2580,9.1,20.1,2487,868,1619,3.7,10.5,2256,9.6,21,0,160,160,665
2004,16180,1860,1956,25362,24956,286,14.7,259,13.3,4177,1635,2542,6.6,16.7,3364,1217,2147,4.9,13.5,813,3.2,27,0,187,187,944
2005,16180,1877,1975,25393,25336,283,14.4,250,12.7,3852,1272,2580,5,15.2,3738,1369,2369,5.4,14.8,114,0.4,29.6,0,185,185,840
2006,16180,1911,2011,27206,26291,286,14.4,250,12.5,5135,2169,2966,8.2,19.5,3304,1160,2144,4.4,12.6,1831,6.9,25.2,0,168,168,813
2007,16180,1937,2059,26269,26728,323,15.9,273,13.4,4482,1996,2486,7.5,16.8,5400,2012,3388,7.5,20.2,-918,-3.4,33.6,0,185,185,1027
2008,16180,1917,2040,24875,25493,247,12.1,249,12.2,3108,1092,2016,4.3,12.2,4344,1204,3140,4.7,17,-1236,-4.8,24.4,0,195,195,970
2009,16180,1775,1910,22805,23729,192,9.8,290,14.7,2619,1185,1434,5,11,4466,1145,3321,4.8,18.8,-1847,-7.8,22,0,201,201,668
2010,16180,1755,1892,21642,22113,222,11.7,220,11.6,2700,1332,1368,6,12.2,3642,1222,2420,5.5,16.5,-942,-4.3,24.4,0,146,146,738
2011,16180,1706,1844,22127,21830,195,10.5,224,12,3498,1376,2122,6.3,16,2904,1100,1804,5,13.3,594,2.7,26.6,0,161,161,689
2012,16180,1692,1830,22386,22228,192,10.5,207,11.3,3337,1095,2242,4.9,15,3020,1116,1904,5,13.6,317,1.4,27.2,0,137,137,636
2013,16180,1669,1817,21695,22042,170,9.3,182,10,2715,692,2023,3.1,12.3,3409,1171,2238,5.3,15.5,-694,-3.2,24.6,0,128,128,998
2014,16180,1662,1808,22489,22002,177,9.8,173,9.6,3744,1496,2248,6.8,17,2769,940,1829,4.3,12.6,975,4.4,25.2,0,128,128,650
1977,16220,1906,2020,22461,20736,412,21.4,220,11.4,6494,2800,3694,13.5,31.3,3044,1299,1745,6.3,14.7,3450,16.6,29.4,0,154,154,928
1978,16220,1912,2034,25420,23884,368,18.2,334,16.5,7548,2536,5012,10.6,31.6,4475,2745,1730,11.5,18.7,3073,12.9,37.4,0,204,205,1430
1979,16220,2183,2320,29441,27452,446,20.5,175,8,8222,3135,5087,11.4,30,4244,1283,2961,4.7,15.5,3978,14.5,31,1,5,5,
1980,16220,2247,2396,31843,30573,388,16.5,296,12.6,8410,3817,4593,12.5,27.5,5870,2131,3739,7,19.2,2540,8.3,38.4,0,217,217,1307
1981,16220,2223,2384,33179,32463,378,15.8,373,15.6,8120,3055,5065,9.4,25,6687,2255,4432,6.9,20.6,1433,4.4,41.2,0,235,236,1260
1982,16220,2300,2503,33366,33240,461,18.8,328,13.4,8068,3235,4833,9.7,24.3,7816,2813,5003,8.5,23.5,252,0.8,47,0,192,192,1253
1983,16220,2246,2446,25886,29611,327,13.2,388,15.7,4395,2063,2332,7,14.8,11845,3372,8473,11.4,40,-7450,-25.2,29.6,0,277,277,2253
1984,16220,2184,2390,25700,25679,290,12,349,14.4,5525,3088,2437,12,21.5,5483,1981,3502,7.7,21.4,42,0.1,42.8,0,225,225,1176
1985,16220,2179,2372,24398,25116,287,12,318,13.4,4409,1867,2542,7.4,17.6,5845,2052,3793,8.2,23.3,-1436,-5.7,35.2,0,205,205,1126
1986,16220,2063,2240,21977,23160,231,10,353,15.3,3936,1623,2313,7,17,6302,2593,3709,11.2,27.2,-2366,-10.2,34,0,221,221,1320
1987,16220,1933,2099,19804,20880,236,10.9,352,16.2,3516,1775,1741,8.5,16.8,5668,2200,3468,10.5,27.1,-2152,-10.3,33.6,0,201,201,1190
1988,16220,1916,2085,19441,19626,236,11.3,248,11.9,3556,1350,2206,6.9,18.1,3926,1795,2131,9.1,20,-370,-1.9,36.2,0,148,148,792
1989,16220,1897,2063,19619,19557,205,9.9,223,10.8,3313,1039,2274,5.3,16.9,3188,1113,2075,5.7,16.3,125,0.6,32.6,0,144,144,681
1990,16220,1912,2081,20806,20207,214,10.3,187,9,4344,1329,3015,6.6,21.5,3146,1289,1857,6.4,15.6,1198,5.9,31.2,0,106,106,679
1991,16220,1977,2160,21429,21128,251,11.8,180,8.5,4121,1555,2566,7.4,19.5,3519,954,2565,4.5,16.7,602,2.8,33.4,0,108,108,624
1992,16220,1996,2182,20918,21140,232,10.7,192,8.8,3821,1372,2449,6.5,18.1,4265,1205,3060,5.7,20.2,-444,-2.1,36.2,0,105,105,379
1993,16220,2033,2207,21615,21783,221,10.1,200,9.1,3628,1247,2381,5.7,16.7,3964,1010,2954,4.6,18.2,-336,-1.5,33.4,0,120,120,497
1994,16220,2074,2244,22928,22238,246,11.1,193,8.7,4613,1957,2656,8.8,20.7,3232,1174,2058,5.3,14.5,1381,6.2,29,0,126,126,559
1995,16220,2119,2288,23139,23012,260,11.5,202,8.9,3586,1330,2256,5.8,15.6,3332,1131,2201,4.9,14.5,254,1.1,29,0,137,137,694
1996,16220,2144,2320,23007,23079,242,10.5,210,9.1,3342,1147,2195,5,14.5,3486,1039,2447,4.5,15.1,-144,-0.6,29,0,127,127,486
1997,16220,2153,2330,24908,24004,252,10.8,238,10.2,5553,1796,3757,7.5,23.1,3745,1270,2475,5.3,15.6,1808,7.5,31.2,0,155,155,627
1998,16220,2145,2316,25039,24971,231,9.9,242,10.4,4778,1980,2798,7.9,19.1,4642,1845,2797,7.4,18.6,136,0.5,37.2,0,144,144,768
1999,16220,2128,2316,26835,25936,255,11,258,11.1,5709,1971,3738,7.6,22,3911,1406,2505,5.4,15.1,1798,6.9,30.2,0,160,160,832
2000,16220,2140,2347,28066,27458,248,10.6,220,9.4,5155,1520,3635,5.5,18.8,3938,1320,2618,4.8,14.3,1217,4.5,28.6,0,117,117,548
2001,16220,2164,2384,28466,28293,250,10.5,231,9.7,4446,1388,3058,4.9,15.7,4100,1210,2890,4.3,14.5,346,1.2,29,0,137,137,611
2002,16220,2219,2421,28975,28705,296,12.3,255,10.6,5123,1727,3396,6,17.8,4583,1708,2875,6,16,540,1.8,32,0,122,123,523
2003,16220,2264,2465,28005,27807,266,10.9,190,7.8,4307,1480,2827,5.3,15.5,3910,1142,2768,4.1,14.1,397,1.4,28.2,0,125,125,677
2004,16220,2314,2517,30037,28901,269,10.8,196,7.9,5708,1755,3953,6.1,19.8,3435,973,2462,3.4,11.9,2273,7.9,23.8,0,134,134,739
2005,16220,2379,2600,31840,31466,311,12.2,201,7.9,5536,2255,3281,7.2,17.6,4788,1863,2925,5.9,15.2,748,2.4,30.4,0,145,145,1151
2006,16220,2393,2625,35123,33326,287,11,229,8.8,7716,3554,4162,10.7,23.2,4122,1501,2621,4.5,12.4,3594,10.8,24.8,0,169,169,1172
2007,16220,2495,2741,36917,35448,338,12.6,215,8,7931,2423,5508,6.8,22.4,4993,1823,3170,5.1,14.1,2938,8.3,28.2,0,145,145,647
2008,16220,2480,2736,38204,37497,241,8.8,232,8.5,6393,1431,4962,3.8,17,4978,1140,3838,3,13.3,1415,3.7,26.6,0,171,171,738
2009,16220,2474,2734,35860,36865,231,8.5,227,8.3,4761,1567,3194,4.3,12.9,6771,1240,5531,3.4,18.4,-2010,-5.5,25.8,0,138,138,735
2010,16220,2432,2685,31725,33139,207,7.7,243,9,3410,1369,2041,4.1,10.3,6237,2072,4165,6.3,18.8,-2827,-8.5,20.6,0,154,154,650
2011,16220,2450,2707,33857,33146,252,9.4,220,8.2,5668,1876,3792,5.7,17.1,4245,1102,3143,3.3,12.8,1423,4.3,25.6,0,134,134,596
2012,16220,2490,2742,36305,35008,267,9.8,239,8.8,7071,2126,4945,6.1,20.2,4476,1666,2810,4.8,12.8,2595,7.4,25.6,0,132,134,956
2013,16220,2495,2764,40198,38259,237,8.6,218,7.9,8583,1913,6670,5,22.4,4704,1399,3305,3.7,12.3,3879,10.1,24.6,0,154,155,805
2014,16220,2508,2766,37408,38594,233,8.4,216,7.8,5482,1689,3793,4.4,14.2,7854,1287,6567,3.3,20.4,-2372,-6.2,28.4,0,121,121,490
1977,16300,3893,4272,73268,72060,679,16.2,477,11.4,10855,5082,5773,7.1,15.1,8439,3362,5077,4.7,11.7,2416,3.4,23.4,0,312,312,2094
1978,16300,4024,4405,78167,75714,588,13.6,456,10.5,12248,3710,8538,4.9,16.2,7342,2580,4762,3.4,9.7,4906,6.5,19.4,0,315,315,1421
1979,16300,4042,4430,83565,80829,519,11.8,472,10.7,13614,4428,9186,5.5,16.8,8142,3309,4833,4.1,10.1,5472,6.7,20.2,0,342,342,1856
1980,16300,4136,4585,85012,84234,653,14.5,477,10.6,14547,7142,7405,8.5,17.3,12991,4743,8248,5.6,15.4,1556,1.9,30.8,0,356,356,1841
1981,16300,4046,4490,79578,81924,533,11.8,588,13,9250,3924,5326,4.8,11.3,13942,3808,10134,4.6,17,-4692,-5.7,22.6,0,353,353,1854
1982,16300,4044,4546,75711,77582,576,12.7,457,10.1,8655,3926,4729,5.1,11.2,12396,3556,8840,4.6,16,-3741,-4.8,22.4,0,271,271,1349
1983,16300,4103,4604,74182,74759,462,10.1,447,9.8,19059,11873,7186,15.9,25.5,20213,12297,7916,16.4,27,-1154,-1.5,51,0,292,292,1542
1984,16300,4164,4694,72336,73166,556,12,463,10,9185,3231,5954,4.4,12.6,10844,2356,8488,3.2,14.8,-1659,-2.2,25.2,0,301,301,1200
1985,16300,4190,4714,76622,74821,518,11,513,10.9,11639,3690,7949,4.9,15.6,8036,3549,4487,4.7,10.7,3603,4.9,21.4,0,311,312,1473
1986,16300,4249,4771,78164,77395,562,11.9,492,10.4,12058,5671,6387,7.3,15.6,10519,4439,6080,5.7,13.6,1539,2,27.2,0,314,314,1573
1987,16300,4253,4802,81555,80545,613,12.8,564,11.8,12796,5226,7570,6.5,15.9,10778,3563,7215,4.4,13.4,2018,2.5,26.8,0,363,364,1929
1988,16300,4234,4795,83902,82239,530,11.1,511,10.7,12932,3960,8972,4.8,15.7,9607,3752,5855,4.6,11.7,3325,4,23.4,0,328,328,1842
1989,16300,4263,4845,89461,86606,512,10.6,458,9.5,14126,5811,8315,6.7,16.3,8416,3089,5327,3.6,9.7,5710,6.6,19.4,0,286,286,1525
1990,16300,4321,4934,89974,89600,495,10.1,371,7.6,11490,3752,7738,4.2,12.8,10741,1960,8781,2.2,12,749,0.8,24,0,282,282,1302
1991,16300,4391,5028,90951,90325,521,10.5,424,8.5,13201,5823,7378,6.4,14.6,11948,3490,8458,3.9,13.2,1253,1.4,26.4,0,255,259,1800
1992,16300,4436,5119,96505,93741,535,10.5,439,8.6,20663,8729,11934,9.3,22,15134,4691,10443,5,16.1,5529,5.9,32.2,0,274,276,1452
1993,16300,4558,5227,98515,97598,490,9.5,379,7.3,12249,3974,8275,4.1,12.6,10414,2040,8374,2.1,10.7,1835,1.9,21.4,0,227,228,1022
1994,16300,4695,5382,99737,99032,579,10.9,413,7.8,13462,4052,9410,4.1,13.6,12052,4607,7445,4.7,12.2,1410,1.4,24.4,0,274,274,1279
1995,16300,4804,5528,104532,102140,621,11.4,451,8.3,17446,7166,10280,7,17.1,12661,6066,6595,5.9,12.4,4785,4.7,24.8,0,295,295,1635
1996,16300,4855,5565,107493,106038,538,9.7,506,9.1,16364,5806,10558,5.5,15.4,13454,5564,7890,5.2,12.7,2910,2.7,25.4,0,311,311,2443
1997,16300,4873,5639,106927,107301,606,10.8,536,9.5,20864,5471,15393,5.1,19.4,21611,9869,11742,9.2,20.1,-747,-0.7,38.8,0,315,315,2797
1998,16300,4972,5770,117436,112028,631,11.1,480,8.4,21208,6076,15132,5.4,18.9,10391,3333,7058,3,9.3,10817,9.6,18.6,0,308,308,1563
1999,16300,4988,5795,117847,117785,547,9.5,517,8.9,19365,7283,12082,6.2,16.4,19241,5732,13509,4.9,16.3,124,0.1,32.6,0,305,305,1497
2000,16300,4967,5801,120546,119093,551,9.5,544,9.4,17470,6423,11047,5.4,14.7,14564,4613,9951,3.9,12.2,2906,2.5,24.4,0,337,337,1954
2001,16300,4961,5833,119798,120361,578,9.9,595,10.2,15590,7162,8428,6,13,16716,5465,11251,4.5,13.9,-1126,-0.9,26,0,324,324,2367
2002,16300,4986,5878,117220,118388,633,10.8,578,9.9,17232,7350,9882,6.2,14.6,19567,5890,13677,5,16.5,-2335,-1.9,29.2,0,271,271,1949
2003,16300,4967,5853,114862,115258,610,10.5,525,9,15809,6151,9658,5.3,13.7,16600,5402,11198,4.7,14.4,-791,-0.7,27.4,0,314,314,2363
2004,16300,5010,5880,113260,113513,580,9.9,494,8.4,13510,3953,9557,3.5,11.9,14016,4594,9422,4,12.3,-506,-0.4,23.8,0,307,307,1431
2005,16300,5096,5975,114161,113365,599,10.1,463,7.8,13169,4853,8316,4.3,11.6,11577,3163,8414,2.8,10.2,1592,1.4,20.4,0,317,317,2092
2006,16300,5100,6043,116452,115129,654,10.9,540,9,15298,6235,9063,5.4,13.3,12652,4391,8261,3.8,11,2646,2.3,22,0,354,354,2965
2007,16300,5147,6152,120386,118361,613,10.1,508,8.3,16811,5830,10981,4.9,14.2,12761,3435,9326,2.9,10.8,4050,3.4,21.6,0,315,315,2042
2008,16300,5089,6066,123490,121653,516,8.5,541,8.9,20060,5007,15053,4.1,16.5,16385,6717,9668,5.5,13.5,3675,3,27,0,366,366,2400
2009,16300,4977,5950,122420,122553,435,7.3,503,8.4,13799,3839,9960,3.1,11.3,14064,3372,10692,2.8,11.5,-265,-0.2,22.6,0,346,346,2208
2010,16300,4957,5930,120690,121242,423,7.1,415,7,12124,3602,8522,3,10,13227,2506,10721,2.1,10.9,-1103,-0.9,20,0,275,275,1448
2011,16300,4881,5870,121304,120886,424,7.2,456,7.7,12199,2983,9216,2.5,10.1,11363,3017,8346,2.5,9.4,836,0.7,18.8,0,295,298,1811
2012,16300,4946,5917,123872,122097,485,8.2,439,7.5,14922,4344,10578,3.6,12.2,11371,3642,7729,3,9.3,3551,2.9,18.6,0,232,233,1473
2013,16300,4943,5908,124201,123889,441,7.5,419,7.1,11364,3349,8015,2.7,9.2,10739,2652,8087,2.1,8.7,625,0.5,17.4,0,242,244,1650
2014,16300,4933,5890,124637,124037,414,7,385,6.6,11498,2482,9016,2,9.3,10298,2926,7372,2.4,8.3,1200,1,16.6,0,263,263,1635
1977,16580,3373,3674,48392,47549,620,17.2,482,13.4,10002,5075,4927,10.7,21,8315,3348,4967,7,17.5,1687,3.5,35,0,317,317,1829
1978,16580,3562,3870,52134,50277,606,16.1,407,10.8,10371,4097,6274,8.1,20.6,6656,2701,3955,5.4,13.2,3715,7.4,26.4,0,278,281,1574
1979,16580,3476,3805,54491,53252,489,12.7,522,13.6,10610,4195,6415,7.9,19.9,8132,3559,4573,6.7,15.3,2478,4.6,30.6,0,372,372,1706
1980,16580,3433,3766,55089,54371,407,10.8,438,11.6,9846,4451,5395,8.2,18.1,8410,3283,5127,6,15.5,1436,2.6,31,0,301,302,1709
1981,16580,3242,3551,51738,52416,398,11,540,14.9,8867,4449,4418,8.5,16.9,10223,4173,6050,8,19.5,-1356,-2.6,33.8,0,313,314,2123
1982,16580,3257,3630,52050,51852,508,14.1,385,10.7,9679,4092,5587,7.9,18.7,9283,3676,5607,7.1,17.9,396,0.8,35.8,0,231,231,2376
1983,16580,3280,3656,49367,50668,389,10.7,403,11.1,8234,3835,4399,7.6,16.3,10836,4123,6713,8.1,21.4,-2602,-5.1,32.6,0,250,254,1851
1984,16580,3322,3724,51548,50468,452,12.3,393,10.7,8854,3057,5797,6.1,17.5,6694,2754,3940,5.5,13.3,2160,4.2,26.6,0,243,244,1160
1985,16580,3427,3834,53558,53391,465,12.2,390,10.3,9196,3618,5578,6.8,17.2,8861,4109,4752,7.7,16.6,335,0.6,33.2,0,239,239,2055
1986,16580,3532,3948,57539,55525,484,12.4,360,9.3,10984,4660,6324,8.4,19.8,6956,2406,4550,4.3,12.5,4028,7.3,25,0,228,228,1509
1987,16580,3608,4074,60847,59445,586,14.6,445,11.1,11597,4329,7268,7.3,19.5,8792,3668,5124,6.2,14.8,2805,4.7,29.6,0,260,260,1728
1988,16580,3567,4042,59114,58835,438,10.9,388,9.6,8936,3256,5680,5.5,15.2,8378,2747,5631,4.7,14.2,558,1,28.4,0,258,258,1454
1989,16580,3550,4046,60075,59817,409,10.1,420,10.4,8617,3263,5354,5.5,14.4,8100,2810,5290,4.7,13.5,517,0.9,27,0,275,276,1827
1990,16580,3554,4068,63371,61739,392,9.7,343,8.5,10416,3019,7397,4.9,16.9,7152,2293,4859,3.7,11.6,3264,5.3,23.2,0,223,223,1261
1991,16580,3579,4124,64947,64100,420,10.3,365,8.9,9978,4056,5922,6.3,15.6,8283,2568,5715,4,12.9,1695,2.7,25.8,0,237,239,1551
1992,16580,3601,4155,65190,65088,413,10,383,9.2,9086,3319,5767,5.1,14,8881,2516,6365,3.9,13.6,205,0.4,27.2,0,222,223,1277
1993,16580,3667,4192,65896,65560,399,9.6,349,8.4,8693,2602,6091,4,13.3,8020,2744,5276,4.2,12.2,673,1.1,24.4,0,198,201,1072
1994,16580,3677,4199,66508,66151,417,9.9,398,9.5,9324,3058,6266,4.6,14.1,8610,3529,5081,5.3,13,714,1.1,26,0,249,249,1907
1995,16580,3709,4235,68801,67608,454,10.8,393,9.3,10897,4553,6344,6.7,16.1,8511,3349,5162,5,12.6,2386,3.5,25.2,0,228,230,1454
1996,16580,3778,4326,70293,69564,504,11.8,417,9.7,10584,4245,6339,6.1,15.2,9126,2926,6200,4.2,13.1,1458,2.1,26.2,0,262,262,1378
1997,16580,3810,4382,71382,70819,532,12.2,469,10.8,11330,4573,6757,6.5,16,10206,4556,5650,6.4,14.4,1124,1.6,28.8,0,279,279,2009
1998,16580,3803,4367,72648,71982,419,9.6,415,9.5,11048,4508,6540,6.3,15.3,9716,3349,6367,4.7,13.5,1332,1.8,27,0,257,257,1507
1999,16580,3805,4384,73899,73072,403,9.2,389,8.9,10091,3486,6605,4.8,13.8,8437,2893,5544,4,11.5,1654,2.3,23,0,262,262,1375
2000,16580,3843,4429,76806,75255,450,10.2,404,9.2,11969,3812,8157,5.1,15.9,8867,2464,6403,3.3,11.8,3102,4.1,23.6,0,241,241,1041
2001,16580,3889,4513,77274,77083,428,9.6,375,8.4,9473,3537,5936,4.6,12.3,9090,2779,6311,3.6,11.8,383,0.5,23.6,0,213,213,1333
2002,16580,3860,4476,74412,75794,421,9.4,447,10,9926,3554,6372,4.7,13.1,12689,3571,9118,4.7,16.7,-2763,-3.6,26.2,0,226,227,1035
2003,16580,3800,4453,77627,75678,420,9.5,369,8.3,12525,4953,7572,6.5,16.6,8627,2593,6034,3.4,11.4,3898,5.2,22.8,0,251,254,1747
2004,16580,3830,4458,75999,76624,382,8.6,334,7.5,8219,2526,5693,3.3,10.7,9469,2822,6647,3.7,12.4,-1250,-1.7,21.4,0,192,192,1416
2005,16580,3874,4515,76699,76032,415,9.3,321,7.2,9559,3749,5810,4.9,12.6,8225,2069,6156,2.7,10.8,1334,1.8,21.6,0,214,216,1341
2006,16580,3868,4534,79300,77810,440,9.8,377,8.4,11646,5069,6577,6.5,15,8666,2624,6042,3.4,11.1,2980,3.9,22.2,0,243,243,1439
2007,16580,3915,4619,79619,79424,447,9.8,360,7.9,11953,4382,7571,5.5,15,11562,2774,8788,3.5,14.6,391,0.4,29.2,0,236,238,1643
2008,16580,3888,4577,76864,77051,371,8.1,360,7.9,9013,2352,6661,3.1,11.7,9386,2707,6679,3.5,12.2,-373,-0.5,23.4,0,250,250,1876
2009,16580,3826,4537,74806,75662,339,7.5,353,7.8,7733,3296,4437,4.4,10.2,9445,2691,6754,3.6,12.5,-1712,-2.3,20.4,0,251,252,1413
2010,16580,3800,4503,74176,74361,345,7.7,354,7.9,9407,4257,5150,5.7,12.7,9777,3243,6534,4.4,13.1,-370,-0.4,25.4,0,212,217,1705
2011,16580,3722,4443,72281,72920,355,8,387,8.7,9368,3057,6311,4.2,12.8,10645,2567,8078,3.5,14.6,-1277,-1.8,25.6,0,249,249,1466
2012,16580,3696,4405,73023,72183,351,8,375,8.5,9357,2401,6956,3.3,13,7677,2974,4703,4.1,10.6,1680,2.4,21.2,0,222,223,1311
2013,16580,3711,4417,72877,72896,354,8.1,333,7.6,8038,2577,5461,3.5,11,8075,2794,5281,3.8,11.1,-37,-0.1,22,0,205,208,1749
2014,16580,3711,4418,74867,73768,350,8,317,7.2,8235,2626,5609,3.6,11.2,6037,1777,4260,2.4,8.2,2198,3,16.4,0,225,225,1127
1977,16620,4973,5610,108950,99288,854,15.5,645,11.7,35083,8516,26567,8.6,35.3,15758,4758,11000,4.8,15.9,19325,19.4,31.8,0,420,420,2267
1978,16620,5066,5724,93758,101298,769,13.6,649,11.5,15690,5201,10489,5.1,15.5,30770,4369,26401,4.3,30.4,-15080,-14.9,31,0,428,428,2194
1979,16620,5113,5808,133760,113616,765,13.3,623,10.8,51222,5951,45271,5.2,45.1,10934,3521,7413,3.1,9.6,40288,35.5,19.2,0,431,431,1860
1980,16620,5077,5788,102232,117999,648,11.2,674,11.6,15182,5089,10093,4.3,12.9,46716,5725,40991,4.9,39.6,-31534,-26.7,25.8,0,466,468,2420
1981,16620,4836,5571,97987,99598,636,11.2,790,13.9,14278,5258,9020,5.3,14.3,17500,6481,11019,6.5,17.6,-3222,-3.3,28.6,0,486,486,2088
1982,16620,4735,5527,98073,97935,730,13.1,694,12.5,14990,6345,8645,6.5,15.3,14714,5227,9487,5.3,15,276,0.3,30,0,394,394,1805
1983,16620,4812,5616,90373,94372,618,11.1,625,11.2,10743,5059,5684,5.4,11.4,18741,4871,13870,5.2,19.9,-7998,-8.5,22.8,0,426,427,2306
1984,16620,4687,5501,87688,88447,731,13.2,795,14.3,14009,5964,8045,6.7,15.8,15527,7897,7630,8.9,17.6,-1518,-1.8,31.6,0,372,372,1915
1985,16620,5094,5924,91470,90184,750,13.1,414,7.2,14142,6629,7513,7.4,15.7,11569,3540,8029,3.9,12.8,2573,2.9,25.6,0,20,22,241
1986,16620,5148,5987,94029,92691,723,12.1,640,10.8,15399,7130,8269,7.7,16.6,12723,3888,8835,4.2,13.7,2676,2.9,27.4,0,409,409,1862
1987,16620,5168,6069,94714,94273,812,13.5,682,11.3,15504,6302,9202,6.7,16.4,14621,5038,9583,5.3,15.5,883,0.9,31,0,432,432,2598
1988,16620,5155,6069,94000,93925,683,11.3,662,10.9,15989,5878,10111,6.3,17,15840,5595,10245,6,16.9,149,0.1,33.8,0,424,424,2626
1989,16620,5217,6186,96438,94947,704,11.5,592,9.7,17110,7975,9135,8.4,18,14128,5333,8795,5.6,14.9,2982,3.1,29.8,0,383,383,2601
1990,16620,5298,6277,99685,97977,713,11.4,580,9.3,16203,6168,10035,6.3,16.5,12786,4744,8042,4.8,13.1,3417,3.4,26.2,0,394,394,2250
1991,16620,5398,6410,102334,100917,702,11.1,564,8.9,15552,6744,8808,6.7,15.4,12718,3898,8820,3.9,12.6,2834,2.8,25.2,0,340,341,2046
1992,16620,5517,6540,99394,100833,748,11.5,598,9.2,14734,5178,9556,5.1,14.6,17611,6030,11581,6,17.5,-2877,-2.9,29.2,0,342,349,1939
1993,16620,5576,6566,100665,99953,625,9.5,589,9,14465,3767,10698,3.8,14.5,13040,4106,8934,4.1,13,1425,1.5,26,0,365,368,1822
1994,16620,5694,6717,106710,103679,697,10.5,531,8,18191,5572,12619,5.4,17.5,12129,3741,8388,3.6,11.7,6062,5.8,23.4,0,329,329,1575
1995,16620,5864,6901,108709,107685,758,11.1,555,8.2,16440,4225,12215,3.9,15.3,14392,6120,8272,5.7,13.4,2048,1.9,26.8,0,365,365,1816
1996,16620,5909,6980,108843,108732,756,10.9,642,9.3,17548,7580,9968,7,16.1,17325,5575,11750,5.1,15.9,223,0.2,31.8,0,430,430,2199
1997,16620,5935,7100,113150,110906,830,11.8,716,10.2,20559,7500,13059,6.8,18.5,16071,4768,11303,4.3,14.5,4488,4,29,0,420,420,2277
1998,16620,5960,7149,113254,113227,773,10.9,702,9.9,17599,5811,11788,5.1,15.5,17545,5651,11894,5,15.5,54,0,31,0,436,436,2426
1999,16620,5974,7184,112778,112993,741,10.3,701,9.8,15793,6195,9598,5.5,14,16223,5263,10960,4.7,14.4,-430,-0.4,28,0,404,404,1896
2000,16620,5962,7222,117396,115067,737,10.2,699,9.7,18860,7171,11689,6.2,16.4,14202,4553,9649,4,12.3,4658,4.1,24.6,0,411,411,1888
2001,16620,5842,7079,116251,117136,635,8.9,829,11.6,17131,5168,11963,4.4,14.6,18901,6747,12154,5.8,16.1,-1770,-1.5,29.2,0,439,439,1907
2002,16620,5813,7106,121868,119184,787,11.1,768,10.8,24902,8428,16474,7.1,20.9,19534,6672,12862,5.6,16.4,5368,4.5,32.8,0,386,387,3195
2003,16620,5791,7094,118396,119116,688,9.8,552,7.8,16150,6152,9998,5.2,13.6,17589,3748,13841,3.1,14.8,-1439,-1.2,27.2,0,371,373,1978
2004,16620,5774,7091,117923,117445,659,9.3,596,8.4,17103,5957,11146,5.1,14.6,16146,4798,11348,4.1,13.7,957,0.9,27.4,0,382,382,2588
2005,16620,5763,7084,115123,116072,695,9.8,615,8.7,14818,4923,9895,4.2,12.8,16715,5245,11470,4.5,14.4,-1897,-1.6,25.6,0,394,394,2557
2006,16620,5691,7062,120483,117486,689,9.8,625,8.9,19077,7322,11755,6.2,16.2,13083,3712,9371,3.2,11.1,5994,5.1,22.2,0,402,402,2353
2007,16620,5631,7025,119982,120165,613,8.7,651,9.3,17935,5747,12188,4.8,14.9,18303,5734,12569,4.8,15.2,-368,-0.3,29.8,0,393,404,3349
2008,16620,5582,7001,117906,118144,578,8.3,552,7.9,14414,4950,9464,4.2,12.2,14890,3939,10951,3.3,12.6,-476,-0.4,24.4,0,393,393,2261
2009,16620,5474,6920,118334,117987,533,7.7,577,8.3,15099,5690,9409,4.8,12.8,14405,3589,10816,3,12.2,694,0.6,24.4,0,380,381,1829
2010,16620,5392,6844,115309,116740,457,6.7,507,7.4,13651,3711,9940,3.2,11.7,16512,4702,11810,4,14.1,-2861,-2.4,23.4,0,323,325,2958
2011,16620,5233,6702,113606,114202,449,6.7,538,8,11932,3222,8710,2.8,10.4,13123,3485,9638,3.1,11.5,-1191,-1.1,20.8,0,368,368,2206
2012,16620,5264,6712,115768,114559,483,7.2,474,7.1,17763,6262,11501,5.5,15.5,15345,5486,9859,4.8,13.4,2418,2.1,26.8,0,259,266,2306
2013,16620,5168,6602,115846,115512,416,6.3,512,7.7,14054,3699,10355,3.2,12.2,13385,4229,9156,3.7,11.6,669,0.6,23.2,0,308,308,1906
2014,16620,5023,6470,114262,114653,431,6.6,510,7.8,14425,4570,9855,4,12.6,15207,5815,9392,5.1,13.3,-782,-0.7,25.2,0,319,319,1840
1977,16700,5638,6313,80043,79386,1216,19.8,846,13.8,16913,8210,8703,10.3,21.3,15599,6320,9279,8,19.6,1314,1.7,39.2,0,580,585,3645
1978,16700,5958,6681,92686,86353,1110,17.1,743,11.4,25368,10567,14801,12.2,29.4,12702,6671,6031,7.7,14.7,12666,14.7,29.4,0,541,541,2754
1979,16700,6041,6827,96852,94686,1019,15.1,832,12.3,19046,6359,12687,6.7,20.1,14714,5860,8854,6.2,15.5,4332,4.6,31,0,630,630,3594
1980,16700,6168,6959,97622,97142,1008,14.6,839,12.2,18235,7754,10481,8,18.8,17275,6157,11118,6.3,17.8,960,1,35.6,0,586,586,3718
1981,16700,6028,6845,99227,97937,979,14.2,1056,15.3,20307,7805,12502,8,20.7,17726,8046,9680,8.2,18.1,2581,2.6,36.2,0,659,659,3942
1982,16700,6240,7228,101355,100213,1256,17.8,826,11.7,21623,11098,10525,11.1,21.6,19339,6561,12778,6.5,19.3,2284,2.3,38.6,0,530,530,3900
1983,16700,6035,7044,99001,99476,940,13.2,1013,14.2,19588,9544,10044,9.6,19.7,20537,9262,11275,9.3,20.6,-949,-0.9,39.4,0,597,599,4613
1984,16700,6769,7838,110610,104957,1244,16.7,570,7.7,23846,9513,14333,9.1,22.7,12540,4254,8286,4.1,11.9,11306,10.8,23.8,0,14,14,134
1985,16700,7191,8300,118513,114961,1375,17,939,11.6,24493,9895,14598,8.6,21.3,17389,8262,9127,7.2,15.1,7104,6.2,30.2,0,601,603,5023
1986,16700,7618,8828,128007,123178,1481,17.3,921,10.8,28248,12576,15672,10.2,22.9,18589,7195,11394,5.8,15.1,9659,7.8,30.2,0,602,602,3375
1987,16700,7892,9251,133756,131860,1589,17.6,1136,12.6,27612,13148,14464,10,20.9,23820,8619,15201,6.5,18.1,3792,2.8,36.2,0,715,717,5785
1988,16700,8025,9464,138777,136609,1470,15.7,1204,12.9,27141,11455,15686,8.4,19.9,22804,8690,14114,6.4,16.7,4337,3.2,33.4,0,820,820,4115
1989,16700,8211,9726,145541,142775,1361,14.2,1111,11.6,26814,10897,15917,7.6,18.8,21281,7996,13285,5.6,14.9,5533,3.9,29.8,0,745,746,4737
1990,16700,8434,9970,155600,150441,1391,14.1,1095,11.1,31476,11556,19920,7.7,20.9,21158,8893,12265,5.9,14.1,10318,6.8,28.2,0,742,743,4658
1991,16700,8826,10465,154282,154651,1494,14.6,1008,9.9,26269,11522,14747,7.5,17,27006,7720,19286,5,17.5,-737,-0.5,34,0,646,649,3936
1992,16700,8885,10563,158648,156568,1445,13.7,1294,12.3,32543,11397,21146,7.3,20.8,28382,10080,18302,6.4,18.1,4161,2.7,36.2,0,867,871,6327
1993,16700,9013,10644,161554,159962,1376,13,1270,12,27700,10395,17305,6.5,17.3,24515,9452,15063,5.9,15.3,3185,2,30.6,0,822,825,4680
1994,16700,9112,10792,166032,163612,1406,13.1,1217,11.4,29749,14614,15135,8.9,18.2,24908,9497,15411,5.8,15.2,4841,3,30.4,0,829,832,4689
1995,16700,9236,10926,170844,168287,1442,13.3,1271,11.7,28850,12398,16452,7.4,17.1,23737,8708,15029,5.2,14.1,5113,3,28.2,0,895,897,4990
1996,16700,9401,11116,176228,173652,1515,13.7,1285,11.7,29203,11893,17310,6.8,16.8,24052,8103,15949,4.7,13.9,5151,2.9,27.8,0,853,853,4144
1997,16700,9699,11499,187387,181925,1689,14.9,1328,11.7,36728,14136,22592,7.8,20.2,25804,10294,15510,5.7,14.2,10924,6,28.4,0,800,800,5034
1998,16700,9970,11810,202504,194903,1651,14.2,1304,11.2,42589,20966,21623,10.8,21.9,27387,12894,14493,6.6,14.1,15202,7.8,28.2,0,875,875,4753
1999,16700,10259,12177,212344,207596,1713,14.3,1329,11.1,36149,13180,22969,6.3,17.4,26653,10758,15895,5.2,12.8,9496,4.6,25.6,0,870,870,5755
2000,16700,10470,12411,232922,222722,1628,13.2,1393,11.3,48500,16991,31509,7.6,21.8,28100,11134,16966,5,12.6,20400,9.2,25.2,0,835,835,4775
2001,16700,10626,12670,227490,232539,1629,13,1473,11.7,36026,12820,23206,5.5,15.5,46123,13436,32687,5.8,19.8,-10097,-4.3,31,0,893,893,5650
2002,16700,10843,12949,214420,216576,1779,13.9,1484,11.6,36506,14661,21845,6.8,16.9,40817,11220,29597,5.2,18.8,-4311,-1.9,33.8,0,862,863,5031
2003,16700,11136,13326,222637,218322,1799,13.8,1202,9.2,40649,19925,20724,9.1,18.6,32018,8340,23678,3.8,14.7,8631,3.9,29.4,0,864,864,4908
2004,16700,11482,13724,228043,224430,1744,12.9,1232,9.1,37206,13337,23869,5.9,16.6,29979,9027,20952,4,13.4,7227,3.2,26.8,0,842,842,5227
2005,16700,11987,14391,236320,231489,2016,14.4,1267,9,39618,16568,23050,7.2,17.1,29956,10482,19474,4.5,12.9,9662,4.2,25.8,0,922,922,6366
2006,16700,12357,14863,245827,240449,2025,13.9,1416,9.7,41699,15370,26329,6.4,17.3,30944,9845,21099,4.1,12.9,10755,4.4,25.8,0,995,995,6341
2007,16700,12725,15456,257075,250973,2066,13.6,1443,9.5,47269,18619,28650,7.4,18.8,35064,10417,24647,4.2,14,12205,4.8,28,0,960,967,5310
2008,16700,12682,15499,258606,256522,1701,11,1517,9.8,39633,13451,26182,5.2,15.5,35464,9728,25736,3.8,13.8,4169,1.7,27.6,0,1092,1092,6320
2009,16700,12179,15028,242295,249289,1510,9.9,1819,12,31053,13638,17415,5.5,12.5,45040,13745,31295,5.5,18.1,-13987,-5.6,25,0,1256,1269,7943
2010,16700,11940,14803,236680,239113,1400,9.4,1548,10.4,29951,12895,17056,5.4,12.5,34816,10291,24525,4.3,14.6,-4865,-2.1,25,0,1022,1029,6857
2011,16700,11801,14721,244059,240036,1489,10.1,1437,9.8,35696,12761,22935,5.3,14.9,27649,10010,17639,4.2,11.5,8047,3.4,23,0,944,945,5129
2012,16700,12044,14981,252617,248179,1624,11,1376,9.3,41322,12968,28354,5.2,16.7,32445,10504,21941,4.2,13.1,8877,3.6,26.2,0,773,794,4713
2013,16700,12251,15149,256384,253219,1507,10,1320,8.8,33851,9923,23928,3.9,13.4,27521,8317,19204,3.3,10.9,6330,2.5,21.8,0,850,859,4757
2014,16700,12401,15362,264960,259933,1706,11.2,1382,9.1,35260,12557,22703,4.8,13.6,25205,8551,16654,3.3,9.7,10055,3.9,19.4,0,922,925,4290
1977,16740,14374,17080,345030,334857,2713,16.2,1959,11.7,62732,26973,35759,8.1,18.7,42386,14370,28016,4.3,12.7,20346,6,25.4,0,1313,1319,8203
1978,16740,14915,17718,362857,352062,2570,14.8,1939,11.1,63180,18693,44487,5.3,17.9,41589,15274,26315,4.3,11.8,21591,6.1,23.6,0,1315,1320,7707
1979,16740,15394,18303,383584,373121,2542,14.1,1871,10.4,64203,21586,42617,5.8,17.2,43277,15245,28032,4.1,11.6,20926,5.6,23.2,0,1286,1286,7130
1980,16740,15693,18690,398704,392192,2376,12.8,1912,10.3,58606,18449,40157,4.7,14.9,45582,12668,32914,3.2,11.6,13024,3.3,23.2,0,1298,1299,6354
1981,16740,15509,18495,394434,395782,2261,12.2,2330,12.5,56495,21010,35485,5.3,14.3,59191,21483,37708,5.4,15,-2696,-0.7,28.6,0,1337,1338,8283
1982,16740,15857,19100,395625,395019,2677,14.2,1952,10.4,55716,23074,32642,5.8,14.1,54503,15490,39013,3.9,13.8,1213,0.3,27.6,0,1146,1148,6745
1983,16740,15330,18553,390626,390624,2084,11.1,2417,12.8,58340,21879,36461,5.6,14.9,58336,17896,40440,4.6,14.9,4,0,29.8,0,1233,1236,6122
1984,16740,17292,20639,428220,409222,2979,15.2,1214,6.2,75300,22500,52800,5.5,18.4,37303,11032,26271,2.7,9.1,37997,9.3,18.2,0,48,49,412
1985,16740,18209,21603,441981,436617,3015,14.3,2059,9.7,69074,22467,46607,5.1,15.8,58346,17469,40877,4,13.4,10728,2.4,26.8,0,1263,1271,8139
1986,16740,19091,22636,478417,459917,3302,14.9,2188,9.9,94256,47339,46917,10.3,20.5,57256,18963,38293,4.1,12.4,37000,8.1,24.8,0,1378,1379,8790
1987,16740,19841,23794,486023,483375,3740,16.1,2510,10.8,90290,33162,57128,6.9,18.7,84995,28238,56757,5.8,17.6,5295,1.1,35.2,0,1493,1495,10973
1988,16740,20541,24737,505953,495856,3618,14.9,2595,10.7,91924,35906,56018,7.2,18.5,71729,25119,46610,5.1,14.5,20195,4,29,0,1611,1611,8233
1989,16740,21223,25584,528538,518435,3532,14,2716,10.8,94755,38213,56542,7.4,18.3,74548,27472,47076,5.3,14.4,20207,3.9,28.8,0,1666,1679,12521
1990,16740,21928,26414,544004,536005,3514,13.5,2556,9.8,90773,28851,61922,5.4,16.9,74774,27502,47272,5.1,14,15999,2.9,28,0,1649,1666,12119
1991,16740,22276,27073,529646,536638,3534,13.2,2856,10.7,75360,35374,39986,6.6,14,89344,26434,62910,4.9,16.6,-13984,-2.6,28,0,1732,1755,11736
1992,16740,22357,27290,535872,532007,3376,12.4,2995,11,97642,38383,59259,7.2,18.4,89912,41507,48405,7.8,16.9,7730,1.5,33.8,0,1861,1873,11993
1993,16740,22782,27694,551565,544736,3178,11.6,2708,9.9,91595,30102,61493,5.5,16.8,77936,28841,49095,5.3,14.3,13659,2.5,28.6,0,1739,1765,11035
1994,16740,23474,28525,578370,565157,3496,12.4,2578,9.2,94135,33669,60466,6,16.7,67708,24447,43261,4.3,12,26427,4.7,24,0,1680,1685,10459
1995,16740,24235,29520,608274,593457,3711,12.8,2625,9,99393,33363,66030,5.6,16.7,69758,24377,45381,4.1,11.8,29635,4.9,23.6,0,1695,1699,13422
1996,16740,25084,30529,622779,615235,4077,13.6,2937,9.8,104624,40897,63727,6.6,17,89536,27012,62524,4.4,14.6,15088,2.4,29.2,0,1807,1807,11042
1997,16740,26033,32776,646256,634699,5545,17.5,3314,10.5,125485,57145,68340,9,19.8,102370,33959,68411,5.4,16.1,23115,3.7,32.2,0,1918,1918,12025
1998,16740,26841,33057,667058,656450,4603,14,4249,12.9,120829,51034,69795,7.8,18.4,99613,44432,55181,6.8,15.2,21216,3.2,30.4,0,2051,2051,15965
1999,16740,27425,33684,689786,678063,4484,13.4,3776,11.3,140813,52808,88005,7.8,20.8,117366,53082,64284,7.8,17.3,23447,3.5,34.6,0,2154,2154,23758
2000,16740,27612,34196,716511,703876,4282,12.6,3784,11.2,130519,50314,80205,7.1,18.5,105251,40044,65207,5.7,15,25268,3.5,30,0,2222,2222,14946
2001,16740,28163,35057,781520,753525,4607,13.3,3956,11.4,180745,59305,121440,7.9,24,124756,41230,83526,5.5,16.6,55989,7.4,33.2,0,2152,2152,11853
2002,16740,28241,35424,771266,773554,4745,13.5,4343,12.3,130276,52670,77606,6.8,16.8,134851,42353,92498,5.5,17.4,-4575,-0.6,33.6,0,2263,2269,15281
2003,16740,28555,35873,764452,761117,4622,13,3417,9.6,134519,54991,79528,7.2,17.7,127849,42149,85700,5.5,16.8,6670,0.9,33.6,0,2222,2223,15629
2004,16740,29229,36591,735958,745028,4645,12.9,3427,9.5,110882,41444,69438,5.6,14.9,129021,41333,87688,5.5,17.3,-18139,-2.4,29.8,0,2119,2122,15314
2005,16740,30114,37745,774249,752376,5041,13.6,3509,9.5,136797,60801,75996,8.1,18.2,93051,31565,61486,4.2,12.4,43746,5.8,24.8,0,2273,2291,16338
2006,16740,30950,39155,822903,796051,5379,14,3660,9.5,148171,57214,90957,7.2,18.6,94467,31987,62480,4,11.9,53704,6.7,23.8,0,2414,2416,17749
2007,16740,31965,40995,869007,844157,5881,14.7,3928,9.8,169345,57429,111916,6.8,20.1,119644,38519,81125,4.6,14.2,49701,5.9,28.4,0,2349,2373,15055
2008,16740,32227,41693,870155,865143,5053,12.3,3914,9.5,132308,47806,84502,5.5,15.3,122283,35931,86352,4.2,14.1,10025,1.2,28.2,0,2666,2667,19447
2009,16740,30831,40240,813467,835255,3976,9.7,4805,11.8,93733,37727,56006,4.5,11.2,137308,36533,100775,4.4,16.4,-43575,-5.2,22.4,0,3150,3176,20915
2010,16740,30419,39681,793601,798921,4291,10.8,4464,11.2,116641,40319,76322,5,14.6,127281,33066,94215,4.1,15.9,-10640,-1.3,29.2,0,2641,2649,16488
2011,16740,30192,39412,813385,801662,4194,10.6,4076,10.3,109876,34405,75471,4.3,13.7,86429,27743,58686,3.5,10.8,23447,2.9,21.6,0,2619,2651,15869
2012,16740,30814,40237,860725,836376,4802,12.1,3938,9.9,141672,39844,101828,4.8,16.9,92973,31390,61583,3.8,11.1,48699,5.8,22.2,0,2188,2200,13634
2013,16740,31395,41017,872128,864275,4377,10.8,3594,8.9,129205,39111,90094,4.5,14.9,113499,26187,87312,3,13.1,15706,1.8,26.2,0,2255,2259,13590
2014,16740,31850,41484,823106,844776,4542,11.1,3681,9,109543,33495,76048,4,13,152882,75498,77384,8.9,18.1,-43339,-5.1,26,0,2444,2451,16695
1977,16820,2125,2290,30816,38403,371,16.5,277,12.3,5411,2553,2858,6.6,14.1,20584,1502,19082,3.9,53.6,-15173,-39.5,28.2,0,174,175,770
1978,16820,2234,2409,32279,31551,385,16.4,266,11.3,5620,1841,3779,5.8,17.8,4163,2270,1893,7.2,13.2,1457,4.6,26.4,0,201,202,1837
1979,16820,2293,2466,35556,33892,361,14.8,289,11.9,6903,2124,4779,6.3,20.4,3574,1595,1979,4.7,10.5,3329,9.9,21,0,212,212,1025
1980,16820,2350,2530,36596,36062,365,14.6,297,11.9,5752,2184,3568,6.1,16,4683,1293,3390,3.6,13,1069,3,26,0,205,205,862
1981,16820,2294,2474,35934,35815,334,13.4,356,14.3,5894,3371,2523,9.4,16.5,5656,2436,3220,6.8,15.8,238,0.7,31.6,0,206,206,1165
1982,16820,2381,2599,37445,36671,432,17,286,11.3,7074,3368,3706,9.2,19.3,5525,1726,3799,4.7,15.1,1549,4.2,30.2,0,160,160,1128
1983,16820,2436,2651,37359,37454,305,11.6,275,10.5,5122,1838,3284,4.9,13.7,5311,1806,3505,4.8,14.2,-189,-0.5,27.4,0,184,184,898
1984,16820,2426,2652,40212,38739,366,13.8,345,13,6977,2550,4427,6.6,18,4030,1744,2286,4.5,10.4,2947,7.6,20.8,0,205,205,1086
1985,16820,2707,2948,41715,41280,423,15.1,161,5.7,6294,3056,3238,7.4,15.2,5424,1441,3983,3.5,13.1,870,2.1,26.2,0,10,10,204
1986,16820,2826,3068,43200,42400,398,13.2,263,8.7,5952,2611,3341,6.2,14,4352,1414,2938,3.3,10.3,1600,3.7,20.6,0,174,174,910
1987,16820,2967,3215,47134,45233,494,15.7,337,10.7,9135,3619,5516,8,20.2,5332,2486,2846,5.5,11.8,3803,8.4,23.6,0,222,223,1434
1988,16820,3070,3322,51269,48633,477,14.6,355,10.9,11570,6984,4586,14.4,23.8,6298,2523,3775,5.2,13,5272,10.8,26,0,233,233,1147
1989,16820,3182,3468,54813,53054,495,14.6,355,10.5,9923,3882,6041,7.3,18.7,6405,2965,3440,5.6,12.1,3518,6.6,24.2,0,249,250,1940
1990,16820,3267,3557,56066,55348,449,12.8,326,9.3,8015,3051,4964,5.5,14.5,6578,2424,4154,4.4,11.9,1437,2.6,23.8,0,213,213,1670
1991,16820,3309,3618,52984,54635,449,12.5,379,10.6,6080,2279,3801,4.2,11.1,9381,3285,6096,6,17.2,-3301,-6.1,22.2,0,235,235,2185
1992,16820,3366,3682,52627,52692,457,12.5,360,9.9,6527,2184,4343,4.1,12.4,6656,1928,4728,3.7,12.6,-129,-0.2,24.8,0,247,247,1237
1993,16820,3428,3751,54887,53733,417,11.2,331,8.9,7862,2805,5057,5.2,14.6,5553,1898,3655,3.5,10.3,2309,4.3,20.6,0,232,232,1314
1994,16820,3508,3844,57917,56401,462,12.2,369,9.7,9663,4032,5631,7.1,17.1,6630,2955,3675,5.2,11.8,3033,5.3,23.6,0,259,259,1490
1995,16820,3644,3999,58717,58211,501,12.8,323,8.2,8101,3370,4731,5.8,13.9,7089,1934,5155,3.3,12.2,1012,1.7,24.4,0,227,227,1130
1996,16820,3746,4097,60060,59390,496,12.2,399,9.9,7850,3158,4692,5.3,13.2,6509,1942,4567,3.3,11,1341,2.2,22,0,267,267,1273
1997,16820,3857,4225,62820,61434,545,13.1,408,9.8,9624,3300,6324,5.4,15.7,6852,2256,4596,3.7,11.2,2772,4.5,22.4,0,272,272,1278
1998,16820,3938,4311,65742,64283,499,11.7,415,9.7,9875,3560,6315,5.5,15.4,6957,2588,4369,4,10.8,2918,4.6,21.6,0,271,271,1211
1999,16820,3980,4374,67840,66667,492,11.3,424,9.8,9946,3626,6320,5.4,14.9,7600,2644,4956,4,11.4,2346,3.5,22.8,0,270,270,1618
2000,16820,4035,4432,69840,68856,498,11.3,436,9.9,9682,3496,6186,5.1,14.1,7714,2348,5366,3.4,11.2,1968,2.9,22.4,0,274,274,1102
2001,16820,4134,4548,70090,70130,509,11.3,438,9.7,9131,3020,6111,4.3,13,9210,3948,5262,5.6,13.1,-79,-0.1,26,0,265,265,1893
2002,16820,4238,4667,70534,70234,592,12.9,464,10.1,10595,4221,6374,6,15.1,9995,3245,6750,4.6,14.2,600,0.9,28.4,0,264,264,1491
2003,16820,4280,4734,70467,70206,530,11.3,391,8.4,9320,3222,6098,4.6,13.3,8798,2450,6348,3.5,12.5,522,0.8,25,0,255,255,1557
2004,16820,4439,4895,70594,70372,565,11.8,372,7.7,9056,3415,5641,4.9,12.9,8611,3250,5361,4.6,12.2,445,0.7,24.4,0,246,246,1373
2005,16820,4595,5077,72832,71527,610,12.3,392,7.9,9888,3729,6159,5.2,13.8,7278,2351,4927,3.3,10.2,2610,3.6,20.4,0,284,284,1526
2006,16820,4663,5162,76416,74358,599,11.7,491,9.6,12027,4107,7920,5.5,16.2,7910,3473,4437,4.7,10.6,4117,5.6,21.2,0,354,354,1886
2007,16820,4754,5242,77006,76659,600,11.6,498,9.6,11367,3973,7394,5.2,14.8,10672,3426,7246,4.5,13.9,695,0.9,27.8,0,319,320,1532
2008,16820,4731,5241,78705,77682,519,9.9,489,9.4,10051,3317,6734,4.3,12.9,8004,2190,5814,2.8,10.3,2047,2.6,20.6,0,350,351,1713
2009,16820,4593,5113,75890,76826,440,8.5,529,10.2,8369,3129,5240,4.1,10.9,10241,2301,7940,3,13.3,-1872,-2.4,21.8,0,370,370,1639
2010,16820,4497,5027,75251,75470,403,8,467,9.2,8305,3457,4848,4.6,11,8743,2043,6700,2.7,11.6,-438,-0.6,22,0,306,306,1140
2011,16820,4453,5014,75735,75382,484,9.7,474,9.5,9222,3705,5517,4.9,12.2,8516,2484,6032,3.3,11.3,706,0.9,22.6,0,338,338,1393
2012,16820,4496,5059,76107,75803,479,9.5,443,8.8,9200,2724,6476,3.6,12.1,8591,3042,5549,4,11.3,609,0.8,22.6,0,267,267,1519
2013,16820,4529,5134,77914,76767,467,9.2,396,7.8,10286,3408,6878,4.4,13.4,7992,2273,5719,3,10.4,2294,3,20.8,0,249,249,1599
2014,16820,4579,5189,73320,72133,498,9.7,415,8.1,9693,3430,6263,4.8,13.4,7318,2614,4704,3.6,10.1,2375,3.3,20.2,0,265,266,1111
1977,16860,6353,7390,132647,131514,1207,16.7,901,12.4,23330,10068,13262,7.7,17.7,21064,7780,13284,5.9,16,2266,1.7,32,0,606,609,4422
1978,16860,6526,7582,138843,135752,1070,14.3,877,11.7,24118,7729,16389,5.7,17.8,17936,8363,9573,6.2,13.2,6182,4.6,26.4,0,585,588,3682
1979,16860,6564,7643,143117,141008,1014,13.3,911,12,22395,6977,15418,4.9,15.9,18176,6034,12142,4.3,12.9,4219,3,25.8,0,622,627,2969
1980,16860,6608,7706,139629,141289,981,12.8,889,11.6,20372,7451,12921,5.3,14.4,23691,7742,15949,5.5,16.8,-3319,-2.4,28.8,0,623,624,3538
1981,16860,6449,7530,131684,135250,919,12.1,1012,13.3,18042,7887,10155,5.8,13.3,25173,11253,13920,8.3,18.6,-7131,-5.3,26.6,0,603,603,4651
1982,16860,6477,7676,129654,130510,1143,15,909,12,20125,10477,9648,8,15.4,21837,7179,14658,5.5,16.7,-1712,-1.3,30.8,0,517,518,2659
1983,16860,6543,7704,130173,129473,925,12,944,12.3,20548,8620,11928,6.7,15.9,19147,6962,12185,5.4,14.8,1401,1.1,29.6,0,595,596,3111
1984,16860,6872,8041,135960,133150,1198,15.2,853,10.8,22344,8615,13729,6.5,16.8,16724,6412,10312,4.8,12.6,5620,4.2,25.2,0,538,541,2817
1985,16860,7045,8239,142992,139756,1094,13.4,908,11.1,23157,7954,15203,5.7,16.6,16685,6447,10238,4.6,11.9,6472,4.7,23.8,0,592,593,2603
1986,16860,7286,8502,148758,145812,1153,13.8,857,10.2,26423,11182,15241,7.7,18.1,20531,7317,13214,5,14.1,5892,4,28.2,0,572,572,4253
1987,16860,7502,8791,157809,153511,1276,14.7,943,10.9,31235,10746,20489,7,20.3,22639,9986,12653,6.5,14.7,8596,5.6,29.4,0,621,623,4521
1988,16860,7542,8895,162563,159586,1157,13.1,1010,11.4,29159,12157,17002,7.6,18.3,23204,8943,14261,5.6,14.5,5955,3.8,29,0,648,648,3518
1989,16860,7688,9144,169905,166449,1143,12.7,921,10.2,32172,12453,19719,7.5,19.3,25259,9768,15491,5.9,15.2,6913,4.1,30.4,0,582,586,4368
1990,16860,7785,9265,168512,169065,1092,11.9,910,9.9,24804,10501,14303,6.2,14.7,25909,7261,18648,4.3,15.3,-1105,-0.6,29.4,0,598,601,4174
1991,16860,7917,9459,171007,169850,1166,12.5,971,10.4,30414,15291,15123,9,17.9,28099,9840,18259,5.8,16.5,2315,1.4,33,0,588,589,5368
1992,16860,8000,9552,166714,168592,1159,12.2,1024,10.8,25684,8005,17679,4.7,15.2,29440,9501,19939,5.6,17.5,-3756,-2.3,30.4,0,647,658,4164
1993,16860,8160,9669,170631,168734,1045,10.9,906,9.4,27940,9602,18338,5.7,16.6,24146,8180,15966,4.8,14.3,3794,2.3,28.6,0,579,579,3519
1994,16860,8267,9792,174934,172763,1106,11.4,953,9.8,25608,8592,17016,5,14.8,21266,8356,12910,4.8,12.3,4342,2.5,24.6,0,659,662,4269
1995,16860,8391,9904,180916,177926,1138,11.6,994,10.1,26790,9141,17649,5.1,15.1,20809,7561,13248,4.2,11.7,5981,3.4,23.4,0,643,643,3670
1996,16860,8486,10066,183358,182125,1205,12.1,1012,10.1,29625,13564,16061,7.4,16.3,27158,9149,18009,5,14.9,2467,1.4,29.8,0,691,691,5069
1997,16860,8581,10273,193096,188195,1265,12.4,1074,10.5,34749,13168,21581,7,18.5,24946,7793,17153,4.1,13.3,9803,5.2,26.6,0,714,714,4172
1998,16860,8627,10355,200381,196708,1206,11.7,1090,10.6,31006,12267,18739,6.2,15.8,23659,8487,15172,4.3,12,7347,3.8,24,0,730,730,3813
1999,16860,8584,10352,205595,202875,1114,10.8,1108,10.7,33595,11741,21854,5.8,16.6,28155,10720,17435,5.3,13.9,5440,2.7,27.8,0,734,734,5064
2000,16860,8522,10333,211895,208694,1103,10.7,1123,10.9,32953,9883,23070,4.7,15.8,26551,9356,17195,4.5,12.7,6402,3.1,25.4,0,687,687,3318
2001,16860,8455,10301,209722,211034,1028,10,1136,11,27670,10436,17234,4.9,13.1,30293,11977,18316,5.7,14.4,-2623,-1.3,26.2,0,665,665,5807
2002,16860,8459,10286,208227,208144,1230,12,1221,11.9,30583,13108,17475,6.3,14.7,30417,11465,18952,5.5,14.6,166,0.1,29.2,0,655,659,4605
2003,16860,8490,10311,206638,205382,1171,11.4,962,9.4,28559,11275,17284,5.5,13.9,26047,7091,18956,3.5,12.7,2512,1.2,25.4,0,671,674,3827
2004,16860,8569,10423,208438,206466,1059,10.2,841,8.1,27894,11005,16889,5.3,13.5,23949,8084,15865,3.9,11.6,3945,1.9,23.2,0,574,574,3621
2005,16860,8657,10587,214938,210702,1163,11.1,889,8.5,33122,10323,22799,4.9,15.7,24649,7289,17360,3.5,11.7,8473,4,23.4,0,637,637,4520
2006,16860,8667,10649,218933,216678,1159,10.9,1001,9.5,28774,11330,17444,5.2,13.3,24264,8697,15567,4,11.2,4510,2.1,22.4,0,688,689,5008
2007,16860,8754,10799,223755,222860,1166,10.9,1003,9.4,36587,10714,25873,4.8,16.4,34797,11746,23051,5.3,15.6,1790,0.8,31.2,0,637,640,5051
2008,16860,8653,10760,223894,221533,1013,9.4,954,8.9,32876,10044,22832,4.5,14.8,28154,9975,18179,4.5,12.7,4722,2.1,25.4,0,760,760,7711
2009,16860,8362,10470,205493,213605,819,7.7,1000,9.5,18327,7313,11014,3.4,8.6,34550,5694,28856,2.7,16.2,-16223,-7.6,17.2,0,735,735,3945
2010,16860,8258,10321,196840,200620,776,7.5,873,8.4,21567,7399,14168,3.7,10.8,29127,6387,22740,3.2,14.5,-7560,-3.7,21.6,0,600,606,3523
2011,16860,8125,10166,206352,201155,811,7.9,891,8.7,31313,6984,24329,3.5,15.6,20919,4708,16211,2.3,10.4,10394,5.2,20.8,0,615,615,2768
2012,16860,8177,10219,213212,209878,866,8.5,830,8.2,28848,9349,19499,4.5,13.7,22179,6040,16139,2.9,10.6,6669,3.1,21.2,0,513,515,2825
2013,16860,8220,10275,206168,209283,824,8.1,747,7.3,21826,6070,15756,2.9,10.4,28055,5700,22355,2.7,13.4,-6229,-3,20.8,0,533,538,3547
2014,16860,8199,10261,211554,208466,852,8.3,771,7.5,27989,5848,22141,2.8,13.4,21812,5150,16662,2.5,10.5,6177,2.9,21,0,548,552,3328
1977,16940,1324,1419,15586,15105,294,21.6,176,12.9,4040,2092,1948,13.8,26.7,3078,1520,1558,10.1,20.4,962,6.3,40.8,0,117,117,1032
1978,16940,1320,1409,17079,16291,267,18.9,264,18.7,4616,1791,2825,11,28.3,3039,2153,886,13.2,18.7,1577,9.6,37.4,0,165,165,1027
1979,16940,1419,1517,18877,18067,227,15.5,127,8.7,4308,1728,2580,9.6,23.8,2687,886,1801,4.9,14.9,1621,8.9,29.8,0,5,5,81
1980,16940,1420,1517,18680,18748,194,12.8,181,11.9,3345,1353,1992,7.2,17.8,3480,1374,2106,7.3,18.6,-135,-0.8,35.6,0,127,128,972
1981,16940,1387,1482,18677,18667,207,13.8,233,15.5,4137,1790,2347,9.6,22.2,4117,1757,2360,9.4,22.1,20,0.1,44.2,0,152,152,1010
1982,16940,1409,1533,18088,18255,265,17.6,189,12.5,3466,2095,1371,11.5,19,3800,1257,2543,6.9,20.8,-334,-1.8,38,0,106,106,739
1983,16940,1436,1548,18188,17635,179,11.6,187,12.1,4283,2210,2073,12.5,24.3,3176,1216,1960,6.9,18,1107,6.3,36,0,130,130,653
1984,16940,1496,1617,18733,18823,234,14.8,169,10.7,3806,2013,1793,10.7,20.2,3986,1252,2734,6.7,21.2,-180,-1,40.4,0,103,103,664
1985,16940,1529,1642,19606,19124,221,13.6,191,11.7,4054,2303,1751,12,21.2,3090,1358,1732,7.1,16.2,964,5,32.4,0,116,117,706
1986,16940,1554,1666,19852,19341,226,13.7,191,11.6,4087,1933,2154,10,21.1,3064,1254,1810,6.5,15.8,1023,5.3,31.6,0,127,127,872
1987,16940,1544,1660,19766,20104,222,13.3,224,13.5,3269,1390,1879,6.9,16.3,3944,1341,2603,6.7,19.6,-675,-3.3,32.6,0,131,132,855
1988,16940,1531,1660,19738,19739,199,12,194,11.7,3328,1335,1993,6.8,16.9,3329,1268,2061,6.4,16.9,-1,0,33.8,0,130,130,719
1989,16940,1532,1668,20442,20071,179,10.8,162,9.7,3531,1471,2060,7.3,17.6,2789,1210,1579,6,13.9,742,3.7,27.8,0,104,104,812
1990,16940,1513,1653,20901,20663,164,9.9,165,9.9,3649,1471,2178,7.1,17.7,3172,1334,1838,6.5,15.4,477,2.3,30.8,0,107,107,562
1991,16940,1553,1696,21122,21003,177,10.6,135,8.1,3017,1061,1956,5.1,14.4,2779,772,2007,3.7,13.2,238,1.2,26.4,0,86,86,467
1992,16940,1575,1716,21687,21397,195,11.4,163,9.5,3840,1158,2682,5.4,17.9,3260,1234,2026,5.8,15.2,580,2.7,30.4,0,88,89,807
1993,16940,1621,1755,23345,22498,217,12.5,171,9.9,4749,2442,2307,10.9,21.1,3054,948,2106,4.2,13.6,1695,7.5,27.2,0,118,119,753
1994,16940,1699,1844,24320,23824,223,12.4,129,7.2,3831,1514,2317,6.4,16.1,2839,724,2115,3,11.9,992,4.2,23.8,0,90,90,493
1995,16940,1723,1856,24606,24447,218,11.8,195,10.5,4150,1066,3084,4.4,17,3831,1426,2405,5.8,15.7,319,1.3,31.4,0,132,132,581
1996,16940,1780,1917,24199,24398,253,13.4,191,10.1,3920,1324,2596,5.4,16.1,4318,1277,3041,5.2,17.7,-398,-1.6,32.2,0,127,127,598
1997,16940,1812,1935,24564,24345,268,13.9,241,12.5,4705,1882,2823,7.7,19.3,4266,1434,2832,5.9,17.5,439,1.8,35,0,136,136,559
1998,16940,1879,2013,24615,24598,281,14.2,201,10.2,4289,1938,2351,7.9,17.4,4255,1890,2365,7.7,17.3,34,0.1,34.6,0,149,149,966
1999,16940,1878,2021,25981,25310,236,11.7,229,11.4,4985,1681,3304,6.6,19.7,3642,1689,1953,6.7,14.4,1343,5.3,28.8,0,159,159,754
2000,16940,1895,2032,26821,26391,213,10.5,202,10,4525,1569,2956,5.9,17.1,3665,1511,2154,5.7,13.9,860,3.2,27.8,0,132,132,719
2001,16940,1916,2072,26871,26848,248,12.1,227,11,4090,1556,2534,5.8,15.2,4044,1303,2741,4.9,15.1,46,0.1,30.2,0,137,137,611
2002,16940,1962,2132,27521,27269,307,14.6,245,11.7,4831,2501,2330,9.2,17.7,4327,1483,2844,5.4,15.9,504,1.8,31.8,0,137,137,665
2003,16940,1998,2165,28078,27580,261,12.2,199,9.3,5045,1699,3346,6.2,18.3,4048,1520,2528,5.5,14.7,997,3.6,29.4,0,144,144,883
2004,16940,2027,2196,28919,28381,257,11.8,204,9.4,4931,2094,2837,7.4,17.4,3855,1016,2839,3.6,13.6,1076,3.8,27.2,0,135,135,564
2005,16940,2066,2237,29110,28988,231,10.4,184,8.3,4063,1109,2954,3.8,14,3818,714,3104,2.5,13.2,245,0.8,26.4,0,124,124,490
2006,16940,2131,2298,30575,29771,281,12.4,199,8.8,5087,1748,3339,5.9,17.1,3479,1106,2373,3.7,11.7,1608,5.4,23.4,0,130,130,613
2007,16940,2130,2309,30762,30610,237,10.3,215,9.3,4433,1192,3241,3.9,14.5,4129,1462,2667,4.8,13.5,304,1,27,0,147,148,680
2008,16940,2183,2372,32383,31494,282,12.1,205,8.8,5489,2390,3099,7.6,17.4,3710,926,2784,2.9,11.8,1779,5.6,23.6,0,125,125,562
2009,16940,2200,2392,30076,30336,257,10.8,210,8.9,3676,1138,2538,3.8,12.1,4196,863,3333,2.8,13.8,-520,-1.7,24.2,0,140,140,556
2010,16940,2210,2402,29267,29618,240,10,211,8.8,3108,1190,1918,4,10.5,3809,959,2850,3.2,12.9,-701,-2.4,21,0,139,139,687
2011,16940,2271,2466,29332,29235,296,12.2,223,9.2,3807,1372,2435,4.7,13,3612,1285,2327,4.4,12.4,195,0.6,24.8,0,135,135,811
2012,16940,2354,2558,30278,29717,323,12.9,234,9.3,4528,1666,2862,5.6,15.2,3405,998,2407,3.4,11.5,1123,3.7,23,0,150,151,575
2013,16940,2371,2584,31633,30918,290,11.3,270,10.5,4435,1808,2627,5.8,14.3,3004,1075,1929,3.5,9.7,1431,4.6,19.4,0,174,174,884
2014,16940,2462,2689,32939,32234,327,12.4,208,7.9,5053,1712,3341,5.3,15.7,3643,1322,2321,4.1,11.3,1410,4.4,22.6,0,140,140,521
1977,16980,119839,139055,3015506,2920000,20843,15.2,16980,12.4,580008,224655,355353,7.7,19.9,388995,145447,243548,5,13.3,191013,6.6,26.6,0,11209,11295,74180
1978,16980,121739,141322,3139266,3076948,18573,13.2,16394,11.7,553091,160431,392660,5.2,18,428456,155643,272813,5.1,13.9,124635,4.1,27.8,0,11116,11189,71593
1979,16980,122840,143018,3252800,3193530,18489,13,15899,11.2,563595,176798,386797,5.5,17.6,445054,161897,283157,5.1,13.9,118541,3.7,27.8,0,10901,10931,75630
1980,16980,123961,144453,3211528,3231538,17676,12.3,15910,11.1,450518,162046,288472,5,13.9,490540,147513,343027,4.6,15.2,-40022,-1.3,27.8,0,11024,11068,67042
1981,16980,120352,140201,3062083,3116186,16603,11.7,19562,13.8,441682,177362,264320,5.7,14.2,549889,200976,348913,6.4,17.6,-108207,-3.4,28.4,0,11255,11343,81010
1982,16980,122203,144101,3003997,3032340,20253,14.2,15400,10.8,469124,222498,246626,7.3,15.5,525811,159695,366116,5.3,17.3,-56687,-1.8,31,0,8634,8648,57526
1983,16980,119668,141626,2879267,2938105,16161,11.3,18375,12.9,412510,157298,255212,5.4,14,530185,177926,352259,6.1,18,-117675,-4,28,0,9844,9908,62872
1984,16980,126737,149206,3077072,2983660,19200,13.2,12831,8.8,543254,186540,356714,6.3,18.2,356429,124887,231542,4.2,11.9,186825,6.3,23.8,0,5803,5840,32281
1985,16980,129647,152497,3154296,3122283,19079,12.6,16221,10.7,518521,191739,326782,6.1,16.6,454495,172446,282049,5.5,14.6,64026,2,29.2,0,10191,10237,72589
1986,16980,133424,156992,3256544,3203255,20547,13.3,15681,10.1,565529,218656,346873,6.8,17.7,458951,168362,290589,5.3,14.3,106578,3.4,28.6,0,9813,9835,76259
1987,16980,136260,161131,3262086,3270076,22479,14.1,17788,11.2,536731,205997,330734,6.3,16.4,552711,213006,339705,6.5,16.9,-15980,-0.5,32.8,0,10909,10996,78589
1988,16980,138187,164346,3387291,3308855,20988,12.9,16879,10.4,611563,219404,392159,6.6,18.5,454690,169859,284831,5.1,13.7,156873,4.8,27.4,0,10873,10873,70899
1989,16980,140941,168493,3503029,3448007,20945,12.6,16954,10.2,598927,232670,366257,6.7,17.4,488883,164790,324093,4.8,14.2,110044,3.2,28.4,0,10736,10920,86057
1990,16980,143976,172189,3574574,3535259,20344,11.9,15838,9.3,547088,193557,353531,5.5,15.5,468457,147321,321136,4.2,13.3,78631,2.2,26.6,0,10470,10523,76355
1991,16980,146579,176276,3547483,3560585,21071,12.1,17126,9.8,524642,215073,309569,6,14.7,550845,171230,379615,4.8,15.5,-26203,-0.8,29.4,0,10606,10730,86657
1992,16980,147880,178624,3566472,3548167,21282,12,18166,10.2,604183,225666,378517,6.4,17,567573,183589,383984,5.2,16,36610,1,32,0,11100,11290,86089
1993,16980,150630,180987,3571533,3565085,19730,11,16894,9.4,554188,191259,362929,5.4,15.5,541293,163297,377996,4.6,15.2,12895,0.3,30.4,0,10770,10839,71304
1994,16980,153211,184209,3639681,3604183,20567,11.3,16881,9.2,549822,192902,356920,5.4,15.3,478826,156394,322432,4.3,13.3,70996,2,26.6,0,10951,10996,70453
1995,16980,156477,188246,3738671,3688336,21858,11.7,17293,9.3,585805,203913,381892,5.5,15.9,485136,159768,325368,4.3,13.2,100669,2.7,26.4,0,10989,11054,76075
1996,16980,158830,191089,3810325,3774165,21759,11.5,18672,9.8,589477,211569,377908,5.6,15.6,517157,163874,353283,4.3,13.7,72320,1.9,27.4,0,11730,11731,72327
1997,16980,160473,193382,3886186,3849801,23083,12,20640,10.7,648788,220929,427859,5.7,16.9,576019,211021,364998,5.5,15,72769,1.9,30,0,12157,12157,89577
1998,16980,162207,196045,3980265,3931788,21873,11.2,18859,9.7,630261,210822,419439,5.4,16,533307,180688,352619,4.6,13.6,96954,2.4,27.2,0,12033,12033,84806
1999,16980,163274,198010,4075064,4024252,21298,10.8,19280,9.8,638349,221572,416777,5.5,15.9,536726,193267,343459,4.8,13.3,101623,2.6,26.6,0,11898,11898,77344
2000,16980,163709,199565,4190651,4132883,21802,11,20210,10.2,695927,242705,453222,5.9,16.8,580391,227134,353257,5.5,14,115536,2.8,28,0,11904,11904,91461
2001,16980,164409,201166,4179325,4193379,21194,10.6,20850,10.4,629350,236081,393269,5.6,15,657459,220299,437160,5.3,15.7,-28109,-0.7,30,0,11932,11950,81941
2002,16980,163706,200867,4034685,4101853,24031,12,24105,12,648828,269850,378978,6.6,15.8,783164,248803,534361,6.1,19.1,-134336,-3.3,31.6,0,11846,11888,85907
2003,16980,164820,202470,4047320,4015606,23312,11.6,18497,9.2,624487,211147,413340,5.3,15.6,561058,178006,383052,4.4,14,63429,1.6,28,0,11822,11908,90408
2004,16980,166964,204452,4073281,4043949,22928,11.3,19052,9.4,620124,200082,420042,4.9,15.3,561459,176001,385458,4.4,13.9,58665,1.4,27.8,0,11607,11688,84826
2005,16980,169821,208226,4083286,4068400,24906,12.1,19204,9.3,607700,233875,373825,5.7,14.9,577927,181187,396740,4.5,14.2,29773,0.7,28.4,0,12040,12079,99866
2006,16980,171775,211645,4168153,4115875,25255,12.1,20131,9.6,651549,244030,407519,5.9,15.8,546994,208537,338457,5.1,13.3,104555,2.5,26.6,0,12712,12732,113175
2007,16980,173448,214395,4196191,4177948,24411,11.5,21155,9.9,667731,229079,438652,5.5,16,631245,203912,427333,4.9,15.1,36486,0.9,30.2,0,12497,12597,92452
2008,16980,172537,214525,4279405,4222755,22685,10.6,20764,9.7,650418,220044,430374,5.2,15.4,537117,155142,381975,3.7,12.7,113301,2.7,25.4,0,13688,13709,86943
2009,16980,167076,208302,3986689,4120162,19204,9.1,23318,11.1,435259,162602,272657,3.9,10.6,702206,181175,521031,4.4,17,-266947,-6.4,21.2,0,14480,14510,91942
2010,16980,164738,205510,3849775,3907612,19652,9.5,20871,10.1,440296,155601,284695,4,11.3,555969,158578,397391,4.1,14.2,-115673,-2.9,22.6,0,12433,12482,82153
2011,16980,164661,205627,3905753,3870814,21057,10.3,19634,9.6,502767,158734,344033,4.1,13,432891,133653,299238,3.5,11.2,69876,1.8,22.4,0,11920,12068,77304
2012,16980,166594,207290,3966879,3930341,21719,10.5,19840,9.6,544726,168088,376638,4.3,13.9,471650,163578,308072,4.2,12,73076,1.9,24,0,11068,11171,68363
2013,16980,167754,208618,4077463,4016782,20621,9.9,19334,9.3,557071,179540,377531,4.5,13.9,435709,148001,287708,3.7,10.8,121362,3.1,21.6,0,11296,11366,78762
2014,16980,168481,209654,4151718,4098616,21461,10.3,18854,9,573864,202435,371429,4.9,14,467660,164900,302760,4,11.4,106204,2.6,22.8,0,12063,12106,75768
1977,17020,2577,2767,24330,22727,655,25,351,13.4,6744,3625,3119,16,29.7,3538,1947,1591,8.6,15.6,3206,14.1,31.2,0,241,241,1282
1978,17020,2641,2837,26865,25580,517,18.5,439,15.7,6639,2385,4254,9.3,26,4069,2176,1893,8.5,15.9,2570,10.1,31.8,0,277,279,1233
1979,17020,2837,3050,29286,28024,630,21.4,390,13.3,8168,3375,4793,12,29.1,5644,2315,3329,8.3,20.1,2524,9,40.2,0,291,291,1583
1980,17020,2948,3194,30699,29952,604,19.4,435,13.9,6911,3200,3711,10.7,23.1,5417,2021,3396,6.7,18.1,1494,5,36.2,0,315,315,1312
1981,17020,2864,3090,30086,30154,491,15.7,553,17.6,6848,3311,3537,11,22.7,6983,3220,3763,10.7,23.2,-135,-0.5,45.4,0,335,335,1551
1982,17020,2903,3198,30298,30092,558,17.7,410,13,6691,3345,3346,11.1,22.2,6279,1950,4329,6.5,20.9,412,1.3,41.8,0,253,253,1281
1983,17020,2943,3219,29974,29792,448,14,436,13.6,6358,2965,3393,10,21.3,5993,2744,3249,9.2,20.1,365,1.2,40.2,0,273,273,1614
1984,17020,3096,3380,32608,31276,547,16.6,381,11.6,7089,2712,4377,8.7,22.7,4425,2077,2348,6.6,14.1,2664,8.6,28.2,0,251,251,1192
1985,17020,3224,3504,33952,33478,519,15,414,12,6916,2514,4402,7.5,20.7,5968,2925,3043,8.7,17.8,948,2.9,35.6,0,273,276,1308
1986,17020,3349,3624,37673,35785,542,15.2,409,11.5,9446,4385,5061,12.3,26.4,5669,2239,3430,6.3,15.8,3777,10.6,31.6,0,264,264,1298
1987,17020,3451,3737,39019,38325,610,16.6,476,12.9,8836,3602,5234,9.4,23.1,7448,2819,4629,7.4,19.4,1388,3.7,38.8,0,296,298,1367
1988,17020,3468,3771,40920,39691,551,14.7,456,12.2,8515,3385,5130,8.5,21.5,6056,2313,3743,5.8,15.3,2459,6.2,30.6,0,302,302,1325
1989,17020,3326,3649,42232,41613,523,14.1,645,17.4,9166,4547,4619,10.9,22,7928,4469,3459,10.7,19.1,1238,2.9,38.2,0,280,281,1461
1990,17020,3660,3993,45839,43933,733,19.2,353,9.2,9933,5223,4710,11.9,22.6,6120,2124,3996,4.8,13.9,3813,8.7,27.8,0,246,246,1231
1991,17020,3847,4195,45904,45877,580,14.2,387,9.5,7976,3325,4651,7.2,17.4,7922,2933,4989,6.4,17.3,54,0.1,34.6,0,238,239,1344
1992,17020,3819,4187,45671,45512,512,12.2,488,11.6,8121,3153,4968,6.9,17.8,7803,2924,4879,6.4,17.1,318,0.7,34.2,0,330,330,1633
1993,17020,3736,4099,44456,45115,392,9.5,459,11.1,6637,2103,4534,4.7,14.7,7954,3155,4799,7,17.6,-1317,-2.9,29.4,0,323,324,1770
1994,17020,3690,4069,45818,45084,397,9.7,391,9.6,7975,3412,4563,7.6,17.7,6506,2317,4189,5.1,14.4,1469,3.3,28.8,0,270,270,1109
1995,17020,3628,4011,47043,46430,413,10.2,439,10.9,7269,2339,4930,5,15.7,6042,2188,3854,4.7,13,1227,2.7,26,0,320,320,1339
1996,17020,3647,4011,48363,47660,408,10.2,393,9.8,7955,2921,5034,6.1,16.7,6548,2265,4283,4.8,13.7,1407,3,27.4,0,247,247,1133
1997,17020,3600,3997,48863,48592,454,11.3,445,11.1,8538,2792,5746,5.7,17.6,7995,2440,5555,5,16.5,543,1.1,33,0,278,278,1489
1998,17020,3608,4018,49960,49441,434,10.8,395,9.9,8760,3041,5719,6.2,17.7,7721,2730,4991,5.5,15.6,1039,2.1,31.2,0,253,253,1785
1999,17020,3614,4046,51008,50379,432,10.7,393,9.7,8206,3152,5054,6.3,16.3,6947,2246,4701,4.5,13.8,1259,2.5,27.6,0,252,252,1173
2000,17020,3631,4073,53112,52090,408,10.1,392,9.7,8982,2700,6282,5.2,17.2,6938,2398,4540,4.6,13.3,2044,3.9,26.6,0,245,245,1289
2001,17020,3715,4150,55782,54862,424,10.3,392,9.5,9180,2995,6185,5.5,16.7,7340,2766,4574,5,13.4,1840,3.3,26.8,0,222,222,1384
2002,17020,3821,4247,56195,55939,571,13.6,470,11.2,9680,4182,5498,7.5,17.3,9167,3081,6086,5.5,16.4,513,0.9,32.8,0,243,243,1246
2003,17020,3855,4304,56288,56117,499,11.7,390,9.1,7510,2826,4684,5,13.4,7167,2416,4751,4.3,12.8,343,0.6,25.6,0,277,282,1674
2004,17020,3852,4315,56533,56091,458,10.6,395,9.2,7518,2629,4889,4.7,13.4,6634,2093,4541,3.7,11.8,884,1.6,23.6,0,275,275,1450
2005,17020,3956,4426,58668,57448,525,12,386,8.9,8475,2928,5547,5.1,14.8,6034,2004,4030,3.5,10.5,2441,4.3,21,0,279,279,1439
2006,17020,3962,4455,60532,59471,520,11.7,442,10,9304,3878,5426,6.5,15.6,7182,2577,4605,4.3,12.1,2122,3.5,24.2,0,288,288,1500
2007,17020,4028,4537,61255,60841,537,12,450,10,9116,3933,5183,6.5,15,8288,2550,5738,4.2,13.6,828,1.4,27.2,0,284,285,1405
2008,17020,3980,4507,59802,60257,450,10,451,10,7723,2988,4735,5,12.8,8633,2253,6380,3.7,14.3,-910,-1.5,25.6,0,332,332,1809
2009,17020,3818,4335,55223,57231,336,7.6,464,10.5,5402,1728,3674,3,9.4,9417,2681,6736,4.7,16.5,-4015,-7.1,18.8,0,316,316,1225
2010,17020,3729,4238,53388,53882,315,7.4,391,9.1,5476,1764,3712,3.3,10.2,6463,1729,4734,3.2,12,-987,-1.8,20.4,0,258,258,972
2011,17020,3660,4159,52581,52928,339,8.1,395,9.4,6137,2406,3731,4.5,11.6,6831,2725,4106,5.1,12.9,-694,-1.3,23.2,0,264,265,1484
2012,17020,3646,4136,53796,53650,411,9.9,438,10.6,6928,2286,4642,4.3,12.9,6635,3039,3596,5.7,12.4,293,0.5,24.8,0,292,296,1888
2013,17020,3683,4175,54768,54212,408,9.8,373,9,6463,1761,4702,3.2,11.9,5351,2356,2995,4.3,9.9,1112,2,19.8,0,246,246,1512
2014,17020,3653,4143,56391,55463,347,8.4,360,8.7,6495,1628,4867,2.9,11.7,4639,1446,3193,2.6,8.4,1856,3.3,16.8,0,252,253,913
1977,17140,25116,30049,562924,546218,4586,15.5,3614,12.2,102526,43004,59522,7.9,18.8,69113,27387,41726,5,12.7,33413,6.1,25.4,0,2293,2305,15736
1978,17140,25527,30622,587357,573004,3983,13.1,3395,11.2,97136,28622,68514,5,17,68430,26415,42015,4.6,11.9,28706,5.1,23.8,0,2265,2274,12304
1979,17140,25830,31067,624878,605505,3840,12.5,3238,10.5,102241,31403,70838,5.2,16.9,63494,25478,38016,4.2,10.5,38747,6.4,21,0,2181,2186,12198
1980,17140,25855,31193,620093,622249,3535,11.4,3287,10.6,80533,27757,52776,4.5,12.9,84844,25410,59434,4.1,13.6,-4311,-0.7,25.8,0,2242,2256,12362
1981,17140,25075,30235,591149,601052,3440,11.2,4121,13.4,76441,30282,46159,5,12.7,96246,34776,61470,5.8,16,-19805,-3.3,25.4,0,2253,2257,12354
1982,17140,25037,30717,581864,586374,4064,13.3,3269,10.7,85630,36606,49024,6.2,14.6,94651,27661,66990,4.7,16.1,-9021,-1.5,29.2,0,1807,1808,13389
1983,17140,25590,31194,579480,582609,3335,10.8,3106,10,75753,25618,50135,4.4,13,82011,22021,59990,3.8,14.1,-6258,-1.1,26,0,1825,1840,9437
1984,17140,26581,32267,613826,595747,4029,12.7,2981,9.4,104212,36425,67787,6.1,17.5,68053,22282,45771,3.7,11.4,36159,6.1,22.8,0,1792,1793,9462
1985,17140,27259,32980,650736,633324,4051,12.4,3360,10.3,113507,36935,76572,5.8,17.9,78684,30438,48246,4.8,12.4,34823,5.5,24.8,0,2040,2059,12407
1986,17140,28142,34029,677868,663863,4482,13.4,3348,10,112961,40133,72828,6,17,84952,27963,56989,4.2,12.8,28009,4.2,25.6,0,2089,2094,13525
1987,17140,29128,35491,706204,694591,5126,14.7,3574,10.3,130962,48386,82576,7,18.9,107737,41393,66344,6,15.5,23225,3.4,31,0,2148,2162,18323
1988,17140,29480,36127,735131,719415,4500,12.6,3783,10.6,129082,47821,81261,6.6,17.9,97651,34298,63353,4.8,13.6,31431,4.3,27.2,0,2381,2381,14133
1989,17140,29997,36932,754936,745862,4326,11.8,3548,9.7,124762,45961,78801,6.2,16.7,106615,37021,69594,5,14.3,18147,2.4,28.6,0,2289,2292,15867
1990,17140,30439,37683,778178,766038,4310,11.6,3381,9.1,118852,42194,76658,5.5,15.5,94572,29942,64630,3.9,12.3,24280,3.2,24.6,0,2260,2271,17113
1991,17140,30887,38599,780036,778313,4433,11.6,3454,9.1,115121,47762,67359,6.1,14.8,111674,31254,80420,4,14.3,3447,0.5,28.6,0,2172,2182,16886
1992,17140,31114,39142,772836,776210,4461,11.5,3817,9.8,108105,35168,72937,4.5,13.9,114852,36834,78018,4.7,14.8,-6747,-0.9,27.8,0,2338,2371,17287
1993,17140,31583,39298,790052,781386,3977,10.1,3768,9.6,121003,40986,80017,5.2,15.5,103671,33836,69835,4.3,13.3,17332,2.2,26.6,0,2264,2302,14989
1994,17140,32142,40066,804431,796651,4428,11.2,3547,8.9,119873,42163,77710,5.3,15,104313,34154,70159,4.3,13.1,15560,1.9,26.2,0,2240,2246,16873
1995,17140,32945,41139,826898,815244,4776,11.8,3596,8.9,126083,48334,77749,5.9,15.5,102774,31652,71122,3.9,12.6,23309,2.9,25.2,0,2289,2309,16361
1996,17140,33284,41620,848831,838311,4523,10.9,4002,9.7,133571,46514,87057,5.5,15.9,112530,41362,71168,4.9,13.4,21041,2.5,26.8,0,2462,2462,15459
1997,17140,33623,42179,873988,861972,5063,12.1,4545,10.8,153899,61523,92376,7.1,17.9,129866,43581,86285,5.1,15.1,24033,2.8,30.2,0,2693,2693,20152
1998,17140,33671,42305,882339,876047,4468,10.6,4263,10.1,134448,42877,91571,4.9,15.3,121863,42028,79835,4.8,13.9,12585,1.4,27.8,0,2686,2686,20681
1999,17140,33740,42685,911430,897443,4426,10.4,4003,9.4,145319,55842,89477,6.2,16.2,117345,43671,73674,4.9,13.1,27974,3.1,26.2,0,2502,2502,17668
2000,17140,33727,42964,945569,928721,4375,10.2,4125,9.6,152888,52707,100181,5.7,16.5,119194,47009,72185,5.1,12.8,33694,3.7,25.6,0,2477,2477,17592
2001,17140,33687,43105,932276,941164,4238,9.8,4330,10.1,132491,50102,82389,5.3,14.1,150267,48370,101897,5.1,16,-17776,-1.9,28.2,0,2466,2466,21234
2002,17140,33687,43105,915441,921716,4797,11.1,4735,11,154240,64182,90058,7,16.7,166790,54227,112563,5.9,18.1,-12550,-1.4,33.4,0,2282,2288,19886
2003,17140,33674,43197,914697,907627,4623,10.8,3754,8.8,139557,51582,87975,5.7,15.4,125417,37172,88245,4.1,13.8,14140,1.6,27.6,0,2441,2464,19175
2004,17140,33819,43501,917911,910828,4388,10.1,3670,8.5,132900,47964,84936,5.3,14.6,118734,41779,76955,4.6,13,14166,1.6,26,0,2325,2330,23463
2005,17140,33939,43937,909644,909680,4468,10.3,3663,8.4,138397,52417,85980,5.8,15.2,138468,39593,98875,4.4,15.2,-71,0,30.4,0,2453,2458,22705
2006,17140,33973,44301,940244,922310,4658,10.6,3898,8.9,149802,59329,90473,6.4,16.2,113933,40913,73020,4.4,12.4,35869,3.8,24.8,0,2523,2524,26108
2007,17140,33996,44732,950429,943890,4786,10.8,4279,9.6,155691,60320,95371,6.4,16.5,142613,45736,96877,4.8,15.1,13078,1.4,30.2,0,2493,2527,20854
2008,17140,33522,44251,960179,951667,3996,9,3999,9,151985,60912,91073,6.4,16,134961,45940,89021,4.8,14.2,17024,1.8,28.4,0,2649,2652,19560
2009,17140,32389,42971,910704,933339,3277,7.5,4144,9.5,108836,43176,65660,4.6,11.7,154106,41140,112966,4.4,16.5,-45270,-4.8,23.4,0,2653,2664,26115
2010,17140,31570,42070,884445,894901,3298,7.8,3790,9,103199,39750,63449,4.4,11.5,124110,32158,91952,3.6,13.9,-20911,-2.4,23,0,2312,2313,17365
2011,17140,31154,41758,891814,886274,3476,8.3,3452,8.3,111516,33898,77618,3.8,12.6,100435,28421,72014,3.2,11.3,11081,1.3,22.6,0,2191,2204,14170
2012,17140,31376,41823,913044,900563,3660,8.8,3464,8.3,129674,36516,93158,4.1,14.4,104712,33252,71460,3.7,11.6,24962,2.8,23.2,0,1910,1922,14693
2013,17140,31292,41770,919201,913707,3514,8.4,3381,8.1,121337,34386,86951,3.8,13.3,110349,44430,65919,4.9,12.1,10988,1.2,24.2,0,2058,2064,15990
2014,17140,31199,41829,942330,927520,3511,8.4,3104,7.5,126618,39336,87282,4.2,13.7,96997,29069,67928,3.1,10.5,29621,3.2,21,0,2046,2063,13824
1977,17300,2315,2527,30835,30220,458,18.6,319,13,5719,2491,3228,8.2,18.9,4488,1550,2938,5.1,14.9,1231,4,29.8,0,215,215,877
1978,17300,2349,2569,31527,31034,372,14.6,326,12.8,5764,2015,3749,6.5,18.6,4778,2207,2571,7.1,15.4,986,3.2,30.8,0,241,241,931
1979,17300,2394,2623,33528,32486,394,15.2,319,12.3,7075,2221,4854,6.8,21.8,4991,2087,2904,6.4,15.4,2084,6.4,30.8,0,243,243,1361
1980,17300,2347,2577,31630,32587,282,10.8,320,12.3,4109,1684,2425,5.2,12.6,6023,1479,4544,4.5,18.5,-1914,-5.9,25.2,0,234,235,937
1981,17300,2223,2430,30497,30588,257,10.3,361,14.5,4946,1723,3223,5.6,16.2,5127,1840,3287,6,16.8,-181,-0.6,32.4,0,217,217,1044
1982,17300,2227,2467,30205,30348,330,13.5,269,11,4613,2395,2218,7.9,15.2,4898,1348,3550,4.4,16.1,-285,-0.9,30.4,0,157,157,668
1983,17300,2273,2507,29402,29648,309,12.4,287,11.5,4735,1913,2822,6.5,16,5226,1923,3303,6.5,17.6,-491,-1.6,32,0,199,199,982
1984,17300,2382,2611,32364,30834,403,15.8,300,11.7,6515,2529,3986,8.2,21.1,3455,1265,2190,4.1,11.2,3060,9.9,22.4,0,202,202,791
1985,17300,2440,2680,35111,33941,341,12.9,288,10.9,6879,1864,5015,5.5,20.3,4538,1651,2887,4.9,13.4,2341,6.9,26.8,0,198,198,1147
1986,17300,2533,2783,35669,35364,371,13.6,267,9.8,6606,2813,3793,8,18.7,5996,2156,3840,6.1,17,610,1.7,34,0,189,189,1380
1987,17300,2559,2849,38767,38138,417,14.8,333,11.8,7318,2941,4377,7.7,19.2,6059,2744,3315,7.2,15.9,1259,3.3,31.8,0,233,234,1479
1988,17300,2563,2865,40070,39055,375,13.2,321,11.3,7650,3881,3769,9.9,19.6,5620,2129,3491,5.5,14.4,2030,5.2,28.8,0,210,210,1076
1989,17300,2601,2921,40804,40562,360,12.4,307,10.6,5863,2548,3315,6.3,14.5,5378,1592,3786,3.9,13.3,485,1.2,26.6,0,214,214,1028
1990,17300,2646,2977,41056,40898,357,12.1,278,9.4,5738,2486,3252,6.1,14,5422,1553,3869,3.8,13.3,316,0.7,26.6,0,194,194,952
1991,17300,2660,3018,40273,40636,353,11.8,294,9.8,6534,3531,3003,8.7,16.1,7260,1585,5675,3.9,17.9,-726,-1.8,32.2,0,196,196,835
1992,17300,2705,3084,42584,41408,399,13.1,317,10.4,8192,2504,5688,6,19.8,5839,2008,3831,4.8,14.1,2353,5.7,28.2,0,196,197,784
1993,17300,2800,3192,44058,43259,391,12.5,275,8.8,6906,2759,4147,6.4,16,5307,1913,3394,4.4,12.3,1599,3.7,24.6,0,180,181,930
1994,17300,2899,3272,46102,45099,414,12.8,326,10.1,7588,3201,4387,7.1,16.8,5582,2382,3200,5.3,12.4,2006,4.4,24.8,0,228,228,1349
1995,17300,2994,3392,50324,48231,441,13.2,313,9.4,9713,3410,6303,7.1,20.1,5526,1898,3628,3.9,11.5,4187,8.6,23,0,236,236,1178
1996,17300,3110,3532,51715,51030,472,13.6,313,9,7881,3103,4778,6.1,15.4,6511,2312,4199,4.5,12.8,1370,2.6,25.6,0,212,212,925
1997,17300,3153,3597,53811,52555,449,12.6,376,10.5,10582,4102,6480,7.8,20.1,8069,2293,5776,4.4,15.4,2513,4.7,30.8,0,240,240,1141
1998,17300,3198,3654,54935,54361,475,13.1,412,11.4,8432,3866,4566,7.1,15.5,7283,2781,4502,5.1,13.4,1149,2.1,26.8,0,287,287,1319
1999,17300,3151,3644,58237,56536,438,12,436,12,10592,4412,6180,7.8,18.7,7190,2810,4380,5,12.7,3402,6,25.4,0,296,296,1722
2000,17300,3081,3598,59968,59073,399,11,439,12.1,8995,3369,5626,5.7,15.2,7205,2709,4496,4.6,12.2,1790,3,24.4,0,285,285,1372
2001,17300,3089,3615,62000,61147,384,10.6,397,11,9800,2777,7023,4.5,16,8094,2454,5640,4,13.2,1706,2.8,26.4,0,232,232,1154
2002,17300,3090,3620,61384,61668,433,12,426,11.8,9547,3709,5838,6,15.5,10114,2868,7246,4.7,16.4,-567,-0.9,31,0,245,245,1119
2003,17300,3102,3651,62615,61773,397,11,309,8.5,9805,3502,6303,5.7,15.9,8121,2769,5352,4.5,13.1,1684,2.8,26.2,0,220,220,1413
2004,17300,3183,3738,64747,63322,400,10.9,275,7.5,10472,3668,6804,5.8,16.5,7621,2511,5110,4,12,2851,4.5,24,0,163,163,915
2005,17300,3259,3819,65074,64727,427,11.3,300,8,8503,2774,5729,4.3,13.1,7809,2736,5073,4.2,12.1,694,1,24.2,0,207,207,1118
2006,17300,3279,3867,67592,66026,452,11.8,357,9.3,10209,4400,5809,6.7,15.5,7077,2324,4753,3.5,10.7,3132,4.8,21.4,0,262,262,1842
2007,17300,3340,3975,67932,67668,452,11.5,340,8.7,9725,3549,6176,5.2,14.4,9197,2131,7066,3.1,13.6,528,0.8,27.2,0,229,230,1204
2008,17300,3367,3994,65892,66335,381,9.6,315,7.9,7725,2479,5246,3.7,11.6,8610,1915,6695,2.9,13,-885,-1.4,23.2,0,227,227,1376
2009,17300,3332,3968,62790,64218,344,8.7,342,8.6,6919,2778,4141,4.3,10.8,9775,2139,7636,3.3,15.2,-2856,-4.4,21.6,0,247,247,1431
2010,17300,3320,3975,65783,64105,356,9,332,8.4,10963,6568,4395,10.2,17.1,7607,1927,5680,3,11.9,3356,5.2,23.8,0,239,239,1467
2011,17300,3286,3978,65895,65802,386,9.7,355,8.9,9087,3038,6049,4.6,13.8,8900,2701,6199,4.1,13.5,187,0.3,27,0,260,260,1361
2012,17300,3321,4028,68063,66994,368,9.2,326,8.2,11147,2992,8155,4.5,16.6,9008,3627,5381,5.4,13.4,2139,3.2,26.8,0,204,206,957
2013,17300,3316,4032,66212,66469,347,8.6,341,8.5,8203,2546,5657,3.8,12.3,8716,2630,6086,4,13.1,-513,-0.8,24.6,0,215,218,1296
2014,17300,3332,4068,66888,66114,382,9.5,316,7.8,8704,3081,5623,4.7,13.2,7155,2624,4531,4,10.8,1549,2.4,21.6,0,225,226,1268
1977,17420,1155,1245,24830,23813,244,20,181,14.9,4952,1705,3247,7.2,20.8,2918,1139,1779,4.8,12.3,2034,8.5,24.6,0,127,127,824
1978,17420,1177,1268,24752,24781,179,14.2,157,12.5,3597,961,2636,3.9,14.5,3654,2420,1234,9.8,14.7,-57,-0.2,29,0,120,120,631
1979,17420,1188,1281,26007,25352,176,13.8,161,12.6,4316,1431,2885,5.6,17,3006,895,2111,3.5,11.9,1310,5.1,23.8,0,117,117,508
1980,17420,1179,1277,25525,25754,167,13.1,162,12.7,3173,1340,1833,5.2,12.3,3630,1342,2288,5.2,14.1,-457,-1.8,24.6,0,122,122,461
1981,17420,1137,1242,25318,25205,164,13.1,176,14.1,3822,1802,2020,7.1,15.2,3595,1368,2227,5.4,14.3,227,0.9,28.6,0,120,120,632
1982,17420,1159,1279,27514,26378,195,15.5,142,11.3,6077,2089,3988,7.9,23,3806,1027,2779,3.9,14.4,2271,8.6,28.8,0,85,85,330
1983,17420,1214,1333,25113,26248,162,12.4,114,8.7,2774,1040,1734,4,10.6,5045,545,4500,2.1,19.2,-2271,-8.6,21.2,0,76,76,297
1984,17420,1289,1403,27537,26325,234,17.1,166,12.1,4665,1768,2897,6.7,17.7,2241,1070,1171,4.1,8.5,2424,9.2,17,0,115,115,577
1985,17420,1334,1444,28382,28155,202,14.1,168,11.8,4037,1271,2766,4.5,14.3,3583,1502,2081,5.3,12.7,454,1.6,25.4,0,110,110,1001
1986,17420,1355,1478,29613,29049,209,14.3,167,11.4,4502,1368,3134,4.7,15.5,3373,894,2479,3.1,11.6,1129,3.9,23.2,0,112,112,442
1987,17420,1407,1533,30958,30251,219,14.5,163,10.8,5394,1320,4074,4.4,17.8,3980,2101,1879,6.9,13.2,1414,4.6,26.4,0,108,109,739
1988,17420,1417,1555,30550,30516,199,12.9,164,10.7,4534,1782,2752,5.8,14.9,4466,1335,3131,4.4,14.6,68,0.3,29.2,0,108,108,875
1989,17420,1438,1589,32061,31343,182,11.6,151,9.6,4894,1789,3105,5.7,15.6,3457,1382,2075,4.4,11,1437,4.6,22,0,108,108,659
1990,17420,1470,1625,32462,32204,202,12.6,159,9.9,5213,2289,2924,7.1,16.2,4696,2426,2270,7.5,14.6,517,1.6,29.2,0,119,119,1733
1991,17420,1526,1701,31547,31751,238,14.3,164,9.9,4942,2927,2015,9.2,15.6,5349,1512,3837,4.8,16.8,-407,-1.2,31.2,0,105,105,610
1992,17420,1537,1707,33836,32672,183,10.7,169,9.9,6081,1518,4563,4.6,18.6,3753,1400,2353,4.3,11.5,2328,7.1,23,0,106,107,903
1993,17420,1576,1758,34241,33827,206,11.9,143,8.3,5156,1690,3466,5,15.2,4330,924,3406,2.7,12.8,826,2.4,25.6,0,105,106,640
1994,17420,1617,1795,33965,34087,193,10.9,151,8.5,5191,2194,2997,6.4,15.2,5435,2307,3128,6.8,15.9,-244,-0.7,30.4,0,105,105,1415
1995,17420,1644,1828,34650,34449,191,10.5,153,8.4,4272,1421,2851,4.1,12.4,3869,1145,2724,3.3,11.2,403,1.2,22.4,0,95,95,739
1996,17420,1690,1865,35317,35386,222,12,181,9.8,4859,1592,3267,4.5,13.7,4996,2542,2454,7.2,14.1,-137,-0.4,27.4,0,113,113,1673
1997,17420,1738,1920,36722,36016,222,11.7,168,8.9,5818,1512,4306,4.2,16.2,4406,1757,2649,4.9,12.2,1412,4,24.4,0,109,109,699
1998,17420,1745,1937,37150,36911,212,11,191,9.9,5208,2022,3186,5.5,14.1,4729,1671,3058,4.5,12.8,479,1.3,25.6,0,146,146,1154
1999,17420,1739,1937,38788,38479,223,11.5,220,11.4,5939,2733,3206,7.1,15.4,5320,2217,3103,5.8,13.8,619,1.6,27.6,0,150,150,1390
2000,17420,1703,1908,38636,38720,220,11.4,248,12.9,5792,2429,3363,6.3,15,5960,3244,2716,8.4,15.4,-168,-0.4,30,0,169,169,1838
2001,17420,1704,1911,37237,37963,197,10.3,209,10.9,4194,1782,2412,4.7,11,5646,1719,3927,4.5,14.9,-1452,-3.9,22,0,134,134,803
2002,17420,1681,1898,35770,36314,208,10.9,216,11.4,5021,2120,2901,5.8,13.8,6108,2033,4075,5.6,16.8,-1087,-3,27.6,0,136,136,1405
2003,17420,1702,1929,36070,35437,217,11.4,148,7.8,5801,2437,3364,6.9,16.4,4535,1020,3515,2.9,12.8,1266,3.6,25.6,0,108,108,768
2004,17420,1731,1969,36878,36356,212,10.9,156,8,6371,2431,3940,6.7,17.5,5327,2425,2902,6.7,14.7,1044,2.8,29.4,0,109,109,567
2005,17420,1752,1998,35582,36215,217,11,173,8.8,4096,1552,2544,4.3,11.3,5361,1438,3923,4,14.8,-1265,-3.5,22.6,0,129,129,728
2006,17420,1753,2021,37740,36484,224,11.2,186,9.3,6873,4270,2603,11.7,18.8,4360,1358,3002,3.7,12,2513,6.8,24,0,126,126,1080
2007,17420,1786,2066,38188,37990,248,12.1,201,9.8,7345,2229,5116,5.9,19.3,6949,3466,3483,9.1,18.3,396,1,36.6,0,132,141,1065
2008,17420,1797,2086,37690,37851,205,9.9,164,7.9,5691,2006,3685,5.3,15,6012,869,5143,2.3,15.9,-321,-0.9,30,0,133,133,668
2009,17420,1715,1986,35634,36641,154,7.6,240,11.8,4690,1793,2897,4.9,12.8,6704,2163,4541,5.9,18.3,-2014,-5.5,25.6,0,162,162,1297
2010,17420,1682,1947,35643,35529,145,7.4,167,8.5,4351,868,3483,2.4,12.2,4123,1184,2939,3.3,11.6,228,0.6,23.2,0,125,125,993
2011,17420,1632,1892,36076,35722,134,7,161,8.4,4236,1376,2860,3.9,11.9,3527,1055,2472,3,9.9,709,2,19.8,0,121,122,703
2012,17420,1669,1940,38338,37191,190,9.9,143,7.5,6364,2626,3738,7.1,17.1,4070,1155,2915,3.1,10.9,2294,6.2,21.8,0,86,86,553
2013,17420,1649,1915,37940,38084,133,6.9,159,8.3,4226,716,3510,1.9,11.1,4514,2103,2411,5.5,11.9,-288,-0.8,22.2,0,103,103,1054
2014,17420,1661,1933,39369,38599,170,8.9,129,6.7,5071,1520,3551,3.9,13.1,3530,941,2589,2.4,9.1,1541,4,18.2,0,97,97,513
1977,17460,33743,40604,810634,796940,5759,14.4,4540,11.3,137580,57286,80294,7.2,17.3,110191,38668,71523,4.9,13.8,27389,3.5,27.6,0,2817,2834,18057
1978,17460,34234,41256,861460,836438,4951,12.1,4317,10.5,149820,43673,106147,5.2,17.9,99776,37807,61969,4.5,11.9,50044,6,23.8,0,2743,2757,15332
1979,17460,34653,41835,885179,872714,4900,11.8,4111,9.9,141001,49307,91694,5.6,16.2,116071,45920,70151,5.3,13.3,24930,2.9,26.6,0,2649,2667,18612
1980,17460,34658,41967,866349,875484,4485,10.7,4201,10,121086,40604,80482,4.6,13.8,139358,36651,102707,4.2,15.9,-18272,-2.1,27.6,0,2757,2772,17978
1981,17460,33664,40738,824934,842681,4205,10.2,5172,12.5,105926,40750,65176,4.8,12.6,141420,48818,92602,5.8,16.8,-35494,-4.2,25.2,0,2811,2826,15959
1982,17460,33820,41494,820549,822175,5233,12.7,4155,10.1,129411,58676,70735,7.1,15.7,132664,39964,92700,4.9,16.1,-3253,-0.4,31.4,0,2177,2180,14786
1983,17460,34241,41849,778093,799708,4118,9.9,4088,9.8,106836,42962,63874,5.4,13.4,150065,34374,115691,4.3,18.8,-43229,-5.4,26.8,0,2476,2487,14283
1984,17460,34875,42399,813238,796007,4607,10.9,4139,9.8,133796,46248,87548,5.8,16.8,99333,32875,66458,4.1,12.5,34463,4.3,25,0,2483,2490,13026
1985,17460,35436,42814,824585,817754,4712,11.1,4290,10.1,127198,34259,92939,4.2,15.6,113535,47691,65844,5.8,13.9,13663,1.7,27.8,0,2598,2622,19590
1986,17460,36151,43585,852437,838037,5153,11.9,4276,9.9,137911,51676,86235,6.2,16.5,109110,38019,71091,4.5,13,28801,3.5,26,0,2687,2690,18427
1987,17460,36648,44468,844034,848386,5673,12.9,4627,10.5,145866,59569,86297,7,17.2,154571,68567,86004,8.1,18.2,-8705,-1,34.4,0,2718,2737,21003
1988,17460,36808,44697,861823,853411,5068,11.4,4775,10.7,146385,54470,91915,6.4,17.2,129562,49505,80057,5.8,15.2,16823,2,30.4,0,2787,2787,16516
1989,17460,37442,45595,899079,882882,5257,11.6,4389,9.7,158353,61172,97181,6.9,17.9,125960,53034,72926,6,14.3,32393,3.6,28.6,0,2798,2836,24014
1990,17460,38023,46315,914723,907471,4827,10.5,3931,8.6,132865,41453,91412,4.6,14.6,118360,37398,80962,4.1,13,14505,1.6,26,0,2539,2547,20389
1991,17460,38621,47242,899548,908702,5141,11,4173,8.9,121454,48156,73298,5.3,13.4,139762,42493,97269,4.7,15.4,-18308,-2,26.8,0,2534,2550,17927
1992,17460,38906,47655,894792,896609,5051,10.6,4462,9.4,125475,39811,85664,4.4,14,129109,40942,88167,4.6,14.4,-3634,-0.4,28,0,2727,2751,18018
1993,17460,39475,47875,904058,900033,4671,9.8,4383,9.2,140027,40373,99654,4.5,15.6,131976,42673,89303,4.7,14.7,8051,0.9,29.4,0,2604,2629,15825
1994,17460,40114,48592,910773,906850,5022,10.4,4233,8.8,141543,51133,90410,5.6,15.6,133698,41278,92420,4.6,14.7,7845,0.9,29.4,0,2621,2638,15325
1995,17460,40724,49286,939203,923676,5122,10.5,4254,8.7,142297,46869,95428,5.1,15.4,111242,37455,73787,4.1,12,31055,3.4,24,0,2674,2702,15240
1996,17460,41273,49969,959654,950032,5184,10.4,4429,8.9,139889,47224,92665,5,14.7,120644,36293,84351,3.8,12.7,19245,2,25.4,0,2714,2717,17437
1997,17460,41644,50626,975109,967592,5703,11.3,5046,10,162866,57415,105451,5.9,16.8,147832,51244,96588,5.3,15.3,15034,1.5,30.6,0,2919,2919,22801
1998,17460,41857,50890,999800,987072,4916,9.7,4561,9,156767,44032,112735,4.5,15.9,131311,50527,80784,5.1,13.3,25456,2.6,26.6,0,2803,2803,16023
1999,17460,41698,50884,1009154,1006756,4743,9.3,4664,9.2,148755,52419,96336,5.2,14.8,143959,49913,94046,5,14.3,4796,0.5,28.6,0,2815,2815,18816
2000,17460,41455,50889,1046545,1027379,4846,9.5,4852,9.5,181058,57790,123268,5.6,17.6,142725,49604,93121,4.8,13.9,38333,3.7,27.8,0,2805,2805,18877
2001,17460,41349,51043,1038728,1045058,4742,9.3,4893,9.6,143382,52840,90542,5.1,13.7,156041,46977,109064,4.5,14.9,-12659,-1.2,27.4,0,2798,2804,19755
2002,17460,40786,50370,974783,997517,5213,10.3,5839,11.5,145810,56589,89221,5.7,14.6,191277,59919,131358,6,19.2,-45467,-4.6,29.2,0,2817,2825,19680
2003,17460,40510,50198,964601,965153,4877,9.7,4269,8.5,145267,50582,94685,5.2,15.1,146371,43070,103301,4.5,15.2,-1104,-0.1,30.2,0,2735,2745,20323
2004,17460,40460,50184,959853,960211,4879,9.8,4359,8.7,127196,43652,83544,4.5,13.2,127911,40990,86921,4.3,13.3,-715,-0.1,26.4,0,2732,2746,20298
2005,17460,40648,50511,968090,963601,5093,10.1,4371,8.7,137178,51896,85282,5.4,14.2,128199,39977,88222,4.1,13.3,8979,0.9,26.6,0,2813,2819,22567
2006,17460,40317,50437,981399,972314,5170,10.3,4763,9.5,134493,50102,84391,5.2,13.8,116323,40563,75760,4.2,12,18170,1.8,24,0,3076,3104,20731
2007,17460,39917,50172,975431,975090,4771,9.5,4875,9.7,141219,47042,94177,4.8,14.5,140536,45250,95286,4.6,14.4,683,0.1,28.8,0,2873,2898,19772
2008,17460,39120,49296,956903,963607,4161,8.4,4582,9.3,121891,39715,82176,4.1,12.6,135298,47943,87355,5,14,-13407,-1.4,25.2,0,3059,3070,25465
2009,17460,37593,47627,915221,932547,3571,7.4,4738,9.8,101424,37515,63909,4,10.9,136076,32048,104028,3.4,14.6,-34652,-3.7,21.8,0,2952,2966,18715
2010,17460,36813,46762,887541,899140,3687,7.8,4065,8.7,99450,34130,65320,3.8,11.1,122648,30699,91949,3.4,13.6,-23198,-2.5,22.2,0,2429,2434,20595
2011,17460,36382,46342,912047,898392,3810,8.2,3925,8.5,125496,34273,91223,3.8,14,98185,27496,70689,3.1,10.9,27311,3.1,21.8,0,2379,2400,16368
2012,17460,36599,46664,929127,919180,4230,9.1,3836,8.3,124099,33704,90395,3.7,13.5,104204,31709,72495,3.4,11.3,19895,2.2,22.6,0,2139,2153,14231
2013,17460,36372,46605,948864,937459,3650,7.9,3593,7.7,119670,30596,89074,3.3,12.8,96861,30036,66825,3.2,10.3,22809,2.5,20.6,0,2138,2141,15114
2014,17460,36101,46421,953066,947885,3640,7.9,3509,7.6,105118,30049,75069,3.2,11.1,94755,22414,72341,2.4,10,10363,1.1,20,0,2282,2292,15262
1977,17660,1058,1120,9820,9457,264,24.8,148,13.9,2557,1378,1179,14.6,27,1830,789,1041,8.3,19.4,727,7.6,38.8,0,108,108,393
1978,17660,1065,1129,11109,10433,265,23.6,242,21.5,3045,1432,1613,13.7,29.2,1693,1105,588,10.6,16.2,1352,13,32.4,0,143,143,584
1979,17660,1201,1276,12563,11839,277,23,136,11.3,3365,1637,1728,13.8,28.4,1917,828,1089,7,16.2,1448,12.2,32.4,0,10,10,35
1980,17660,1239,1312,12211,12391,267,20.6,222,17.2,2239,1038,1201,8.4,18.1,2598,1181,1417,9.5,21,-359,-2.9,36.2,0,179,179,812
1981,17660,1201,1271,11849,11666,216,16.8,225,17.5,2902,1329,1573,11.4,24.9,2535,1027,1508,8.8,21.7,367,3.2,43.4,0,157,157,625
1982,17660,1182,1260,10915,11377,214,16.9,215,17,2194,1244,950,10.9,19.3,3117,825,2292,7.3,27.4,-923,-8.1,38.6,0,129,130,559
1983,17660,1209,1288,11652,11275,191,15,168,13.2,2477,962,1515,8.5,22,1723,698,1025,6.2,15.3,754,6.7,30.6,0,114,114,398
1984,17660,1284,1361,13561,12630,228,17.2,162,12.2,3502,1098,2404,8.7,27.7,1639,874,765,6.9,13,1863,14.7,26,0,111,111,535
1985,17660,1408,1484,15174,14876,280,19.6,166,11.6,3242,1334,1908,9,21.8,2645,1209,1436,8.1,17.8,597,4,35.6,0,107,107,520
1986,17660,1492,1563,15784,15473,292,19.2,202,13.3,3531,1385,2146,9,22.8,2909,1035,1874,6.7,18.8,622,4,37.6,0,127,129,565
1987,17660,1550,1622,16230,15988,292,18.3,211,13.2,3834,1380,2454,8.6,24,3349,1102,2247,6.9,20.9,485,3.1,41.8,0,135,135,612
1988,17660,1512,1588,15737,15405,219,13.7,229,14.3,3964,1507,2457,9.8,25.7,3299,1483,1816,9.6,21.4,665,4.3,42.8,0,157,157,646
1989,17660,1564,1646,17125,16430,266,16.5,206,12.7,4215,1777,2438,10.8,25.7,2825,1215,1610,7.4,17.2,1390,8.5,34.4,0,133,133,784
1990,17660,1687,1793,18830,17949,326,19,167,9.7,4355,1730,2625,9.6,24.3,2592,1070,1522,6,14.4,1763,9.9,28.8,0,122,122,805
1991,17660,1810,1931,19818,19321,326,17.5,186,10,4521,1975,2546,10.2,23.4,3526,1255,2271,6.5,18.2,995,5.2,36.4,0,117,117,638
1992,17660,2004,2124,22724,21260,430,21.2,225,11.1,6090,2834,3256,13.3,28.6,3162,1201,1961,5.6,14.9,2928,13.7,29.8,0,149,149,737
1993,17660,2149,2269,24004,23344,410,18.7,258,11.7,5284,2052,3232,8.8,22.6,3963,1425,2538,6.1,17,1321,5.6,34,0,171,171,926
1994,17660,2383,2515,26393,25147,492,20.6,228,9.5,5892,2475,3417,9.8,23.4,3399,1173,2226,4.7,13.5,2493,9.9,27,0,159,160,750
1995,17660,2505,2644,28100,27281,451,17.5,307,11.9,5431,2151,3280,7.9,19.9,3793,1465,2328,5.4,13.9,1638,6,27.8,0,229,229,1017
1996,17660,2601,2747,28303,28182,451,16.7,335,12.4,5466,2689,2777,9.5,19.4,5223,1740,3483,6.2,18.5,243,0.9,37,0,222,222,1054
1997,17660,2694,2842,29325,28801,468,16.7,359,12.8,6100,2700,3400,9.4,21.2,5052,1711,3341,5.9,17.5,1048,3.7,35,0,234,234,1009
1998,17660,2782,2952,30921,30107,472,16.3,359,12.4,6306,3009,3297,10,20.9,4678,1772,2906,5.9,15.5,1628,5.4,31,0,258,258,1152
1999,17660,2843,3033,33024,32707,467,15.6,384,12.8,5885,2518,3367,7.7,18,5250,2095,3155,6.4,16.1,635,1.9,32.2,0,266,266,1402
2000,17660,2828,3020,35411,34223,440,14.5,457,15.1,7293,3308,3985,9.7,21.3,4916,2353,2563,6.9,14.4,2377,6.9,28.8,0,284,284,1393
2001,17660,2882,3091,38267,36864,448,14.6,405,13.2,8011,2595,5416,7,21.7,5205,2255,2950,6.1,14.1,2806,7.6,28.2,0,243,243,1313
2002,17660,2855,3066,39404,38787,446,14.5,459,14.9,8198,3891,4307,10,21.1,6964,3047,3917,7.9,18,1234,3.1,36,0,214,215,1083
2003,17660,3002,3218,40709,40200,518,16.6,312,10,6091,2544,3547,6.3,15.2,5072,1303,3769,3.2,12.6,1019,2.6,25.2,0,205,205,819
2004,17660,3165,3406,41914,41152,556,16.8,336,10.2,8311,3590,4721,8.7,20.2,6787,1669,5118,4.1,16.5,1524,3.7,33,0,240,240,1242
2005,17660,3439,3699,46272,44002,649,18.3,323,9.1,9770,3658,6112,8.3,22.2,5229,1796,3433,4.1,11.9,4541,10.3,23.8,0,240,240,1168
2006,17660,3679,3945,48671,46974,689,18.1,417,10.9,9184,3486,5698,7.4,19.6,5789,2260,3529,4.8,12.3,3395,7.3,24.6,0,277,277,1572
2007,17660,3814,4097,48820,48585,648,16.1,463,11.5,10360,5471,4889,11.3,21.3,9890,5056,4834,10.4,20.4,470,0.9,40.8,0,312,312,4030
2008,17660,3791,4092,48798,48678,506,12.4,464,11.4,7609,2721,4888,5.6,15.6,7368,2513,4855,5.2,15.1,241,0.5,30.2,0,324,324,1998
2009,17660,3539,3851,45527,47060,387,9.8,588,14.8,5903,2274,3629,4.8,12.5,8968,2622,6346,5.6,19.1,-3065,-6.6,25,0,372,372,1986
2010,17660,3486,3809,44454,44929,428,11.2,452,11.8,5595,1752,3843,3.9,12.5,6544,1903,4641,4.2,14.6,-949,-2.1,25,0,302,302,1434
2011,17660,3324,3642,43288,43840,367,9.9,489,13.2,5819,2209,3610,5,13.3,6922,1909,5013,4.4,15.8,-1103,-2.5,26.6,0,301,301,1042
2012,17660,3383,3708,43650,43373,461,12.5,418,11.4,6800,2024,4776,4.7,15.7,6245,2564,3681,5.9,14.4,555,1.3,28.8,0,252,260,1263
2013,17660,3404,3720,44636,44147,398,10.7,394,10.6,6178,2001,4177,4.5,14,5199,1889,3310,4.3,11.8,979,2.2,23.6,0,260,260,1313
2014,17660,3475,3785,46239,45385,432,11.5,352,9.4,6341,2124,4217,4.7,14,4632,1583,3049,3.5,10.2,1709,3.8,20.4,0,244,244,1070
1977,17780,1695,1816,19486,18287,344,19.6,225,12.8,5149,2483,2666,13.6,28.2,2750,1397,1353,7.6,15,2399,13.2,30,0,161,161,922
1978,17780,1641,1764,21216,20336,274,15.3,309,17.3,5430,1894,3536,9.3,26.7,3669,2129,1540,10.5,18,1761,8.7,36,0,176,177,1010
1979,17780,1839,1966,24243,22740,332,17.8,141,7.6,6169,2812,3357,12.4,27.1,3163,895,2268,3.9,13.9,3006,13.2,27.8,1,1,1,
1980,17780,1388,1509,23627,22789,99,5.7,320,18.4,5605,2966,2639,13,24.6,3929,2264,1665,9.9,17.2,1676,7.4,34.4,0,244,247,1686
1981,17780,1996,2125,25799,24679,482,26.6,179,9.9,5891,3734,2157,15.1,23.9,3651,1246,2405,5,14.8,2240,9.1,29.6,0,100,100,666
1982,17780,2227,2420,31294,28500,586,25.8,262,11.5,10012,5248,4764,18.4,35.1,4424,1912,2512,6.7,15.5,5588,19.6,31,0,171,171,1107
1983,17780,2353,2550,31612,31487,456,18.4,343,13.8,7607,3551,4056,11.3,24.2,7356,2554,4802,8.1,23.4,251,0.8,46.8,0,259,263,1946
1984,17780,2415,2625,32650,32043,440,17,360,13.9,7439,3428,4011,10.7,23.2,6225,2369,3856,7.4,19.4,1214,3.8,38.8,0,250,250,1739
1985,17780,2479,2700,38688,37704,427,16,349,13.1,8074,3881,4193,10.3,21.4,6106,2633,3473,7,16.2,1968,5.2,32.4,0,236,236,1489
1986,17780,2473,2693,36754,37655,405,15,392,14.6,6431,3277,3154,8.7,17.1,8232,3175,5057,8.4,21.9,-1801,-4.8,34.2,0,277,277,1434
1987,17780,2400,2624,34446,35689,383,14.4,421,15.8,5269,2538,2731,7.1,14.8,7755,3120,4635,8.7,21.7,-2486,-6.9,29.6,0,273,274,1789
1988,17780,2342,2565,30368,30237,320,12.3,368,14.2,6403,2154,4249,7.1,21.2,6141,3062,3079,10.1,20.3,262,0.9,40.6,0,259,259,1411
1989,17780,2379,2623,31711,31118,346,13.3,298,11.5,6322,2746,3576,8.8,20.3,5135,2160,2975,6.9,16.5,1187,3.8,33,0,209,209,1241
1990,17780,2384,2631,33776,32671,311,11.8,274,10.4,6813,2885,3928,8.8,20.9,4603,1731,2872,5.3,14.1,2210,6.8,28.2,0,174,177,914
1991,17780,2469,2732,35989,34776,374,14,270,10.1,7725,3672,4053,10.6,22.2,5298,1733,3565,5,15.2,2427,7,30.4,0,167,169,1111
1992,17780,2555,2825,37619,36830,395,14.2,296,10.6,8641,4206,4435,11.4,23.5,7062,2462,4600,6.7,19.2,1579,4.3,38.4,0,194,194,1090
1993,17780,2597,2865,39604,38560,341,12,295,10.4,8775,2829,5946,7.3,22.8,6687,3352,3335,8.7,17.3,2088,5.5,34.6,0,187,187,2219
1994,17780,2719,3011,41031,40273,404,13.8,245,8.3,7503,2907,4596,7.2,18.6,5987,1713,4274,4.3,14.9,1516,3.7,29.8,0,172,172,1030
1995,17780,2807,3108,42342,41641,395,12.9,274,9,7408,3123,4285,7.5,17.8,6006,2102,3904,5,14.4,1402,3.4,28.8,0,186,186,1118
1996,17780,2855,3139,42827,42677,359,11.5,323,10.3,6780,2612,4168,6.1,15.9,6479,2349,4130,5.5,15.2,301,0.7,30.4,0,208,208,1235
1997,17780,2942,3248,44666,43865,452,14.1,355,11.1,8898,4203,4695,9.6,20.3,7295,2919,4376,6.7,16.6,1603,3.7,33.2,0,212,212,1492
1998,17780,2962,3277,46964,45729,415,12.7,365,11.2,9488,4120,5368,9,20.7,7018,3558,3460,7.8,15.3,2470,5.4,30.6,0,236,236,2200
1999,17780,2933,3263,47849,47820,364,11.1,378,11.6,9134,4188,4946,8.8,19.1,9077,3403,5674,7.1,19,57,0.1,38,0,247,247,1635
2000,17780,2963,3318,50962,49296,413,12.6,358,10.9,10756,5341,5415,10.8,21.8,7424,3411,4013,6.9,15.1,3332,6.7,30.2,0,227,227,1738
2001,17780,3004,3386,52229,52036,393,11.7,354,10.5,8511,3858,4653,7.4,16.4,8124,3307,4817,6.4,15.6,387,0.8,31.2,0,217,217,1675
2002,17780,3091,3489,53218,52213,426,12.4,318,9.3,10322,4658,5664,8.9,19.8,8311,3209,5102,6.1,15.9,2011,3.9,31.8,0,181,182,1008
2003,17780,3155,3565,54501,53519,427,12.2,281,8,9522,3949,5573,7.4,17.8,7557,2928,4629,5.5,14.1,1965,3.7,28.2,0,208,208,1764
2004,17780,3210,3631,55600,54683,435,12.1,316,8.8,8651,3094,5557,5.7,15.8,6816,2176,4640,4,12.5,1835,3.3,25,0,226,226,1465
2005,17780,3276,3735,56626,56109,419,11.4,293,8,9185,4400,4785,7.8,16.4,8150,3172,4978,5.7,14.5,1035,1.9,29,0,211,211,2283
2006,17780,3329,3828,57003,56544,467,12.4,336,8.9,10067,4674,5393,8.3,17.8,9148,3465,5683,6.1,16.2,919,1.6,32.4,0,224,224,2251
2007,17780,3386,3901,57280,56859,473,12.3,376,9.8,9850,4235,5615,7.4,17.3,9007,3401,5606,6,15.8,843,1.5,31.6,0,224,225,1328
2008,17780,3463,3995,60295,58517,409,10.4,278,7.1,9732,3694,6038,6.3,16.6,6176,1757,4419,3,10.6,3556,6,21.2,0,191,191,1146
2009,17780,3427,3962,60199,60140,366,9.2,362,9.1,8456,2676,5780,4.4,14.1,8338,2273,6065,3.8,13.9,118,0.2,27.8,0,258,258,1300
2010,17780,3429,3972,58832,59443,348,8.8,325,8.2,6852,2607,4245,4.4,11.5,8073,1852,6221,3.1,13.6,-1221,-2.1,23,0,237,237,1415
2011,17780,3404,3953,58883,58844,355,9,343,8.7,7443,2691,4752,4.6,12.6,7365,2322,5043,3.9,12.5,78,0.1,25,0,244,244,1758
2012,17780,3515,4057,60163,59447,407,10.2,312,7.8,8290,3200,5090,5.4,13.9,6858,2127,4731,3.6,11.5,1432,2.4,23,0,201,203,1098
2013,17780,3570,4161,62357,61156,404,9.9,301,7.3,8633,3565,5068,5.8,14.1,6231,1921,4310,3.1,10.2,2402,3.9,20.4,0,216,218,1487
2014,17780,3659,4260,66477,64239,445,10.6,322,7.7,11264,3696,7568,5.8,17.5,6787,2724,4063,4.2,10.6,4477,6.9,21.2,0,229,230,1476
1977,17820,5034,5590,64090,62155,1243,23.1,835,15.5,15539,8343,7196,13.4,25,11668,5971,5697,9.6,18.8,3871,6.2,37.6,0,544,550,3227
1978,17820,4934,5525,71235,67588,1084,19.5,1072,19.3,17207,6693,10514,9.9,25.5,9913,5606,4307,8.3,14.7,7294,10.8,29.4,0,656,657,2863
1979,17820,5644,6249,83174,77361,1252,21.3,574,9.8,22282,9430,12852,12.2,28.8,10655,4989,5666,6.4,13.8,11627,15,27.6,0,9,11,70
1980,17820,5757,6383,85079,83875,1128,17.9,923,14.6,18693,7973,10720,9.5,22.3,16285,7309,8976,8.7,19.4,2408,2.9,38.8,0,676,678,3775
1981,17820,5755,6357,86847,85545,1098,17.3,1071,16.8,19322,7525,11797,8.8,22.6,16717,6818,9899,8,19.5,2605,3.1,39,0,686,686,3912
1982,17820,6072,6840,92750,89620,1371,20.8,833,12.6,21360,10355,11005,11.6,23.8,15099,5564,9535,6.2,16.8,6261,7,33.6,0,469,469,2755
1983,17820,6498,7307,98084,94491,1298,18.4,873,12.3,22213,9673,12540,10.2,23.5,15027,5762,9265,6.1,15.9,7186,7.6,31.8,0,584,585,2938
1984,17820,6955,7799,109837,104185,1481,19.6,1004,13.3,27129,12615,14514,12.1,26,15824,5905,9919,5.7,15.2,11305,10.8,30.4,0,690,692,3629
1985,17820,7430,8352,117267,113521,1634,20.2,1076,13.3,25214,11911,13303,10.5,22.2,17721,7621,10100,6.7,15.6,7493,6.6,31.2,0,709,714,3961
1986,17820,7795,8790,122190,119532,1627,19,1147,13.4,25761,11653,14108,9.7,21.6,20445,7672,12773,6.4,17.1,5316,4.5,34.2,0,810,811,4519
1987,17820,7851,8962,123929,123340,1618,18.2,1395,15.7,25121,12536,12585,10.2,20.4,23943,10119,13824,8.2,19.4,1178,1,38.8,0,922,940,6162
1988,17820,7648,8814,124099,123971,1334,15,1432,16.1,24270,10961,13309,8.8,19.6,24013,8679,15334,7,19.4,257,0.2,38.8,0,1035,1035,4924
1989,17820,7511,8667,129505,126723,1127,12.9,1266,14.5,25969,10037,15932,7.9,20.5,20405,8548,11857,6.7,16.1,5564,4.4,32.2,0,859,860,5310
1990,17820,7486,8667,128311,128782,1182,13.6,1122,12.9,21811,9127,12684,7.1,16.9,22752,9003,13749,7,17.7,-941,-0.8,33.8,0,763,766,4830
1991,17820,7658,8903,131083,129968,1299,14.8,1064,12.1,23693,10627,13066,8.2,18.2,21462,7868,13594,6.1,16.5,2231,1.7,33,0,663,681,5023
1992,17820,7963,9216,138185,134959,1412,15.6,1059,11.7,29186,11768,17418,8.7,21.6,22733,9493,13240,7,16.8,6453,4.8,33.6,0,675,684,4868
1993,17820,8520,9747,150164,144139,1461,15.4,920,9.7,31666,9021,22645,6.3,22,19616,8024,11592,5.6,13.6,12050,8.4,27.2,0,603,604,2975
1994,17820,8924,10217,157042,153550,1584,15.9,1066,10.7,33052,13620,19432,8.9,21.5,26067,10392,15675,6.8,17,6985,4.5,34,0,709,710,3301
1995,17820,9291,10651,166576,161685,1656,15.9,1181,11.3,32784,13087,19697,8.1,20.3,23002,8277,14725,5.1,14.2,9782,6.1,28.4,0,826,827,5737
1996,17820,9608,10976,175023,170768,1630,15.1,1272,11.8,35106,13545,21561,7.9,20.6,26595,10313,16282,6,15.6,8511,5,31.2,0,825,825,3989
1997,17820,9929,11441,184502,179805,1829,16.3,1363,12.1,39234,15468,23766,8.6,21.8,29839,11741,18098,6.5,16.6,9395,5.2,33.2,0,886,886,5196
1998,17820,10089,11698,194896,189572,1672,14.5,1379,11.9,37536,14923,22613,7.9,19.8,26888,9159,17729,4.8,14.2,10648,5.6,28.4,0,913,913,4388
1999,17820,10307,11992,205356,201358,1714,14.5,1375,11.6,37985,14313,23672,7.1,18.9,29988,11169,18819,5.5,14.9,7997,4,29.8,0,893,893,4674
2000,17820,10494,12279,215835,211014,1822,15,1556,12.8,41178,18554,22624,8.8,19.5,31536,11672,19864,5.5,14.9,9642,4.6,29.8,0,922,922,5430
2001,17820,10740,12596,220051,218567,1780,14.3,1557,12.5,39520,17281,22239,7.9,18.1,36552,14589,21963,6.7,16.7,2968,1.4,33.4,0,928,930,5524
2002,17820,10989,12903,210127,215505,2020,15.9,1689,13.3,36032,17430,18602,8.1,16.7,46787,18023,28764,8.4,21.7,-10755,-5,33.4,0,862,864,5356
2003,17820,11158,13153,207229,207592,1905,14.7,1397,10.8,34106,15087,19019,7.3,16.4,34834,11703,23131,5.6,16.8,-728,-0.4,32.8,0,948,949,5959
2004,17820,11452,13477,206849,205692,1908,14.4,1466,11,32110,13627,18483,6.6,15.6,29797,10365,19432,5,14.5,2313,1.1,29,0,932,939,5184
2005,17820,11791,13923,213468,209395,1987,14.5,1380,10.1,36965,14204,22761,6.8,17.7,28818,10307,18511,4.9,13.8,8147,3.9,27.6,0,931,931,5638
2006,17820,12202,14495,223300,217906,2214,15.6,1506,10.6,41903,18453,23450,8.5,19.2,31114,11690,19424,5.4,14.3,10789,4.9,28.6,0,1020,1020,6689
2007,17820,12436,14828,230376,226368,2035,13.9,1663,11.4,44413,15026,29387,6.6,19.6,36396,11572,24824,5.1,16.1,8017,3.5,32.2,0,1029,1037,5826
2008,17820,12332,14684,228912,228521,1718,11.7,1700,11.6,34248,12990,21258,5.7,15,33466,12308,21158,5.4,14.6,782,0.4,29.2,0,1096,1096,5247
2009,17820,11922,14265,217488,222348,1527,10.6,1754,12.2,25365,10259,15106,4.6,11.4,35084,9430,25654,4.2,15.8,-9719,-4.4,22.8,0,1120,1120,4839
2010,17820,11846,14239,214730,215727,1612,11.4,1525,10.7,35130,13041,22089,6,16.3,37123,8887,28236,4.1,17.2,-1993,-0.9,32.6,0,929,929,4508
2011,17820,11837,14298,217820,216074,1626,11.4,1479,10.4,30312,11206,19106,5.2,14,26820,7146,19674,3.3,12.4,3492,1.6,24.8,0,921,921,3988
2012,17820,11848,14253,220265,218582,1587,11.1,1591,11.2,31332,10093,21239,4.6,14.3,27965,8979,18986,4.1,12.8,3367,1.5,25.6,0,914,922,4481
2013,17820,12035,14489,227445,223269,1592,11.1,1354,9.5,34714,11527,23187,5.2,15.5,26362,9509,16853,4.3,11.8,8352,3.7,23.6,0,819,820,5371
2014,17820,12228,14753,225932,226212,1789,12.3,1426,9.8,31848,10703,21145,4.7,14.1,32408,9965,22443,4.4,14.3,-560,-0.2,28.2,0,973,974,5079
1977,17860,1902,2020,25513,24987,357,18.2,243,12.4,4663,2437,2226,9.8,18.7,3611,1509,2102,6,14.5,1052,4.2,29,0,162,163,966
1978,17860,1959,2090,27646,26570,342,16.6,267,13,5875,2054,3821,7.7,22.1,3722,1874,1848,7.1,14,2153,8.1,28,0,191,191,983
1979,17860,2018,2150,30532,29055,307,14.5,230,10.9,6609,2105,4504,7.2,22.7,3655,1291,2364,4.4,12.6,2954,10.1,25.2,0,171,171,896
1980,17860,1989,2123,29714,30059,256,12,266,12.5,4819,2034,2785,6.8,16,5509,2362,3147,7.9,18.3,-690,-2.3,32,0,190,192,1236
1981,17860,1936,2070,28606,28713,266,12.8,278,13.3,4408,2038,2370,7.1,15.4,4622,2207,2415,7.7,16.1,-214,-0.7,30.8,0,183,183,1457
1982,17860,1929,2081,28217,28410,292,14.1,260,12.5,4984,2385,2599,8.4,17.5,5370,2013,3357,7.1,18.9,-386,-1.4,35,0,144,144,677
1983,17860,2019,2171,28845,28507,311,14.6,228,10.7,5570,2599,2971,9.1,19.5,4893,2010,2883,7.1,17.2,677,2.3,34.4,0,140,140,763
1984,17860,2096,2258,32836,31199,295,13.3,222,10,6491,2385,4106,7.6,20.8,3216,1301,1915,4.2,10.3,3275,10.5,20.6,0,136,136,666
1985,17860,2204,2369,34200,33599,365,15.8,260,11.2,6063,2874,3189,8.6,18,4861,2054,2807,6.1,14.5,1202,3.5,29,0,177,178,1219
1986,17860,2343,2546,36703,35338,411,16.7,231,9.4,7199,3280,3919,9.3,20.4,4468,1460,3008,4.1,12.6,2731,7.8,25.2,0,137,137,837
1987,17860,2450,2670,42791,41680,440,16.9,309,11.8,8076,3871,4205,9.3,19.4,5854,2369,3485,5.7,14,2222,5.4,28,0,206,206,1406
1988,17860,2416,2661,42633,42439,328,12.3,314,11.8,6833,2701,4132,6.4,16.1,6444,2775,3669,6.5,15.2,389,0.9,30.4,0,211,211,1405
1989,17860,2475,2735,44521,43545,323,12,251,9.3,6520,2010,4510,4.6,15,4567,1646,2921,3.8,10.5,1953,4.5,21,0,163,163,1004
1990,17860,2559,2828,47346,46625,364,13.1,259,9.3,6597,2714,3883,5.8,14.1,5154,1980,3174,4.2,11.1,1443,3,22.2,0,176,176,1342
1991,17860,2589,2888,49316,48381,331,11.6,271,9.5,7538,2839,4699,5.9,15.6,5667,2278,3389,4.7,11.7,1871,3.9,23.4,0,173,173,1220
1992,17860,2682,2981,51450,50319,376,12.8,276,9.4,8229,2928,5301,5.8,16.4,5967,1959,4008,3.9,11.9,2262,4.5,23.8,0,169,172,1083
1993,17860,2764,3059,52319,51943,350,11.6,276,9.1,6610,2104,4506,4.1,12.7,5857,1767,4090,3.4,11.3,753,1.4,22.6,0,187,188,997
1994,17860,2857,3158,54713,53489,410,13.2,290,9.3,8048,3087,4961,5.8,15,5599,1738,3861,3.2,10.5,2449,4.5,21,0,217,217,1018
1995,17860,2963,3277,58320,56497,423,13.2,300,9.3,9962,3084,6878,5.5,17.6,6315,1701,4614,3,11.2,3647,6.4,22.4,0,217,217,1127
1996,17860,3028,3332,58950,58608,387,11.7,320,9.7,7984,2747,5237,4.7,13.6,7299,2144,5155,3.7,12.5,685,1.1,25,0,211,211,1121
1997,17860,3072,3381,61063,60026,431,12.8,369,11,9451,2786,6665,4.6,15.7,7378,3013,4365,5,12.3,2073,3.4,24.6,0,238,238,1550
1998,17860,3139,3458,62406,61734,442,12.9,363,10.6,7675,2540,5135,4.1,12.4,6331,2142,4189,3.5,10.3,1344,2.1,20.6,0,248,248,1068
1999,17860,3182,3510,62439,61287,390,11.2,339,9.7,9491,3984,5507,6.5,15.5,7187,2665,4522,4.3,11.7,2304,3.8,23.4,0,218,218,1559
2000,17860,3214,3562,64004,63236,420,11.9,366,10.4,9505,3211,6294,5.1,15,7969,3275,4694,5.2,12.6,1536,2.4,25.2,0,240,240,1173
2001,17860,3245,3606,64838,64468,363,10.1,345,9.6,7654,2209,5445,3.4,11.9,6913,1955,4958,3,10.7,741,1.2,21.4,0,203,203,900
2002,17860,3223,3596,63906,64359,462,12.8,470,13.1,10166,4064,6102,6.3,15.8,11071,4739,6332,7.4,17.2,-905,-1.4,31.6,0,300,300,2616
2003,17860,3246,3619,66718,65167,414,11.5,338,9.4,9629,2675,6954,4.1,14.8,6529,1714,4815,2.6,10,3100,4.8,20,0,225,225,1000
2004,17860,3383,3761,67169,66482,471,12.8,284,7.7,8427,2431,5996,3.7,12.7,7054,1319,5735,2,10.6,1373,2.1,21.2,0,199,199,885
2005,17860,3506,3901,69118,68033,476,12.5,309,8.1,9732,3224,6508,4.7,14.3,7561,2738,4823,4,11.1,2171,3.2,22.2,0,233,233,2433
2006,17860,3540,3969,70058,69359,504,12.8,391,10,9923,3628,6295,5.2,14.3,8525,3449,5076,5,12.3,1398,2,24.6,0,281,281,1369
2007,17860,3623,4134,74161,72047,547,13.5,398,9.8,13389,4363,9026,6.1,18.6,9161,2359,6802,3.3,12.7,4228,5.9,25.4,0,273,274,1335
2008,17860,3632,4142,72925,73097,411,10,359,8.7,7928,2598,5330,3.6,10.8,8271,2335,5936,3.2,11.3,-343,-0.5,21.6,0,261,261,1248
2009,17860,3554,4046,67359,70088,352,8.6,424,10.4,6974,2703,4271,3.9,10,12432,2601,9831,3.7,17.7,-5458,-7.7,20,0,290,291,1488
2010,17860,3519,4031,68424,67774,355,8.8,343,8.5,9104,3261,5843,4.8,13.4,7803,2664,5139,3.9,11.5,1301,1.9,23,0,239,239,2087
2011,17860,3518,4032,68233,68256,379,9.4,357,8.9,6565,1733,4832,2.5,9.6,6611,1557,5054,2.3,9.7,-46,-0.1,19.2,0,243,243,1084
2012,17860,3566,4072,71877,69963,418,10.3,358,8.9,9207,2735,6472,3.9,13.2,5379,1771,3608,2.5,7.7,3828,5.5,15.4,0,223,223,779
2013,17860,3651,4152,73026,72350,385,9.4,307,7.5,7110,1706,5404,2.4,9.8,5757,1534,4223,2.1,8,1353,1.8,16,0,205,205,1080
2014,17860,3708,4200,75308,74049,411,9.9,333,8,7792,2347,5445,3.2,10.5,5274,1396,3878,1.9,7.1,2518,3.4,14.2,0,226,226,971
1977,17900,7393,8357,126621,123636,1411,17.3,1033,12.6,25277,11776,13501,9.5,20.4,19307,7430,11877,6,15.6,5970,4.8,31.2,0,721,723,4503
1978,17900,7698,8775,138264,131957,1455,17,1039,12.1,28566,10534,18032,8,21.6,15952,6402,9550,4.9,12.1,12614,9.5,24.2,0,745,747,3179
1979,17900,7766,8903,143451,141891,1225,13.9,1046,11.8,25243,9898,15345,7,17.8,22122,6864,15258,4.8,15.6,3121,2.2,31.2,0,731,735,4297
1980,17900,7872,9030,149685,146484,1219,13.6,1064,11.9,25495,7606,17889,5.2,17.4,19093,6305,12788,4.3,13,6402,4.4,26,0,749,750,3014
1981,17900,7640,8808,144343,144876,1176,13.2,1314,14.7,23795,9252,14543,6.4,16.4,24861,9497,15364,6.6,17.2,-1066,-0.8,32.8,0,793,793,4823
1982,17900,7794,9089,146735,145537,1413,15.8,1040,11.6,23709,11902,11807,8.2,16.3,21313,7046,14267,4.8,14.6,2396,1.7,29.2,0,603,603,3745
1983,17900,7502,8805,143996,144139,1077,12,1255,14,24594,11049,13545,7.7,17.1,24879,9248,15631,6.4,17.3,-285,-0.2,34.2,0,729,731,4574
1984,17900,8444,9810,162059,153321,1424,15.3,615,6.6,32454,12785,19669,8.3,21.2,14977,4494,10483,2.9,9.8,17477,11.4,19.6,0,15,16,354
1985,17900,8822,10234,172411,169002,1402,14,1010,10.1,33286,13863,19423,8.2,19.7,26468,9419,17049,5.6,15.7,6818,4,31.4,0,657,659,4216
1986,17900,9265,10735,180758,176636,1581,15.1,1041,9.9,37427,13578,23849,7.7,21.2,29183,13550,15633,7.7,16.5,8244,4.7,33,0,642,642,4471
1987,17900,9542,11168,192417,189172,1749,16,1282,11.7,37023,17319,19704,9.2,19.6,30532,10477,20055,5.5,16.1,6491,3.5,32.2,0,799,808,4705
1988,17900,9660,11352,195162,192133,1609,14.3,1380,12.3,36185,15556,20629,8.1,18.8,30126,12416,17710,6.5,15.7,6059,3.1,31.4,0,887,887,4939
1989,17900,9800,11596,203660,199714,1509,13.2,1279,11.1,37221,15675,21546,7.8,18.6,29328,12461,16867,6.2,14.7,7893,3.9,29.4,0,862,863,7739
1990,17900,9938,11828,209526,206251,1507,12.9,1178,10.1,33846,12262,21584,5.9,16.4,27295,8729,18566,4.2,13.2,6551,3.2,26.4,0,822,822,5251
1991,17900,10186,12217,206326,207855,1678,14,1288,10.7,33356,15697,17659,7.6,16,36414,12959,23455,6.2,17.5,-3058,-1.5,32,0,759,766,6472
1992,17900,10290,12383,205286,205640,1585,12.9,1362,11.1,31309,12067,19242,5.9,15.2,32017,10910,21107,5.3,15.6,-708,-0.4,30.4,0,839,848,4656
1993,17900,10513,12620,205776,205482,1456,11.6,1202,9.6,28904,10731,18173,5.2,14.1,28316,9578,18738,4.7,13.8,588,0.3,27.6,0,789,790,3872
1994,17900,10756,12893,214558,210144,1555,12.2,1243,9.7,35512,15825,19687,7.5,16.9,26684,10520,16164,5,12.7,8828,4.2,25.4,0,799,802,5407
1995,17900,11067,13219,223993,219346,1620,12.4,1262,9.7,36400,13815,22585,6.3,16.6,27105,9174,17931,4.2,12.4,9295,4.2,24.8,0,809,811,4575
1996,17900,11206,13406,229889,226971,1593,12,1365,10.3,35808,14331,21477,6.3,15.8,29972,10057,19915,4.4,13.2,5836,2.6,26.4,0,866,866,4422
1997,17900,11413,13730,234719,232210,1753,12.9,1427,10.5,39916,14666,25250,6.3,17.2,34897,12838,22059,5.5,15,5019,2.2,30,0,858,858,6099
1998,17900,11611,13958,250727,242683,1684,12.2,1430,10.3,48757,23142,25615,9.5,20.1,32669,13335,19334,5.5,13.5,16088,6.6,27,0,871,871,5500
1999,17900,11804,14251,264407,259350,1755,12.4,1458,10.3,45755,15759,29996,6.1,17.6,35640,13976,21664,5.4,13.7,10115,3.9,27.4,0,915,915,5857
2000,17900,11863,14393,270807,267063,1644,11.5,1507,10.5,44509,15456,29053,5.8,16.7,37021,15025,21996,5.6,13.9,7488,2.8,27.8,0,885,885,5849
2001,17900,11899,14573,279015,275661,1746,12,1683,11.6,52123,20536,31587,7.4,18.9,45415,15877,29538,5.8,16.5,6708,2.4,33,0,953,953,6646
2002,17900,11950,14637,275224,277078,1789,12.2,1734,11.9,48352,17753,30599,6.4,17.5,52060,15216,36844,5.5,18.8,-3708,-1.3,35,0,888,894,4990
2003,17900,12113,14860,271539,270189,1700,11.6,1249,8.5,46273,17021,29252,6.3,17.1,43573,14253,29320,5.3,16.1,2700,1,32.2,0,886,886,6458
2004,17900,12311,15124,274321,272610,1714,11.5,1305,8.7,41203,15376,25827,5.6,15.1,37782,13248,24534,4.9,13.9,3421,1.2,27.8,0,882,882,5992
2005,17900,12545,15506,279818,276112,1806,11.8,1289,8.4,41934,16333,25601,5.9,15.2,34522,9061,25461,3.3,12.5,7412,2.7,25,0,906,906,6070
2006,17900,12777,15844,292364,285260,1770,11.3,1310,8.4,45527,16997,28530,6,16,31319,9421,21898,3.3,11,14208,5,22,0,843,844,5063
2007,17900,12890,16133,290743,290877,1862,11.7,1493,9.4,45427,15898,29529,5.5,15.6,45695,13491,32204,4.6,15.7,-268,-0.1,31.2,0,965,971,5522
2008,17900,12849,16159,293631,291478,1586,9.9,1405,8.7,39515,14635,24880,5,13.6,35208,7885,27323,2.7,12.1,4307,1.5,24.2,0,1005,1006,5323
2009,17900,12496,15794,281327,286488,1389,8.7,1559,9.8,30669,11017,19652,3.8,10.7,40991,10120,30871,3.5,14.3,-10322,-3.6,21.4,0,1035,1050,5441
2010,17900,12338,15615,273105,276557,1319,8.4,1430,9.1,32349,11821,20528,4.3,11.7,39253,8739,30514,3.2,14.2,-6904,-2.5,23.4,0,899,903,4765
2011,17900,12138,15429,272484,272312,1316,8.5,1399,9,33753,10762,22991,4,12.4,33409,8857,24552,3.3,12.3,344,0.1,24.6,0,951,951,5530
2012,17900,12132,15403,272666,272447,1317,8.6,1338,8.7,35780,11059,24721,4.1,13.1,35342,10983,24359,4,13,438,0.1,26,0,802,803,4583
2013,17900,12200,15463,279055,275539,1281,8.3,1193,7.8,36191,10239,25952,3.7,13.1,29159,10413,18746,3.8,10.6,7032,2.5,21.2,0,749,757,5311
2014,17900,12189,15488,283847,280824,1372,8.9,1213,7.9,35333,10986,24347,3.9,12.6,29286,8194,21092,2.9,10.4,6047,2.2,20.8,0,846,848,4728
1977,17980,828,877,9153,9197,167,19.2,150,17.3,2197,1069,1128,11.6,23.9,2285,1238,1047,13.5,24.8,-88,-0.9,47.8,0,104,104,1037
1978,17980,836,881,10000,9563,125,14.2,116,13.2,2145,707,1438,7.4,22.4,1271,477,794,5,13.3,874,9.1,26.6,0,90,90,317
1979,17980,840,890,11264,10628,131,14.8,115,13,2589,671,1918,6.3,24.4,1317,486,831,4.6,12.4,1272,12,24.8,0,84,84,321
1980,17980,822,876,10405,10841,123,13.9,136,15.4,1442,588,854,5.4,13.3,2313,822,1491,7.6,21.3,-871,-8,26.6,0,94,94,403
1981,17980,788,839,10161,10054,108,12.6,130,15.2,1766,879,887,8.7,17.6,1551,762,789,7.6,15.4,215,2.2,30.8,0,91,91,504
1982,17980,769,832,9928,10018,113,13.5,100,12,1467,634,833,6.3,14.6,1647,516,1131,5.2,16.4,-180,-1.8,29.2,0,59,59,294
1983,17980,798,858,9630,9737,103,12.2,93,11,1548,547,1001,5.6,15.9,1761,611,1150,6.3,18.1,-213,-2.2,31.8,0,59,59,387
1984,17980,850,911,10436,10039,142,16.1,88,9.9,1755,547,1208,5.4,17.5,960,359,601,3.6,9.6,795,7.9,19.2,0,60,60,199
1985,17980,885,948,11426,11080,139,14.9,109,11.7,2131,1225,906,11.1,19.2,1438,841,597,7.6,13,693,6.2,26,0,69,69,351
1986,17980,887,953,11403,11405,140,14.7,131,13.8,1979,940,1039,8.2,17.4,1983,975,1008,8.5,17.4,-4,0,34.8,0,87,87,679
1987,17980,911,977,13395,13068,150,15.5,115,11.9,2358,779,1579,6,18,1703,596,1107,4.6,13,655,5,26,0,87,87,426
1988,17980,884,946,13692,13340,100,10.4,115,12,2103,716,1387,5.4,15.8,1399,571,828,4.3,10.5,704,5.3,21,0,73,73,263
1989,17980,934,1003,14835,14268,168,17.2,113,11.6,2790,1401,1389,9.8,19.6,1656,495,1161,3.5,11.6,1134,8,23.2,0,82,82,417
1990,17980,942,1017,14569,14695,137,13.6,120,11.9,2151,865,1286,5.9,14.6,2402,993,1409,6.8,16.3,-251,-1.7,29.2,0,85,85,757
1991,17980,957,1039,14083,14329,128,12.4,104,10.1,1867,885,982,6.2,13,2359,563,1796,3.9,16.5,-492,-3.5,26,0,71,74,368
1992,17980,955,1044,15359,14704,129,12.4,113,10.8,2615,742,1873,5,17.8,1305,508,797,3.5,8.9,1310,8.9,17.8,0,87,87,380
1993,17980,981,1072,16433,15882,131,12.4,91,8.6,2822,720,2102,4.5,17.8,1719,535,1184,3.4,10.8,1103,7,21.6,0,72,72,343
1994,17980,1024,1111,16933,16652,146,13.4,101,9.3,2403,1203,1200,7.2,14.4,1840,449,1391,2.7,11,563,3.4,22,0,69,69,270
1995,17980,1058,1140,17795,17373,146,13,115,10.2,2237,637,1600,3.7,12.9,1393,498,895,2.9,8,844,4.9,16,0,79,79,268
1996,17980,1088,1170,17921,17847,158,13.7,127,11,2546,1079,1467,6,14.3,2397,709,1688,4,13.4,149,0.9,26.8,0,85,85,355
1997,17980,1135,1215,17540,17730,171,14.3,127,10.6,3058,1010,2048,5.7,17.2,3437,759,2678,4.3,19.4,-379,-2.2,34.4,0,87,87,414
1998,17980,1139,1236,18103,17822,157,12.8,131,10.7,2630,802,1828,4.5,14.8,2068,687,1381,3.9,11.6,562,3.2,23.2,0,102,102,442
1999,17980,1158,1262,19570,18830,167,13.4,142,11.4,3249,950,2299,5,17.3,1769,715,1054,3.8,9.4,1480,7.9,18.8,0,95,95,431
2000,17980,1154,1265,18813,19200,139,11,136,10.8,2186,932,1254,4.9,11.4,2959,1281,1678,6.7,15.4,-773,-4,22.8,0,95,95,512
2001,17980,1120,1230,18459,18661,136,10.9,181,14.5,2548,665,1883,3.6,13.7,2952,1467,1485,7.9,15.8,-404,-2.1,27.4,0,111,111,607
2002,17980,1137,1249,17647,18052,175,14.1,155,12.5,2177,953,1224,5.3,12.1,2987,934,2053,5.2,16.5,-810,-4.4,24.2,0,94,94,374
2003,17980,1157,1274,17619,17427,159,12.6,119,9.5,2520,1176,1344,6.7,14.5,2136,620,1516,3.6,12.3,384,2.2,24.6,0,85,85,440
2004,17980,1150,1270,17150,17395,150,11.8,138,10.8,2532,928,1604,5.3,14.6,3022,1263,1759,7.3,17.4,-490,-2.8,29.2,0,97,97,822
2005,17980,1174,1302,17061,17084,157,12.2,114,8.9,2525,974,1551,5.7,14.8,2571,876,1695,5.1,15,-46,-0.2,29.6,0,76,76,661
2006,17980,1188,1326,16537,16787,178,13.6,144,11,2651,1350,1301,8,15.8,3151,717,2434,4.3,18.8,-500,-3,31.6,0,92,92,463
2007,17980,1208,1359,17175,16852,155,11.5,128,9.5,2892,1036,1856,6.1,17.2,2245,761,1484,4.5,13.3,647,3.9,26.6,0,101,101,380
2008,17980,1193,1346,17494,17269,125,9.3,132,9.8,2718,1314,1404,7.6,15.7,2267,591,1676,3.4,13.1,451,2.6,26.2,0,97,97,469
2009,17980,1158,1302,16728,17085,105,8,140,10.6,1653,632,1021,3.7,9.7,2367,507,1860,3,13.9,-714,-4.2,19.4,0,101,101,368
2010,17980,1116,1269,16674,16626,104,8.1,128,10,1934,416,1518,2.5,11.6,1838,598,1240,3.6,11.1,96,0.5,22.2,0,94,94,336
2011,17980,1092,1242,17321,16910,98,7.8,116,9.3,2486,746,1740,4.4,14.7,1664,627,1037,3.7,9.8,822,4.9,19.6,0,81,81,472
2012,17980,1098,1249,18182,17735,121,9.7,112,9,2925,1674,1251,9.4,16.5,2030,493,1537,2.8,11.4,895,5.1,22.8,0,80,80,260
2013,17980,1105,1244,18211,18159,106,8.5,106,8.5,2145,634,1511,3.5,11.8,2041,736,1305,4.1,11.2,104,0.6,22.4,0,64,64,592
2014,17980,1100,1260,18956,18564,123,9.9,100,8,2575,1152,1423,6.2,13.9,1790,414,1376,2.2,9.6,785,4.3,19.2,0,74,74,269
1977,18020,1093,1171,28473,27447,182,15.9,129,11.3,4720,1682,3038,6.1,17.2,2668,1255,1413,4.6,9.7,2052,7.5,19.4,0,81,81,764
1978,18020,1150,1234,29040,28755,175,14.6,113,9.4,3858,1530,2328,5.3,13.4,3287,910,2377,3.2,11.4,571,2,22.8,0,74,74,464
1979,18020,1155,1237,29947,29483,134,10.8,126,10.2,3352,845,2507,2.9,11.4,2424,1055,1369,3.6,8.2,928,3.2,16.4,0,90,90,281
1980,18020,1172,1255,29338,29628,128,10.3,103,8.3,3320,1042,2278,3.5,11.2,3899,697,3202,2.4,13.2,-579,-2,22.4,0,72,72,225
1981,18020,1141,1231,30459,29861,139,11.2,150,12.1,4300,1551,2749,5.2,14.4,3103,1044,2059,3.5,10.4,1197,4,20.8,0,99,100,508
1982,18020,1126,1222,25549,27969,145,11.8,141,11.5,1888,816,1072,2.9,6.8,6727,1849,4878,6.6,24.1,-4839,-17.3,13.6,0,76,76,326
1983,18020,1056,1148,25138,25336,106,8.9,166,14,2913,999,1914,3.9,11.5,3309,1252,2057,4.9,13.1,-396,-1.6,23,0,94,94,612
1984,18020,1147,1254,27121,26181,145,12.1,68,5.7,4151,1246,2905,4.8,15.9,2271,631,1640,2.4,8.7,1880,7.2,17.4,0,,,
1985,18020,1202,1310,28386,27743,178,13.9,119,9.3,4433,1704,2729,6.1,16,3146,904,2242,3.3,11.3,1287,4.7,22.6,0,80,80,372
1986,18020,1241,1349,29637,28986,174,13.1,126,9.5,4503,1939,2564,6.7,15.5,3200,1146,2054,4,11,1303,4.5,22,0,73,73,432
1987,18020,1299,1412,31024,30330,198,14.3,133,9.6,4048,1471,2577,4.8,13.3,2660,1041,1619,3.4,8.8,1388,4.5,17.6,0,83,83,375
1988,18020,1280,1395,30275,30605,144,10.3,150,10.7,4050,1339,2711,4.4,13.2,4710,1356,3354,4.4,15.4,-660,-2.2,26.4,0,91,91,439
1989,18020,1329,1446,32020,31143,187,13.2,141,9.9,4908,2037,2871,6.5,15.8,3154,1740,1414,5.6,10.1,1754,5.7,20.2,0,89,89,1399
1990,18020,1412,1529,32488,32173,213,14.3,122,8.2,5253,2282,2971,7.1,16.3,4624,816,3808,2.5,14.4,629,1.9,28.8,0,82,82,468
1991,18020,1431,1566,31887,32135,189,12.2,150,9.7,3867,1499,2368,4.7,12,4364,1300,3064,4,13.6,-497,-1.6,24,0,95,95,827
1992,18020,1463,1625,33746,32853,190,11.9,136,8.5,4839,1686,3153,5.1,14.7,3052,953,2099,2.9,9.3,1787,5.4,18.6,0,88,88,608
1993,18020,1483,1642,31280,32473,155,9.5,136,8.3,4670,1569,3101,4.8,14.4,7055,777,6278,2.4,21.7,-2385,-7.3,28.8,0,91,91,367
1994,18020,1543,1702,35276,33910,184,11,125,7.5,6372,1435,4937,4.2,18.8,3639,1445,2194,4.3,10.7,2733,8.1,21.4,0,85,85,574
1995,18020,1567,1732,35422,35331,185,10.8,152,8.9,4775,1501,3274,4.2,13.5,4593,1452,3141,4.1,13,182,0.5,26,0,99,99,523
1996,18020,1566,1745,35435,35433,163,9.4,145,8.3,4330,1764,2566,5,12.2,4325,1158,3167,3.3,12.2,5,0,24.4,0,87,87,276
1997,18020,1608,1809,37072,36504,214,12,150,8.4,4920,1921,2999,5.3,13.5,3783,1494,2289,4.1,10.4,1137,3.1,20.8,0,103,103,689
1998,18020,1613,1813,36168,36698,182,10,184,10.2,5288,1370,3918,3.7,14.4,6348,2725,3623,7.4,17.3,-1060,-2.9,28.8,0,115,115,652
1999,18020,1581,1789,35334,35710,170,9.4,195,10.8,4399,1522,2877,4.3,12.3,5151,1287,3864,3.6,14.4,-752,-2.1,24.6,0,126,126,615
2000,18020,1574,1779,37175,36287,154,8.6,164,9.2,5264,2134,3130,5.9,14.5,3487,941,2546,2.6,9.6,1777,4.9,19.2,0,95,95,456
2001,18020,1534,1751,36512,36847,155,8.8,188,10.6,4859,1240,3619,3.4,13.2,5529,1630,3899,4.4,15,-670,-1.8,26.4,0,124,124,609
2002,18020,1525,1734,35900,36205,169,9.7,185,10.6,5429,2733,2696,7.5,15,6039,1750,4289,4.8,16.7,-610,-1.7,30,0,89,89,716
2003,18020,1537,1745,36555,36117,162,9.4,124,7.2,4972,1092,3880,3,13.8,4095,787,3308,2.2,11.3,877,2.5,22.6,0,81,81,463
2004,18020,1531,1730,39004,37652,150,8.7,140,8.1,6581,3138,3443,8.3,17.5,3877,1655,2222,4.4,10.3,2704,7.2,20.6,0,90,90,1040
2005,18020,1534,1736,40499,39391,153,8.9,126,7.3,7897,4314,3583,11,20,5681,617,5064,1.6,14.4,2216,5.6,28.8,0,77,77,417
2006,18020,1560,1767,41663,41047,187,10.7,139,8,5984,2530,3454,6.2,14.6,4751,1298,3453,3.2,11.6,1233,3,23.2,0,96,96,924
2007,18020,1589,1819,41417,41544,183,10.2,136,7.6,5151,1969,3182,4.7,12.4,5405,1929,3476,4.6,13,-254,-0.6,24.8,0,84,84,1270
2008,18020,1546,1777,41935,41675,120,6.7,150,8.4,5149,798,4351,1.9,12.4,4628,1307,3321,3.1,11.1,521,1.3,22.2,0,104,104,608
2009,18020,1499,1736,38986,40366,109,6.2,133,7.6,3102,675,2427,1.7,7.7,5861,848,5013,2.1,14.5,-2759,-6.8,15.4,0,88,89,467
2010,18020,1474,1707,38211,38445,128,7.5,139,8.1,5114,2253,2861,5.9,13.3,5581,1060,4521,2.8,14.5,-467,-1.2,26.6,0,95,95,799
2011,18020,1463,1703,39597,38830,124,7.3,112,6.6,4045,917,3128,2.4,10.4,2510,561,1949,1.4,6.5,1535,3.9,13,0,81,81,405
2012,18020,1456,1685,43453,41507,136,8,152,9,7349,1010,6339,2.4,17.7,3457,1154,2303,2.8,8.3,3892,9.4,16.6,0,80,80,663
2013,18020,1450,1678,42442,42847,107,6.4,109,6.5,3712,749,2963,1.7,8.7,4522,911,3611,2.1,10.6,-810,-1.9,17.4,0,71,71,421
2014,18020,1436,1657,44399,43371,132,8,128,7.7,5069,888,4181,2,11.7,3012,710,2302,1.6,6.9,2057,4.8,13.8,0,89,89,479
1977,18140,18200,22151,417140,396733,3757,17.3,2786,12.8,98500,38797,59703,9.8,24.8,57685,25036,32649,6.3,14.5,40815,10.3,29,0,1772,1783,13512
1978,18140,18610,22677,433703,425428,3098,13.8,2578,11.5,85263,25732,59531,6,20,68712,22692,46020,5.3,16.2,16551,3.8,32.4,0,1663,1671,8786
1979,18140,18977,23175,450689,442082,3161,13.8,2553,11.1,78341,27129,51212,6.1,17.7,61126,23581,37545,5.3,13.8,17215,3.9,27.6,0,1665,1668,8734
1980,18140,19181,23454,457319,453855,2974,12.8,2596,11.1,75053,23564,51489,5.2,16.5,68125,22176,45949,4.9,15,6928,1.5,30,0,1749,1765,10103
1981,18140,18476,22617,430014,438109,2709,11.8,3283,14.3,60315,26059,34256,5.9,13.8,76504,30239,46265,6.9,17.5,-16189,-3.7,27.6,0,1783,1793,10953
1982,18140,18627,23253,427927,428663,3420,14.9,2612,11.4,69371,32859,36512,7.7,16.2,70842,21182,49660,4.9,16.5,-1471,-0.3,32.4,0,1412,1416,9252
1983,18140,19147,23730,431185,429642,2812,12,2496,10.6,68575,25111,43464,5.8,16,65489,22760,42729,5.3,15.2,3086,0.8,30.4,0,1508,1511,10332
1984,18140,19920,24626,464060,448390,3269,13.5,2399,9.9,86409,31503,54906,7,19.3,55068,18812,36256,4.2,12.3,31341,7,24.6,0,1423,1457,7994
1985,18140,20411,25186,489544,475371,3167,12.7,2579,10.4,88494,26057,62437,5.5,18.6,60147,25285,34862,5.3,12.7,28347,5.9,25.4,0,1579,1583,12401
1986,18140,21138,26080,510006,499743,3514,13.7,2547,9.9,92022,35498,56524,7.1,18.4,71496,23530,47966,4.7,14.3,20526,4.1,28.6,0,1587,1591,11321
1987,18140,21852,27211,539344,526176,4052,15.2,2828,10.6,105747,40681,65066,7.7,20.1,79411,31067,48344,5.9,15.1,26336,5,30.2,0,1747,1760,13321
1988,18140,22418,28014,555146,547474,3699,13.4,2847,10.3,102037,39000,63037,7.1,18.6,86694,27252,59442,5,15.8,15343,2.8,31.6,0,1722,1722,10804
1989,18140,22865,28797,587515,571647,3527,12.4,2755,9.7,116831,47827,69004,8.4,20.4,85096,30556,54540,5.3,14.9,31735,5.5,29.8,0,1753,1767,12129
1990,18140,23227,29337,605532,596371,3445,11.9,2787,9.6,98662,36676,61986,6.1,16.5,80341,26156,54185,4.4,13.5,18321,3,27,0,1783,1786,15121
1991,18140,23783,30015,591898,597380,3565,12,2861,9.6,85056,33148,51908,5.5,14.2,96019,32831,63188,5.5,16.1,-10963,-1.9,28.4,0,1712,1731,19618
1992,18140,23916,30328,605582,598665,3522,11.6,3178,10.5,101417,37297,64120,6.2,16.9,87583,29397,58186,4.9,14.6,13834,2.3,29.2,0,1867,1902,14157
1993,18140,24449,30711,614375,609488,3183,10.4,2780,9.1,93602,29385,64217,4.8,15.4,83827,24422,59405,4,13.8,9775,1.6,27.6,0,1706,1710,11297
1994,18140,25108,31589,636460,626588,3699,11.9,2766,8.9,100705,35824,64881,5.7,16.1,80960,27208,53752,4.3,12.9,19745,3.2,25.8,0,1728,1761,11133
1995,18140,25738,32382,661960,649007,3833,12,2933,9.2,103636,37322,66314,5.8,16,77730,24928,52802,3.8,12,25906,4,24,0,1899,1915,12495
1996,18140,26211,33035,692945,678615,3784,11.6,3083,9.4,110857,44396,66461,6.5,16.3,82196,25336,56860,3.7,12.1,28661,4.2,24.2,0,1914,1914,11337
1997,18140,26537,33520,715945,704112,4365,13.1,3878,11.6,139711,62272,77439,8.8,19.8,116044,47164,68880,6.7,16.5,23667,3.3,33,0,2228,2228,14427
1998,18140,26754,33922,745458,731151,3886,11.5,3445,10.2,127569,48300,79269,6.6,17.4,98954,36672,62282,5,13.5,28615,3.9,27,0,2137,2137,14653
1999,18140,26985,34423,775316,761279,3870,11.3,3367,9.9,128333,43899,84434,5.8,16.9,100259,38078,62181,5,13.2,28074,3.7,26.4,0,2006,2006,14699
2000,18140,27023,34809,805045,790362,3851,11.1,3435,9.9,135930,52048,83882,6.6,17.2,106564,41218,65346,5.2,13.5,29366,3.7,27,0,2021,2021,16155
2001,18140,27253,35511,797237,802634,3961,11.3,3505,10,122743,46985,75758,5.9,15.3,133536,49328,84208,6.1,16.6,-10793,-1.3,30.6,0,1939,1940,12042
2002,18140,27448,35713,793815,799296,4303,12.1,4097,11.5,139377,54515,84862,6.8,17.4,150339,49721,100618,6.2,18.8,-10962,-1.4,34.8,0,1931,1932,18391
2003,18140,27586,36057,788466,785583,3998,11.2,3014,8.4,116677,37781,78896,4.8,14.9,110911,28921,81990,3.7,14.1,5766,0.8,28.2,0,1939,1944,14376
2004,18140,27914,36399,785451,781629,3941,10.9,3153,8.7,118911,40803,78108,5.2,15.2,111267,43807,67460,5.6,14.2,7644,1,28.4,0,1987,2001,20379
2005,18140,28095,36772,781405,778557,4043,11.1,3334,9.1,116384,42971,73413,5.5,14.9,110688,39052,71636,5,14.2,5696,0.7,28.4,0,2140,2149,17576
2006,18140,28117,37100,782924,778945,4187,11.4,3466,9.4,122335,48462,73873,6.2,15.7,114377,45683,68694,5.9,14.7,7958,1,29.4,0,2179,2213,20929
2007,18140,28102,37310,794427,788066,4262,11.5,3959,10.7,123788,50831,72957,6.5,15.7,111067,37612,73455,4.8,14.1,12721,1.6,28.2,0,2258,2290,15343
2008,18140,27752,36800,794261,791341,3554,9.6,3555,9.6,115727,42045,73682,5.3,14.6,109888,31495,78393,4,13.9,5839,0.7,27.8,0,2365,2368,17164
2009,18140,27018,36340,763519,776613,3519,9.7,3604,9.9,99237,39797,59440,5.1,12.8,125425,41039,84386,5.3,16.2,-26188,-3.4,25.6,0,2339,2425,15283
2010,18140,26467,35740,747417,752257,2966,8.3,3240,9,86194,29739,56455,4,11.5,95874,27065,68809,3.6,12.7,-9680,-1.2,23,0,1960,1961,13270
2011,18140,26440,35356,757713,750273,3270,9.2,3353,9.5,100475,29385,71090,3.9,13.4,85595,25179,60416,3.4,11.4,14880,2,22.8,0,1860,1860,13225
2012,18140,26769,35822,798252,774800,3530,9.9,3024,8.5,131135,36423,94712,4.7,16.9,84231,29230,55001,3.8,10.9,46904,6,21.8,0,1697,1710,14886
2013,18140,27096,36185,802071,798544,3294,9.2,2810,7.8,104900,34938,69962,4.4,13.1,97845,28267,69578,3.5,12.3,7055,0.8,24.6,0,1711,1724,15903
2014,18140,27129,36344,827152,812732,3263,9,2765,7.7,117890,39113,78777,4.8,14.5,89049,26836,62213,3.3,11,28841,3.5,22,0,1790,1798,15505
1977,18580,5721,6471,80970,79487,1181,18.7,872,13.8,17093,8509,8584,10.7,21.5,14126,5357,8769,6.7,17.8,2967,3.7,35.6,0,607,609,3311
1978,18580,5477,6234,86057,83281,906,14.3,1047,16.5,19052,6256,12796,7.5,22.9,13499,7019,6480,8.4,16.2,5553,6.7,32.4,0,571,572,3834
1979,18580,6121,6922,97964,92169,1099,16.7,479,7.3,22191,7548,14643,8.2,24.1,10601,3283,7318,3.6,11.5,11590,12.6,23,1,4,5,
1980,18580,4681,5512,96164,94878,271,4.4,979,15.8,18867,3478,15389,3.7,19.9,16294,6550,9744,6.9,17.2,2573,2.7,34.4,0,744,745,4609
1981,18580,6202,7086,105039,102753,1292,20.6,667,10.6,21379,11185,10194,10.9,20.8,16807,7621,9186,7.4,16.4,4572,4.4,32.8,0,357,358,2419
1982,18580,6684,7738,114233,109621,1403,18.9,724,9.8,27873,15855,12018,14.5,25.4,18649,5801,12848,5.3,17,9224,8.4,34,0,438,438,2838
1983,18580,6849,7923,104206,108303,1079,13.8,929,11.9,20647,10174,10473,9.4,19.1,28841,7985,20856,7.4,26.6,-8194,-7.5,38.2,0,624,626,4673
1984,18580,6932,8035,106580,105371,1167,14.6,1048,13.1,22529,9487,13042,9,21.4,20111,7658,12453,7.3,19.1,2418,2.3,38.2,0,699,707,4698
1985,18580,6966,8073,106610,106907,1077,13.4,1025,12.7,19735,8725,11010,8.2,18.5,20329,8194,12135,7.7,19,-594,-0.5,37,0,701,706,4468
1986,18580,6929,8013,106185,106319,1047,13,1074,13.4,20952,9101,11851,8.6,19.7,21219,7794,13425,7.3,20,-267,-0.3,39.4,0,700,710,3858
1987,18580,6746,7879,101067,104035,1101,13.8,1175,14.8,19022,8293,10729,8,18.3,24958,9847,15111,9.5,24,-5936,-5.7,36.6,0,785,789,4264
1988,18580,6523,7638,98763,98969,933,12,1093,14.1,19483,8192,11291,8.3,19.7,19894,6974,12920,7,20.1,-411,-0.4,39.4,0,748,748,3825
1989,18580,6435,7581,99970,99782,892,11.7,981,12.9,19204,8281,10923,8.3,19.2,18828,8628,10200,8.6,18.9,376,0.3,37.8,0,634,636,4387
1990,18580,6523,7671,106331,103050,928,12.2,798,10.5,22340,8937,13403,8.7,21.7,15778,6654,9124,6.5,15.3,6562,6.4,30.6,0,538,540,3595
1991,18580,6655,7836,105240,105807,991,12.8,832,10.7,21799,9060,12739,8.6,20.6,22933,11120,11813,10.5,21.7,-1134,-1.1,41.2,0,515,517,7344
1992,18580,6737,7985,105799,105246,1049,13.3,868,11,19193,7557,11636,7.2,18.2,18086,5407,12679,5.1,17.2,1107,1,34.4,0,579,591,3290
1993,18580,6825,8025,110681,108158,890,11.1,825,10.3,20559,7083,13476,6.5,19,15512,5987,9525,5.5,14.3,5047,4.7,28.6,0,536,537,3167
1994,18580,6995,8218,114072,112438,967,11.9,760,9.4,19561,7694,11867,6.8,17.4,16292,4876,11416,4.3,14.5,3269,2.9,29,0,508,508,2838
1995,18580,7116,8371,118750,115838,1011,12.2,803,9.7,21792,8951,12841,7.7,18.8,15967,5808,10159,5,13.8,5825,5,27.6,0,536,540,3018
1996,18580,7186,8411,119076,118881,986,11.8,924,11,20676,8055,12621,6.8,17.4,20286,9306,10980,7.8,17.1,390,0.3,34.2,0,596,596,5320
1997,18580,7239,8504,125116,122243,1062,12.5,958,11.3,28117,13045,15072,10.7,23,22371,9510,12861,7.8,18.3,5746,4.7,36.6,0,608,608,3851
1998,18580,7292,8549,130590,127781,972,11.4,917,10.8,24039,7760,16279,6.1,18.8,18421,6388,12033,5,14.4,5618,4.4,28.8,0,588,588,3040
1999,18580,7218,8548,130377,130538,952,11.1,937,11,21857,9020,12837,6.9,16.7,22179,9131,13048,7,17,-322,-0.3,33.4,0,602,602,3575
2000,18580,7121,8457,133039,132711,831,9.8,926,10.9,18996,6858,12138,5.2,14.3,18341,6542,11799,4.9,13.8,655,0.5,27.6,0,550,550,2996
2001,18580,7141,8507,135787,134064,904,10.6,934,11,25287,13147,12140,9.8,18.9,21842,7928,13914,5.9,16.3,3445,2.6,32.6,0,549,549,3350
2002,18580,7177,8482,132070,132759,1043,12.3,1076,12.7,22267,8887,13380,6.7,16.8,23645,9398,14247,7.1,17.8,-1378,-1,33.6,0,563,565,3577
2003,18580,7226,8506,134285,132441,940,11.1,770,9.1,23262,6576,16686,5,17.6,19574,6727,12847,5.1,14.8,3688,2.8,29.6,0,518,518,3379
2004,18580,7258,8585,135640,134743,963,11.3,821,9.6,19330,7195,12135,5.3,14.3,17535,5662,11873,4.2,13,1795,1.3,26,0,560,560,3434
2005,18580,7352,8716,140798,137865,970,11.2,748,8.7,23838,9382,14456,6.8,17.3,17971,6048,11923,4.4,13,5867,4.3,26,0,540,543,3533
2006,18580,7383,8829,151028,145377,998,11.4,809,9.2,29538,11211,18327,7.7,20.3,18235,7159,11076,4.9,12.5,11303,7.8,25,0,578,578,5137
2007,18580,7377,8865,146864,148652,931,10.5,868,9.8,24515,7420,17095,5,16.5,28091,7703,20388,5.2,18.9,-3576,-2.4,33,0,600,602,4212
2008,18580,7323,8839,149416,147645,821,9.3,751,8.5,22263,6086,16177,4.1,15.1,18721,5403,13318,3.7,12.7,3542,2.4,25.4,0,568,568,3705
2009,18580,7124,8675,144208,146597,715,8.2,832,9.5,17927,6412,11515,4.4,12.2,22705,6429,16276,4.4,15.5,-4778,-3.3,24.4,0,592,592,3293
2010,18580,7013,8612,145240,144510,689,8,697,8.1,19693,7202,12491,5,13.6,18232,4909,13323,3.4,12.6,1461,1,25.2,0,477,477,2639
2011,18580,6929,8557,148236,146544,705,8.2,726,8.5,19993,5503,14490,3.8,13.6,16609,4218,12391,2.9,11.3,3384,2.3,22.6,0,508,518,2823
2012,18580,6989,8600,153523,150606,776,9.1,725,8.5,24722,7385,17337,4.9,16.4,18888,6449,12439,4.3,12.5,5834,3.9,25,0,441,443,2739
2013,18580,7033,8677,160503,156896,712,8.3,630,7.3,24673,8099,16574,5.2,15.7,17458,5778,11680,3.7,11.1,7215,4.6,22.2,0,402,403,3626
2014,18580,7089,8742,162504,160243,796,9.2,658,7.6,24442,6783,17659,4.2,15.3,19919,5081,14838,3.2,12.4,4523,2.9,24.8,0,425,426,2257
1977,18700,1172,1234,12294,11789,258,21.8,153,12.9,3003,1833,1170,15.5,25.5,1993,913,1080,7.7,16.9,1010,8.6,33.8,0,106,106,548
1978,18700,1258,1324,15853,14076,261,20.4,170,13.3,5145,1768,3377,12.6,36.6,1591,836,755,5.9,11.3,3554,25.3,22.6,0,116,117,521
1979,18700,1314,1384,16370,16098,271,20,199,14.7,3712,1821,1891,11.3,23.1,3168,1278,1890,7.9,19.7,544,3.4,39.4,0,142,142,943
1980,18700,1326,1394,15806,16092,213,15.3,197,14.2,2551,1135,1416,7.1,15.9,3122,1207,1915,7.5,19.4,-571,-3.5,31.8,0,141,141,753
1981,18700,1284,1342,15824,15642,160,11.7,187,13.7,2968,892,2076,5.7,19,2604,1193,1411,7.6,16.6,364,2.4,33.2,0,108,108,628
1982,18700,1287,1343,16565,16151,229,17.1,198,14.7,4060,1563,2497,9.7,25.1,3231,1122,2109,6.9,20,829,5.1,40,0,107,107,531
1983,18700,1330,1389,15776,16138,179,13.1,159,11.6,2202,988,1214,6.1,13.6,2926,974,1952,6,18.1,-724,-4.5,27.2,0,116,116,675
1984,18700,1356,1415,16364,16065,191,13.6,165,11.8,2874,784,2090,4.9,17.9,2275,831,1444,5.2,14.2,599,3.7,28.4,0,103,103,543
1985,18700,1379,1433,16822,16732,200,14,189,13.3,5428,3795,1633,22.7,32.4,5248,3293,1955,19.7,31.4,180,1,62.8,0,119,119,722
1986,18700,1407,1463,17021,16712,209,14.4,168,11.6,3018,1355,1663,8.1,18.1,2399,743,1656,4.4,14.4,619,3.7,28.8,0,119,119,576
1987,18700,1422,1486,17733,17380,223,15.1,187,12.7,3054,1123,1931,6.5,17.6,2347,1038,1309,6,13.5,707,4.1,27,0,124,124,503
1988,18700,1419,1492,18251,17901,213,14.3,197,13.3,3148,1082,2066,6,17.6,2447,1167,1280,6.5,13.7,701,3.9,27.4,0,141,141,593
1989,18700,1296,1377,18651,18433,162,11.3,274,19.1,4207,1495,2712,8.1,22.8,3770,2521,1249,13.7,20.5,437,2.3,41,0,125,125,1153
1990,18700,1435,1519,19863,19230,275,19,121,8.4,3290,1614,1676,8.4,17.1,2024,669,1355,3.5,10.5,1266,6.6,21,0,88,88,503
1991,18700,1454,1546,19640,19751,200,13,169,11,5454,3776,1678,19.1,27.6,5675,3730,1945,18.9,28.7,-221,-1.1,55.2,0,113,113,599
1992,18700,1500,1598,21731,20670,212,13.5,153,9.7,4691,1384,3307,6.7,22.7,2569,879,1690,4.3,12.4,2122,10.3,24.8,0,101,101,516
1993,18700,1520,1616,22023,21900,184,11.5,161,10,2891,819,2072,3.7,13.2,2645,681,1964,3.1,12.1,246,1.1,24.2,0,101,101,453
1994,18700,1629,1733,23592,22793,270,16.1,146,8.7,4196,1658,2538,7.3,18.4,2598,845,1753,3.7,11.4,1598,7,22.8,0,96,96,430
1995,18700,1670,1777,26156,24922,242,13.8,199,11.3,4960,1187,3773,4.8,19.9,2491,1410,1081,5.7,10,2469,9.9,20,0,138,138,627
1996,18700,1693,1799,26575,26358,211,11.8,182,10.2,3763,1428,2335,5.4,14.3,3329,999,2330,3.8,12.6,434,1.7,25.2,0,133,133,495
1997,18700,1658,1758,26916,26717,196,11,229,12.9,4061,1679,2382,6.3,15.2,3663,1491,2172,5.6,13.7,398,1.5,27.4,0,143,143,759
1998,18700,1653,1749,28042,27466,183,10.4,192,10.9,4406,1402,3004,5.1,16,3253,1278,1975,4.7,11.8,1153,4.2,23.6,0,121,121,728
1999,18700,1666,1768,27255,27660,181,10.3,159,9,2893,1061,1832,3.8,10.5,3702,985,2717,3.6,13.4,-809,-2.9,21,0,104,104,530
2000,18700,1637,1743,26558,26924,162,9.2,187,10.7,3374,1122,2252,4.2,12.5,4105,1309,2796,4.9,15.2,-731,-2.7,25,0,113,113,802
2001,18700,1659,1777,26927,26779,187,10.6,176,10,3705,1146,2559,4.3,13.8,3408,922,2486,3.4,12.7,297,1.1,25.4,0,89,89,496
2002,18700,1641,1768,26770,26804,203,11.5,211,11.9,3828,1369,2459,5.1,14.3,3896,936,2960,3.5,14.5,-68,-0.2,28.6,0,109,109,431
2003,18700,1649,1784,27896,27251,175,9.9,130,7.3,3886,1225,2661,4.5,14.3,2596,897,1699,3.3,9.5,1290,4.8,19,0,75,75,353
2004,18700,1658,1785,27974,27648,174,9.8,153,8.6,3962,1097,2865,4,14.3,3310,983,2327,3.6,12,652,2.3,24,0,108,108,618
2005,18700,1708,1837,27232,27695,201,11.1,136,7.5,2833,949,1884,3.4,10.2,3759,943,2816,3.4,13.6,-926,-3.4,20.4,0,94,94,329
2006,18700,1711,1850,26421,26814,186,10.1,171,9.3,3174,1053,2121,3.9,11.8,3960,1862,2098,6.9,14.8,-786,-3,23.6,0,110,110,1493
2007,18700,1730,1870,26012,26173,189,10.2,157,8.4,3349,1232,2117,4.7,12.8,3671,665,3006,2.5,14,-322,-1.2,25.6,0,102,102,433
2008,18700,1755,1895,26241,26084,191,10.2,148,7.9,3432,1112,2320,4.3,13.2,3118,1016,2102,3.9,12,314,1.2,24,0,95,95,374
2009,18700,1717,1859,24899,25537,150,8,174,9.3,2542,941,1601,3.7,10,3817,686,3131,2.7,14.9,-1275,-4.9,20,0,122,122,518
2010,18700,1708,1848,24272,24539,164,8.9,167,9,2614,864,1750,3.5,10.7,3147,780,2367,3.2,12.8,-533,-2.1,21.4,0,106,106,559
2011,18700,1692,1831,24945,24551,135,7.4,149,8.1,2676,664,2012,2.7,10.9,1888,627,1261,2.6,7.7,788,3.2,15.4,0,110,110,490
2012,18700,1714,1863,24887,24891,183,9.9,145,7.9,2945,1130,1815,4.5,11.8,2953,658,2295,2.6,11.9,-8,-0.1,23.6,0,81,81,396
2013,18700,1717,1875,25244,25031,160,8.6,151,8.1,2337,733,1604,2.9,9.3,1910,557,1353,2.2,7.6,427,1.7,15.2,0,96,96,336
2014,18700,1743,1892,24438,24765,171,9.1,143,7.6,2887,954,1933,3.9,11.7,3541,1301,2240,5.3,14.3,-654,-2.6,23.4,0,94,94,527
1977,18880,1724,1848,16342,16146,387,21.4,302,16.7,4306,2492,1814,15.4,26.7,3914,1820,2094,11.3,24.2,392,2.5,48.4,0,228,228,1418
1978,18880,1807,1939,18299,17316,367,19.4,270,14.3,4679,1888,2791,10.9,27,2712,1239,1473,7.2,15.7,1967,11.3,31.4,0,198,198,753
1979,18880,1853,2023,20470,19364,389,19.6,289,14.6,5469,2878,2591,14.9,28.2,3257,1367,1890,7.1,16.8,2212,11.4,33.6,0,216,216,914
1980,18880,1940,2110,22202,21268,366,17.7,271,13.1,5437,2259,3178,10.6,25.6,3568,1200,2368,5.6,16.8,1869,8.8,33.6,0,206,206,813
1981,18880,1933,2099,23757,22875,334,15.9,315,15,5492,2296,3196,10,24,3727,1866,1861,8.2,16.3,1765,7.7,32.6,0,201,201,894
1982,18880,2074,2273,24974,24200,453,20.7,261,11.9,6086,2700,3386,11.2,25.1,4537,1690,2847,7,18.7,1549,6.4,37.4,0,160,160,898
1983,18880,2212,2429,26527,25765,435,18.5,299,12.7,6093,2783,3310,10.8,23.6,4568,1720,2848,6.7,17.7,1525,5.9,35.4,0,191,191,961
1984,18880,2481,2710,29107,27773,581,22.6,301,11.7,8044,3721,4323,13.4,29,5375,2226,3149,8,19.4,2669,9.6,38.8,0,198,198,835
1985,18880,2628,2866,32540,31277,547,19.6,388,13.9,7706,3533,4173,11.3,24.6,5180,2211,2969,7.1,16.6,2526,8,33.2,0,266,268,1294
1986,18880,2746,2998,35305,33904,573,19.6,423,14.4,9070,4519,4551,13.3,26.8,6268,2333,3935,6.9,18.5,2802,8.3,37,0,291,294,1524
1987,18880,2808,3083,37294,36928,559,18.3,468,15.4,7826,3766,4060,10.2,21.2,7093,2810,4283,7.6,19.2,733,2,38.4,0,320,321,1569
1988,18880,2816,3146,38754,37816,483,15.5,422,13.6,8094,4077,4017,10.8,21.4,6217,2370,3847,6.3,16.4,1877,5,32.8,0,320,320,1539
1989,18880,2861,3233,40836,39835,510,16,410,12.9,8547,3740,4807,9.4,21.5,6545,2399,4146,6,16.4,2002,5.1,32.8,0,291,291,1556
1990,18880,2919,3304,42755,41737,446,13.7,342,10.5,8353,3314,5039,7.9,20,6316,1872,4444,4.5,15.1,2037,4.9,30.2,0,245,245,1254
1991,18880,2962,3373,41714,42229,466,14,398,11.9,7399,3378,4021,8,17.5,8428,2545,5883,6,20,-1029,-2.5,35,0,258,259,1753
1992,18880,3020,3454,43139,42397,490,14.3,406,11.9,9188,3667,5521,8.6,21.7,7704,3363,4341,7.9,18.2,1484,3.5,36.4,0,262,269,2289
1993,18880,3188,3635,45764,44418,518,14.6,331,9.3,9362,4238,5124,9.5,21.1,6670,2170,4500,4.9,15,2692,6.1,30,0,240,244,1619
1994,18880,3272,3729,49244,47448,475,12.9,376,10.2,9671,2890,6781,6.1,20.4,6079,2262,3817,4.8,12.8,3592,7.6,25.6,0,273,273,1226
1995,18880,3425,3933,51540,50306,604,15.8,381,9.9,10048,4374,5674,8.7,20,7579,2287,5292,4.5,15.1,2469,4.9,30.2,0,275,275,1195
1996,18880,3501,4019,53287,53112,540,13.6,455,11.4,10120,3790,6330,7.1,19.1,9769,3253,6516,6.1,18.4,351,0.7,36.8,0,321,321,1893
1997,18880,3572,4139,54846,54042,602,14.7,479,11.7,11018,4087,6931,7.6,20.4,9409,3217,6192,6,17.4,1609,3,34.8,0,306,306,1565
1998,18880,3602,4180,55752,55264,556,13.4,500,12,10413,3858,6555,7,18.8,9437,3767,5670,6.8,17.1,976,1.7,34.2,0,330,330,2208
1999,18880,3612,4216,54812,55256,558,13.3,511,12.2,10410,4408,6002,8,18.8,11298,6368,4930,11.5,20.4,-888,-1.6,37.6,0,343,343,4622
2000,18880,3570,4180,57993,57451,507,12.1,545,13,10543,4500,6043,7.8,18.4,9460,4343,5117,7.6,16.5,1083,1.9,33,0,341,341,1836
2001,18880,3566,4215,63119,60589,501,11.9,489,11.6,12783,3977,8806,6.6,21.1,7723,2826,4897,4.7,12.7,5060,8.4,25.4,0,295,295,1341
2002,18880,3573,4197,58650,59319,561,13.3,575,13.7,11089,4787,6302,8.1,18.7,12426,6339,6087,10.7,20.9,-1337,-2.2,37.4,0,294,295,1840
2003,18880,3715,4338,64362,61221,591,13.9,373,8.8,14414,4249,10165,6.9,23.5,8131,3517,4614,5.7,13.3,6283,10.2,26.6,0,272,272,1297
2004,18880,3919,4588,70213,67198,755,17,476,10.7,15412,7184,8228,10.7,22.9,9382,4957,4425,7.4,14,6030,8.9,28,0,317,317,3006
2005,18880,4129,4835,71245,70588,727,15.5,445,9.5,10640,4211,6429,6,15.1,9326,3205,6121,4.5,13.2,1314,1.9,26.4,0,313,313,2145
2006,18880,4144,4875,84668,77811,642,13.3,545,11.3,24333,9671,14662,12.4,31.3,10618,4734,5884,6.1,13.6,13715,17.7,27.2,0,378,378,3717
2007,18880,4150,4895,78896,81717,583,11.9,555,11.4,11541,5856,5685,7.2,14.1,17182,4018,13164,4.9,21,-5641,-6.9,28.2,0,359,361,1950
2008,18880,4010,4728,74282,76279,489,10.2,584,12.2,8030,2839,5191,3.7,10.5,12023,3015,9008,4,15.8,-3993,-5.3,21,0,420,420,1843
2009,18880,3801,4510,67899,70870,430,9.3,586,12.7,7018,2787,4231,3.9,9.9,12960,4413,8547,6.2,18.3,-5942,-8.4,19.8,0,372,377,1842
2010,18880,3762,4489,69323,68423,478,10.7,480,10.7,11987,3304,8683,4.8,17.5,10186,1791,8395,2.6,14.9,1801,2.6,29.8,0,341,341,1201
2011,18880,3800,4535,65017,67042,506,11.2,431,9.6,9280,3516,5764,5.2,13.8,13330,6466,6864,9.6,19.9,-4050,-6.1,27.6,0,272,272,5320
2012,18880,3776,4526,65911,65632,455,10.1,462,10.2,10130,2983,7147,4.5,15.4,9572,3494,6078,5.3,14.6,558,0.8,29.2,0,271,271,1653
2013,18880,3802,4577,67230,66518,492,10.8,450,9.9,11186,3261,7925,4.9,16.8,9762,2771,6991,4.2,14.7,1424,2.1,29.4,0,295,295,1831
2014,18880,3807,4602,67394,66933,462,10.1,397,8.7,8388,3349,5039,5,12.5,7466,1923,5543,2.9,11.2,922,1.3,22.4,0,262,262,1045
1977,19060,1695,1864,24576,25076,257,13.9,218,11.8,3602,1819,1783,7.3,14.4,4602,1602,3000,6.4,18.4,-1000,-4,28.8,0,140,142,725
1978,19060,1730,1904,24335,24457,218,11.6,179,9.5,3421,962,2459,3.9,14,3664,2137,1527,8.7,15,-243,-1,28,0,130,130,1880
1979,19060,1745,1907,25886,25095,206,10.8,194,10.2,4160,1662,2498,6.6,16.6,2578,1248,1330,5,10.3,1582,6.3,20.6,0,128,128,542
1980,19060,1727,1898,25942,25915,168,8.8,172,9,3337,1081,2256,4.2,12.9,3282,1564,1718,6,12.7,55,0.2,25.4,0,107,108,538
1981,19060,1684,1862,25224,25391,210,11.2,229,12.2,3583,2250,1333,8.9,14.1,3917,1317,2600,5.2,15.4,-334,-1.3,28.2,0,135,137,538
1982,19060,1678,1869,24091,24587,230,12.3,187,10,3311,1923,1388,7.8,13.5,4302,1488,2814,6.1,17.5,-991,-4,27,0,108,108,664
1983,19060,1760,1949,25192,25292,189,9.9,149,7.8,2862,1350,1512,5.3,11.3,3062,590,2472,2.3,12.1,-200,-0.8,22.6,0,88,88,334
1984,19060,1734,1921,24541,24830,201,10.4,224,11.6,3729,1284,2445,5.2,15,4307,1545,2762,6.2,17.3,-578,-2.3,30,0,130,130,616
1985,19060,1807,1994,25647,25114,208,10.6,149,7.6,4296,1218,3078,4.8,17.1,3230,1021,2209,4.1,12.9,1066,4.2,25.8,0,46,46,300
1986,19060,1843,2031,25490,25564,235,11.7,194,9.6,3419,1457,1962,5.7,13.4,3567,1144,2423,4.5,14,-148,-0.6,26.8,0,119,121,566
1987,19060,1883,2088,27660,26709,260,12.6,196,9.5,4632,2008,2624,7.5,17.3,2730,1011,1719,3.8,10.2,1902,7.1,20.4,0,139,140,655
1988,19060,1859,2065,27536,27558,201,9.7,217,10.5,4436,1574,2862,5.7,16.1,4479,2259,2220,8.2,16.3,-43,-0.2,32.2,0,150,150,571
1989,19060,1891,2102,29374,28462,202,9.7,164,7.9,4787,1578,3209,5.5,16.8,2962,1035,1927,3.6,10.4,1825,6.4,20.8,0,100,100,373
1990,19060,1909,2132,29379,29360,198,9.4,160,7.6,3955,1071,2884,3.6,13.5,3916,913,3003,3.1,13.3,39,0.2,26.6,0,111,111,510
1991,19060,1906,2140,28773,29078,188,8.8,184,8.6,3699,2024,1675,7,12.7,4309,1676,2633,5.8,14.8,-610,-2.1,25.4,0,116,119,856
1992,19060,1932,2169,28124,28435,223,10.3,181,8.4,3316,1351,1965,4.8,11.7,3937,1199,2738,4.2,13.8,-621,-2.1,23.4,0,113,113,575
1993,19060,1932,2175,28181,28143,177,8.1,164,7.6,3392,938,2454,3.3,12.1,3316,1088,2228,3.9,11.8,76,0.3,23.6,0,102,102,617
1994,19060,1930,2167,28280,28216,177,8.2,180,8.3,3319,1170,2149,4.1,11.8,3190,862,2328,3.1,11.3,129,0.5,22.6,0,117,118,522
1995,19060,1929,2155,28906,28574,168,7.8,169,7.8,3400,949,2451,3.3,11.9,2736,1014,1722,3.5,9.6,664,2.3,19.2,0,107,107,580
1996,19060,1941,2172,28566,28740,195,9,175,8.1,3152,1172,1980,4.1,11,3500,1209,2291,4.2,12.2,-348,-1.2,22,0,112,112,661
1997,19060,1914,2146,30051,29279,170,7.9,186,8.6,4261,1298,2963,4.4,14.6,2717,848,1869,2.9,9.3,1544,5.3,18.6,0,124,124,536
1998,19060,1913,2135,29583,29812,169,7.9,175,8.2,3369,1383,1986,4.6,11.3,3826,1377,2449,4.6,12.8,-457,-1.5,22.6,0,98,98,529
1999,19060,1909,2132,29929,29726,176,8.2,183,8.6,3912,1436,2476,4.8,13.2,3505,1015,2490,3.4,11.8,407,1.4,23.6,0,114,114,534
2000,19060,1887,2130,30849,30457,185,8.7,193,9.1,3945,1131,2814,3.7,13,3160,1221,1939,4,10.4,785,2.6,20.8,0,109,109,493
2001,19060,1871,2117,31648,31266,192,9,216,10.2,4192,1871,2321,6,13.4,3427,1070,2357,3.4,11,765,2.4,22,0,132,132,499
2002,19060,1873,2109,31301,31463,207,9.8,211,10,4288,1939,2349,6.2,13.6,4612,1489,3123,4.7,14.7,-324,-1.1,27.2,0,109,109,793
2003,19060,1862,2095,32745,31746,184,8.8,161,7.7,5228,2285,2943,7.2,16.5,3230,1127,2103,3.6,10.2,1998,6.3,20.4,0,108,108,801
2004,19060,1870,2104,33042,32976,179,8.6,142,6.8,3651,1406,2245,4.3,11.1,3519,1286,2233,3.9,10.7,132,0.4,21.4,0,106,106,471
2005,19060,1838,2077,32699,32809,173,8.3,185,8.9,3609,1089,2520,3.3,11,3829,1273,2556,3.9,11.7,-220,-0.7,22,0,133,133,768
2006,19060,1831,2069,33139,32786,174,8.4,172,8.3,5516,2628,2888,8,16.8,4810,2292,2518,7,14.7,706,2.1,29.4,0,115,116,620
2007,19060,1842,2075,33094,33118,196,9.5,186,9,4502,1493,3009,4.5,13.6,4550,1355,3195,4.1,13.7,-48,-0.1,27.2,0,115,115,622
2008,19060,1813,2044,31578,32263,145,7.1,170,8.3,3486,655,2831,2,10.8,4856,1591,3265,4.9,15.1,-1370,-4.3,21.6,0,116,116,799
2009,19060,1787,2017,30754,31070,138,6.8,157,7.7,3098,857,2241,2.8,10,3730,1336,2394,4.3,12,-632,-2,20,0,111,111,444
2010,19060,1758,1988,30562,29952,126,6.3,141,7.1,3877,821,3056,2.7,12.9,2656,749,1907,2.5,8.9,1221,4,17.8,0,99,99,525
2011,19060,1717,1942,30924,30708,115,5.9,151,7.7,3151,701,2450,2.3,10.3,2718,620,2098,2,8.9,433,1.4,17.8,0,104,104,443
2012,19060,1701,1926,31510,31221,121,6.3,139,7.2,4010,1493,2517,4.8,12.8,3432,945,2487,3,11,578,1.8,22,0,84,84,549
2013,19060,1687,1919,31330,31313,132,6.9,142,7.4,3301,1432,1869,4.6,10.5,3267,1145,2122,3.7,10.4,34,0.1,20.8,0,81,81,438
2014,19060,1656,1884,30541,30869,110,5.8,128,6.8,2544,545,1999,1.8,8.2,3200,517,2683,1.7,10.4,-656,-2.2,16.4,0,94,94,372
1977,19100,48951,59895,1077251,1026449,11579,19.9,8098,13.9,270081,115321,154760,11.2,26.3,168477,71875,96602,7,16.4,101604,9.9,32.8,0,5415,5470,39384
1978,19100,46861,58063,1121288,1097409,9634,16.3,10792,18.3,246277,84409,161868,7.7,22.4,198519,93702,104817,8.5,18.1,47758,4.3,36.2,0,5969,6007,40143
1979,19100,53100,64990,1249621,1186630,11532,18.7,5054,8.2,287982,105736,182246,8.9,24.3,161999,55863,106136,4.7,13.7,125983,10.6,27.4,0,99,107,4272
1980,19100,55328,67726,1315404,1281438,11580,17.5,8443,12.7,280480,95276,185204,7.4,21.9,212548,75961,136587,5.9,16.6,67932,5.3,33.2,0,5742,5774,40480
1981,19100,55852,68472,1341112,1320675,11663,17.1,10402,15.3,285557,128032,157525,9.7,21.6,244683,100608,144075,7.6,18.5,40874,3.1,37,0,6135,6142,42844
1982,19100,58718,73239,1411001,1374574,14044,19.8,8775,12.4,318246,146679,171567,10.7,23.2,245393,83500,161893,6.1,17.9,72853,5.3,35.8,0,4741,4745,32326
1983,19100,61596,76581,1441779,1419508,12266,16.4,9409,12.6,315867,131482,184385,9.3,22.3,271326,92771,178555,6.5,19.1,44541,3.2,38.2,0,6149,6167,41638
1984,19100,65921,81327,1592956,1519960,14258,18.1,9507,12,382112,163439,218673,10.8,25.1,236120,88763,147357,5.8,15.5,145992,9.6,31,0,5967,5987,40979
1985,19100,69301,85314,1670987,1627466,14641,17.6,10576,12.7,362989,142870,220119,8.8,22.3,275947,108332,167615,6.7,17,87042,5.3,34,0,6776,6807,51734
1986,19100,71447,88301,1704410,1686010,15023,17.3,11668,13.4,353971,155695,198276,9.2,21,317170,119780,197390,7.1,18.8,36801,2.2,37.6,0,7839,7889,62432
1987,19100,71465,89268,1651526,1677686,15228,17.1,13801,15.5,327470,150811,176659,9,19.5,379789,146574,233215,8.7,22.6,-52319,-3.1,39,0,8799,8880,67182
1988,19100,69511,88260,1674774,1660425,13509,15.2,14003,15.8,353026,156390,196636,9.4,21.3,324329,136907,187422,8.2,19.5,28697,1.8,39,0,9490,9490,60959
1989,19100,68981,87993,1713266,1695536,12457,14.1,12828,14.6,349940,133837,216103,7.9,20.6,314479,133184,181295,7.9,18.5,35461,2.1,37,0,8299,8393,70725.5
1990,19100,70289,89701,1780956,1746041,13218,14.9,10981,12.4,364705,133407,231298,7.6,20.9,294874,122170,172704,7,16.9,69831,4,33.8,0,7050,7113,58025
1991,19100,72544,92765,1796046,1785115,14046,15.4,10960,12,360021,146832,213189,8.2,20.2,338159,137374,200785,7.7,18.9,21862,1.3,37.8,0,6567,6730,77734
1992,19100,73890,94532,1792625,1793530,14362,15.3,12193,13,350979,148530,202449,8.3,19.6,352789,133659,219130,7.5,19.7,-1810,-0.1,39.2,0,7472,7650,65815
1993,19100,76416,96545,1851385,1821147,13391,14,11118,11.6,378000,135026,242974,7.4,20.8,317523,121474,196049,6.7,17.4,60477,3.4,34.8,0,6882,6967,57406
1994,19100,78527,99022,1900297,1873552,14126,14.4,11349,11.6,364267,143542,220725,7.7,19.4,310777,113561,197216,6.1,16.6,53490,2.8,33.2,0,7414,7477,55110
1995,19100,80735,101739,2003831,1951765,14516,14.5,11363,11.3,391496,145094,246402,7.4,20.1,287363,102407,184956,5.2,14.7,104133,5.4,29.4,0,7382,7480,53015
1996,19100,82975,104377,2121366,2066358,14798,14.4,11932,11.6,426703,169776,256927,8.2,20.7,316686,120771,195915,5.8,15.3,110017,5.4,30.6,0,7670,7671,56182
1997,19100,84787,107064,2228273,2176832,16081,15.2,13351,12.6,491780,190415,301365,8.7,22.6,388900,154826,234074,7.1,17.9,102880,4.7,35.8,0,8056,8056,69857
1998,19100,85557,108510,2312255,2273541,14872,13.8,13153,12.2,455650,177205,278445,7.8,20,378223,141794,236429,6.2,16.6,77427,3.4,33.2,0,8088,8089,72296
1999,19100,85921,110136,2415816,2371303,14855,13.6,13131,12,497164,199806,297358,8.4,21,408138,169906,238232,7.2,17.2,89026,3.8,34.4,0,8162,8162,70385
2000,19100,86337,111305,2511555,2459401,14904,13.5,13784,12.5,510439,198459,311980,8.1,20.8,406132,170002,236130,6.9,16.5,104307,4.3,33,0,7990,7990,64728
2001,19100,87373,114064,2566558,2543455,15577,13.8,13663,12.1,505522,208822,296700,8.2,19.9,459315,174380,284935,6.9,18.1,46207,1.8,36.2,0,7872,7879,60906
2002,19100,88135,115297,2502805,2531153,16637,14.5,15259,13.3,481911,227625,254286,9,19,538606,194717,343889,7.7,21.3,-56695,-2.3,38,0,7888,7919,65488
2003,19100,88963,116232,2438798,2447656,15751,13.7,12338,10.7,434750,178507,256243,7.3,17.8,452466,163656,288810,6.7,18.5,-17716,-0.7,35.6,0,8289,8328,72951
2004,19100,90228,117940,2446603,2429407,15876,13.6,12644,10.8,453523,191140,262383,7.9,18.7,419130,163747,255383,6.7,17.3,34393,1.4,34.6,0,8223,8252,75642
2005,19100,92000,120502,2521804,2476060,16253,13.7,12335,10.4,461015,200759,260256,8.1,18.6,369526,133483,236043,5.4,14.9,91489,3.7,29.8,0,8389,8419,78366
2006,19100,93165,123009,2598931,2548217,16686,13.7,12880,10.6,472325,178311,294014,7,18.5,370899,136669,234230,5.4,14.6,101426,3.9,29.2,0,8558,8579,74060
2007,19100,95131,126103,2671843,2627411,17199,13.8,13443,10.8,509667,200729,308938,7.6,19.4,420803,151132,269671,5.8,16,88864,3.4,32,0,8224,8303,65766
2008,19100,96038,127302,2692422,2667205,15346,12.2,12599,10,457210,171210,286000,6.4,17.1,406775,125192,281583,4.7,15.3,50435,1.8,30.6,0,8690,8715,71838
2009,19100,95204,126191,2575264,2624977,13899,11,13721,10.9,363008,150937,212071,5.8,13.8,462433,130288,332145,5,17.6,-99425,-3.8,27.6,0,8970,9032,67515
2010,19100,95003,125990,2533597,2548221,13554,10.8,12664,10.1,374085,155041,219044,6.1,14.7,403335,117699,285636,4.6,15.8,-29250,-1.1,29.4,0,8393,8407,68133
2011,19100,95011,126603,2594275,2556617,14094,11.2,12447,9.9,410458,150211,260247,5.9,16.1,335143,104207,230936,4.1,13.1,75315,3,26.2,0,8385,8411,61078
2012,19100,97496,129611,2717975,2666231,15283,12,12166,9.5,437944,141792,296152,5.3,16.4,334455,119093,215362,4.5,12.5,103489,3.9,25,0,7286,7377,49695
2013,19100,99718,132299,2786321,2747994,14534,11.1,11719,9,421394,138499,282895,5,15.3,344741,108171,236570,3.9,12.5,76653,2.8,25,0,7374,7410,59531
2014,19100,101809,135132,2886748,2826051,15800,11.9,11727,8.8,467368,170795,296573,6,16.5,345973,121632,224341,4.3,12.2,121395,4.3,24.4,0,7944,7995,53945
1977,19140,1653,1763,32707,31686,317,18.4,224,13,6375,2087,4288,6.6,20.1,4333,1824,2509,5.8,13.7,2042,6.4,27.4,0,173,174,1022
1978,19140,1745,1858,36450,34572,326,18,229,12.6,8092,2522,5570,7.3,23.4,4336,1853,2483,5.4,12.5,3756,10.9,25,0,164,164,830
1979,19140,1753,1882,38012,37205,296,15.8,263,14.1,8397,3511,4886,9.4,22.6,6783,3007,3776,8.1,18.2,1614,4.4,36.4,0,193,194,1545
1980,19140,1750,1870,38047,38010,264,14.1,266,14.2,5716,1692,4024,4.5,15,5642,2264,3378,6,14.8,74,0.2,29.6,0,187,187,1315
1981,19140,1724,1849,35041,36127,257,13.9,258,13.9,6658,3601,3057,10,18.4,8829,4651,4178,12.9,24.4,-2171,-6,36.8,0,180,180,969
1982,19140,1685,1844,33669,34327,265,14.3,253,13.7,5605,3064,2541,8.9,16.3,6921,2379,4542,6.9,20.2,-1316,-3.9,32.6,0,149,149,1315
1983,19140,1701,1864,35950,34733,239,12.9,225,12.1,7138,2932,4206,8.4,20.6,4703,1975,2728,5.7,13.5,2435,7.1,27,0,165,165,1265
1984,19140,1785,1954,42587,39280,277,14.5,192,10.1,9622,3131,6491,8,24.5,3008,1424,1584,3.6,7.7,6614,16.8,15.4,0,142,142,1049
1985,19140,1867,2032,44408,43718,285,14.3,219,11,7469,1740,5729,4,17.1,6088,2529,3559,5.8,13.9,1381,3.2,27.8,0,160,160,1010
1986,19140,1894,2070,46467,45416,280,13.7,233,11.4,7538,2772,4766,6.1,16.6,5435,2241,3194,4.9,12,2103,4.6,24,0,176,176,1412
1987,19140,1947,2124,50699,48573,316,15.1,250,11.9,10717,4641,6076,9.6,22.1,6465,3347,3118,6.9,13.3,4252,8.8,26.6,0,175,175,1516
1988,19140,2020,2203,53809,51901,303,14,213,9.9,9444,3854,5590,7.4,18.2,5628,2203,3425,4.2,10.8,3816,7.4,21.6,0,165,165,1353
1989,19140,2053,2242,51848,52902,283,12.7,243,10.9,8090,2743,5347,5.2,15.3,10198,5023,5175,9.5,19.3,-2108,-4,30.6,0,184,184,3673
1990,19140,2107,2309,52442,52168,276,12.1,201,8.8,9591,5461,4130,10.5,18.4,9042,4776,4266,9.2,17.3,549,1.1,34.6,0,147,147,1214
1991,19140,2140,2381,52781,52556,293,12.5,218,9.3,8764,4953,3811,9.4,16.7,8313,1411,6902,2.7,15.8,451,0.9,31.6,0,145,145,872
1992,19140,2222,2473,54432,53565,336,13.8,226,9.3,8342,2698,5644,5,15.6,6608,1848,4760,3.5,12.3,1734,3.3,24.6,0,156,156,1105
1993,19140,2243,2485,56050,55172,267,10.8,243,9.8,8358,2931,5427,5.3,15.1,6602,2645,3957,4.8,12,1756,3.1,24,0,168,168,1418
1994,19140,2275,2510,59638,57751,290,11.6,247,9.9,9985,2078,7907,3.6,17.3,6211,2946,3265,5.1,10.8,3774,6.5,21.6,0,168,168,1883
1995,19140,2362,2611,61230,60434,324,12.7,215,8.4,8539,2742,5797,4.5,14.1,6946,2014,4932,3.3,11.5,1593,2.6,23,0,149,150,1022
1996,19140,2439,2699,62096,61726,346,13,256,9.6,9470,3787,5683,6.1,15.3,8730,2072,6658,3.4,14.1,740,1.2,28.2,0,191,191,1231
1997,19140,2424,2711,63502,62845,294,10.9,285,10.5,9936,2851,7085,4.5,15.8,8622,3818,4804,6.1,13.7,1314,2.1,27.4,0,204,204,1460
1998,19140,2453,2749,63511,62951,326,11.9,279,10.2,10070,4519,5551,7.2,16,8950,2987,5963,4.7,14.2,1120,1.8,28.4,0,190,190,1472
1999,19140,2451,2743,63615,63581,274,10,280,10.2,8329,3323,5006,5.2,13.1,8261,3740,4521,5.9,13,68,0.1,26,0,191,191,2271
2000,19140,2437,2749,65052,64318,262,9.5,262,9.5,12653,4166,8487,6.5,19.7,11185,2077,9108,3.2,17.4,1468,2.3,34.8,0,190,190,1110
2001,19140,2424,2760,64032,64914,295,10.7,305,11.1,7604,3271,4333,5,11.7,9367,3375,5992,5.2,14.4,-1763,-2.7,23.4,0,194,194,1545
2002,19140,2410,2762,64925,64474,292,10.6,285,10.3,9655,4596,5059,7.1,15,8752,2675,6077,4.1,13.6,903,1.4,27.2,0,171,171,1717
2003,19140,2404,2747,64067,64064,290,10.6,265,9.7,7726,2508,5218,3.9,12.1,7720,2474,5246,3.9,12.1,6,0,24.2,0,196,196,1135
2004,19140,2405,2743,68526,66191,265,9.7,248,9.1,11212,3220,7992,4.9,16.9,6541,2486,4055,3.8,9.9,4671,7,19.8,0,161,161,1426
2005,19140,2410,2769,67880,68139,289,10.5,245,8.9,7837,3063,4774,4.5,11.5,8355,2627,5728,3.9,12.3,-518,-0.8,23,0,178,178,1677
2006,19140,2401,2774,67997,67853,254,9.2,229,8.3,7697,2787,4910,4.1,11.3,7409,2163,5246,3.2,10.9,288,0.4,21.8,0,170,171,1465
2007,19140,2414,2788,68004,68075,268,9.6,251,9,10175,2044,8131,3,14.9,10317,1879,8438,2.8,15.2,-142,-0.3,29.8,0,168,177,1264
2008,19140,2343,2715,67860,67673,185,6.8,232,8.5,9100,2231,6869,3.3,13.4,8725,1805,6920,2.7,12.9,375,0.5,25.8,0,186,186,1430
2009,19140,2231,2599,60599,64094,175,6.6,251,9.5,4174,1720,2454,2.7,6.5,11163,2508,8655,3.9,17.4,-6989,-10.9,13,0,186,186,1450
2010,19140,2138,2499,61187,60858,138,5.4,230,9,7148,889,6259,1.5,11.7,6490,2129,4361,3.5,10.7,658,1,21.4,0,159,159,1316
2011,19140,2115,2476,60305,60564,187,7.5,193,7.8,6199,1949,4250,3.2,10.2,6717,1130,5587,1.9,11.1,-518,-0.9,20.4,0,150,150,975
2012,19140,2098,2432,54900,57249,168,6.9,209,8.5,4630,1474,3156,2.6,8.1,9328,2312,7016,4,16.3,-4698,-8.2,16.2,0,127,127,877
2013,19140,2089,2415,52860,53825,160,6.6,166,6.9,6394,878,5516,1.6,11.9,8323,5247,3076,9.7,15.5,-1929,-3.6,23.8,0,108,108,4681
2014,19140,2065,2382,53053,52857,148,6.2,166,6.9,4621,599,4022,1.1,8.7,4228,1231,2997,2.3,8,393,0.7,16,0,123,123,799
1977,19180,1671,1789,31047,31311,255,14.4,215,12.1,3879,1677,2202,5.4,12.4,4406,1812,2594,5.8,14.1,-527,-1.7,24.8,0,141,143,972
1978,19180,1669,1784,32064,31583,207,11.6,222,12.4,4179,1199,2980,3.8,13.2,3217,1144,2073,3.6,10.2,962,3,20.4,0,160,160,744
1979,19180,1682,1801,33607,32783,223,12.4,196,10.9,5909,1717,4192,5.2,18,4261,1690,2571,5.2,13,1648,5,26,0,136,136,692
1980,19180,1661,1777,31753,32682,175,9.8,200,11.2,3753,1483,2270,4.5,11.5,5611,1245,4366,3.8,17.2,-1858,-5.7,23,0,142,142,873
1981,19180,1598,1704,28569,29801,184,10.6,234,13.5,2957,1147,1810,3.8,9.9,5420,1685,3735,5.7,18.2,-2463,-8.3,19.8,0,146,146,619
1982,19180,1563,1679,27798,28156,170,10.1,166,9.8,3997,1767,2230,6.3,14.2,4713,928,3785,3.3,16.7,-716,-2.5,28.4,0,97,97,421
1983,19180,1546,1661,26017,26903,142,8.5,180,10.8,3101,807,2294,3,11.5,4873,1290,3583,4.8,18.1,-1772,-6.6,23,0,105,105,387
1984,19180,1593,1709,27610,26851,209,12.4,161,9.6,4634,1095,3539,4.1,17.3,3116,1092,2024,4.1,11.6,1518,5.7,23.2,0,86,86,382
1985,19180,1576,1703,28246,28135,181,10.6,195,11.4,3619,1306,2313,4.6,12.9,3396,1308,2088,4.6,12.1,223,0.8,24.2,0,124,124,681
1986,19180,1589,1714,28489,28356,175,10.2,154,9,3735,1438,2297,5.1,13.2,3468,1058,2410,3.7,12.2,267,1,24.4,0,97,97,600
1987,19180,1617,1748,28625,29263,224,12.9,183,10.6,3840,1132,2708,3.9,13.1,5115,2379,2736,8.1,17.5,-1275,-4.4,26.2,0,113,113,1609
1988,19180,1571,1707,28124,28039,163,9.5,185,10.8,3906,1495,2411,5.3,13.9,3736,1372,2364,4.9,13.3,170,0.6,26.6,0,117,117,773
1989,19180,1568,1704,28109,28128,176,10.3,183,10.7,3682,1027,2655,3.7,13.1,3720,1891,1829,6.7,13.2,-38,-0.1,26.2,0,122,122,595
1990,19180,1546,1684,29119,28612,131,7.7,146,8.6,3842,1174,2668,4.1,13.4,2828,920,1908,3.2,9.9,1014,3.5,19.8,0,91,91,406
1991,19180,1564,1704,28461,28764,174,10.3,145,8.6,3869,1375,2494,4.8,13.5,4474,1666,2808,5.8,15.6,-605,-2.1,27,0,90,92,553
1992,19180,1547,1687,28273,28341,151,8.9,154,9.1,3889,1270,2619,4.5,13.7,4025,967,3058,3.4,14.2,-136,-0.5,27.4,0,98,98,722
1993,19180,1556,1702,27633,27938,153,9,144,8.5,2818,766,2052,2.7,10.1,3428,1203,2225,4.3,12.3,-610,-2.2,20.2,0,105,105,662
1994,19180,1533,1667,28056,27816,127,7.5,157,9.3,3230,745,2485,2.7,11.6,2749,720,2029,2.6,9.9,481,1.7,19.8,0,107,107,418
1995,19180,1532,1673,28975,28510,146,8.7,141,8.4,3380,977,2403,3.4,11.9,2450,687,1763,2.4,8.6,930,3.3,17.2,0,89,89,358
1996,19180,1537,1685,28279,28628,161,9.6,150,8.9,3411,1564,1847,5.5,11.9,4109,1549,2560,5.4,14.4,-698,-2.5,23.8,0,96,96,381
1997,19180,1516,1683,28576,28446,175,10.4,180,10.7,3660,1732,1928,6.1,12.9,3400,1044,2356,3.7,12,260,0.9,24,0,117,117,584
1998,19180,1492,1662,28961,28760,128,7.7,139,8.3,3258,872,2386,3,11.3,2856,1014,1842,3.5,9.9,402,1.4,19.8,0,89,89,342
1999,19180,1503,1669,29432,29198,152,9.1,148,8.9,3379,1173,2206,4,11.6,2910,931,1979,3.2,10,469,1.6,20,0,89,89,497
2000,19180,1451,1609,28975,29218,120,7.3,182,11.1,3594,1302,2292,4.5,12.3,4080,1443,2637,4.9,14,-486,-1.7,24.6,0,118,118,604
2001,19180,1416,1589,28616,28849,135,8.4,160,10,3246,1354,1892,4.7,11.3,3712,935,2777,3.2,12.9,-466,-1.6,22.6,0,107,107,486
2002,19180,1409,1592,27534,28075,159,10,157,9.9,3636,1531,2105,5.5,13,4717,2040,2677,7.3,16.8,-1081,-3.8,26,0,74,74,742
2003,19180,1384,1570,27192,27293,127,8.1,121,7.7,3183,743,2440,2.7,11.7,3384,751,2633,2.8,12.4,-201,-0.7,23.4,0,80,80,464
2004,19180,1365,1541,26688,26722,124,8,129,8.3,2758,925,1833,3.5,10.3,2826,876,1950,3.3,10.6,-68,-0.3,20.6,0,85,85,411
2005,19180,1351,1532,26968,26737,110,7.2,104,6.8,3173,1308,1865,4.9,11.9,2711,579,2132,2.2,10.1,462,1.8,20.2,0,74,74,325
2006,19180,1313,1498,26969,26904,118,7.8,133,8.8,2829,791,2038,2.9,10.5,2699,885,1814,3.3,10,130,0.5,20,0,85,85,647
2007,19180,1318,1499,25983,26491,122,8.2,121,8.1,2563,985,1578,3.7,9.7,3578,875,2703,3.3,13.5,-1015,-3.8,19.4,0,71,73,537
2008,19180,1277,1459,25665,25805,86,5.8,116,7.9,2181,478,1703,1.9,8.5,2460,527,1933,2,9.5,-279,-1,17,0,80,80,386
2009,19180,1246,1415,24410,24843,85,5.9,124,8.7,1810,444,1366,1.8,7.3,2676,623,2053,2.5,10.8,-866,-3.5,14.6,0,81,81,310
2010,19180,1219,1406,23876,24111,97,6.9,99,7,1965,553,1412,2.3,8.1,2435,476,1959,2,10.1,-470,-2,16.2,0,60,60,319
2011,19180,1167,1357,22922,23364,96,7,128,9.3,2017,392,1625,1.7,8.6,2900,1376,1524,5.9,12.4,-883,-3.8,17.2,0,83,83,265
2012,19180,1193,1381,23760,23291,114,8.3,93,6.8,3098,686,2412,2.9,13.3,2159,620,1539,2.7,9.3,939,4,18.6,0,51,51,240
2013,19180,1145,1334,23266,23456,67,5,110,8.1,2014,621,1393,2.6,8.6,2393,601,1792,2.6,10.2,-379,-1.6,17.2,0,75,75,428
2014,19180,1129,1331,23946,23504,106,8,99,7.5,2878,1507,1371,6.4,12.2,1994,758,1236,3.2,8.5,884,3.7,17,0,74,74,580
1977,19260,1656,1774,33778,32787,223,12.6,199,11.3,4762,2381,2381,7.3,14.5,2779,786,1993,2.4,8.5,1983,6,17,0,120,122,426
1978,19260,1692,1820,33794,33787,225,12.5,180,10,3526,1202,2324,3.6,10.4,3511,1006,2505,3,10.4,15,0,20.8,0,132,132,512
1979,19260,1714,1849,34803,34305,211,11.5,179,9.8,3639,1324,2315,3.9,10.6,2642,717,1925,2.1,7.7,997,2.9,15.4,0,127,127,489
1980,19260,1701,1841,35746,35274,175,9.5,180,9.8,3642,974,2668,2.8,10.3,2697,667,2030,1.9,7.6,945,2.7,15.2,0,127,128,408
1981,19260,1610,1738,34620,35089,154,8.6,238,13.3,2939,875,2064,2.5,8.4,3876,1965,1911,5.6,11,-937,-2.6,16.8,0,148,148,1129
1982,19260,1566,1705,33300,33912,182,10.6,181,10.5,3304,1343,1961,4,9.7,4528,1648,2880,4.9,13.4,-1224,-3.7,19.4,0,125,125,731
1983,19260,1609,1743,33860,33609,157,9.1,144,8.4,3114,1299,1815,3.9,9.3,2611,752,1859,2.2,7.8,503,1.5,15.6,0,96,96,453
1984,19260,1591,1734,34605,34134,218,12.6,207,11.9,3783,1515,2268,4.4,11.1,2840,1013,1827,3,8.3,943,2.8,16.6,0,103,103,382
1985,19260,1725,1881,34805,34806,221,12.2,92,5.1,3680,1669,2011,4.8,10.6,3682,489,3193,1.4,10.6,-2,0,21.2,0,6,6,39
1986,19260,1787,1942,34569,34682,224,11.7,157,8.2,3165,1254,1911,3.6,9.1,3390,913,2477,2.6,9.8,-225,-0.7,18.2,0,107,107,519
1987,19260,1804,1976,34908,34636,235,12,192,9.8,4006,1518,2488,4.4,11.6,3462,1208,2254,3.5,10,544,1.6,20,0,128,128,671
1988,19260,1814,2003,36042,35382,215,10.8,177,8.9,4602,1587,3015,4.5,13,3281,1016,2265,2.9,9.3,1321,3.7,18.6,0,115,115,361
1989,19260,1824,2015,37826,36942,175,8.7,167,8.3,4743,969,3774,2.6,12.8,2974,885,2089,2.4,8.1,1769,4.7,16.2,0,114,114,494
1990,19260,1856,2054,40171,38974,205,10.1,156,7.7,5430,1828,3602,4.7,13.9,3035,825,2210,2.1,7.8,2395,6.1,15.6,0,112,112,378
1991,19260,1887,2103,35334,37779,228,11,178,8.6,3290,1519,1771,4,8.7,8179,1211,6968,3.2,21.6,-4889,-12.9,17.4,0,107,107,722
1992,19260,1885,2091,36612,35975,181,8.6,185,8.8,5188,1535,3653,4.3,14.4,3913,1111,2802,3.1,10.9,1275,3.5,21.8,0,117,118,552
1993,19260,1892,2099,36679,36646,190,9.1,175,8.4,3847,895,2952,2.4,10.5,3780,1089,2691,3,10.3,67,0.2,20.6,0,116,116,609
1994,19260,1926,2140,37375,37028,201,9.5,157,7.4,3923,1089,2834,2.9,10.6,3228,913,2315,2.5,8.7,695,1.9,17.4,0,98,98,411
1995,19260,1955,2174,38193,37764,213,9.9,168,7.8,4556,1588,2968,4.2,12.1,3697,1544,2153,4.1,9.8,859,2.3,19.6,0,119,119,602
1996,19260,1958,2186,37342,37729,194,8.9,172,7.9,3312,1220,2092,3.2,8.8,4085,1098,2987,2.9,10.8,-773,-2,17.6,0,111,111,681
1997,19260,2005,2241,38001,37663,233,10.5,179,8.1,3969,1677,2292,4.5,10.5,3292,1345,1947,3.6,8.7,677,1.8,17.4,0,110,110,619
1998,19260,2009,2260,37214,37597,223,9.9,197,8.8,3630,1416,2214,3.8,9.7,4395,1457,2938,3.9,11.7,-765,-2,19.4,0,125,125,532
1999,19260,1987,2249,37760,37570,211,9.4,218,9.7,4302,1233,3069,3.3,11.5,3922,1529,2393,4.1,10.4,380,1.1,20.8,0,135,135,575
2000,19260,1965,2234,38173,37949,188,8.4,199,8.9,4046,1681,2365,4.4,10.7,3597,1465,2132,3.9,9.5,449,1.2,19,0,125,125,575
2001,19260,1967,2236,38303,38425,187,8.4,203,9.1,3693,1318,2375,3.4,9.6,3937,1000,2937,2.6,10.2,-244,-0.6,19.2,0,117,117,363
2002,19260,1967,2232,37612,37939,219,9.8,214,9.6,4244,1729,2515,4.6,11.2,4897,1412,3485,3.7,12.9,-653,-1.7,22.4,0,125,125,566
2003,19260,1962,2221,37293,37394,189,8.5,170,7.7,3726,1001,2725,2.7,10,3927,1108,2819,3,10.5,-201,-0.5,20,0,119,119,538
2004,19260,1975,2231,36342,36736,189,8.5,153,6.9,3896,1169,2727,3.2,10.6,4683,903,3780,2.5,12.7,-787,-2.1,21.2,0,102,102,453
2005,19260,1969,2218,35237,35582,200,9,195,8.8,4232,1850,2382,5.2,11.9,4922,1428,3494,4,13.8,-690,-1.9,23.8,0,135,135,762
2006,19260,1975,2222,34918,35014,221,10,198,8.9,5334,1829,3505,5.2,15.2,5526,1905,3621,5.4,15.8,-192,-0.6,30.4,0,130,130,1058
2007,19260,1950,2215,34668,34795,202,9.1,206,9.3,4480,1347,3133,3.9,12.9,4733,1363,3370,3.9,13.6,-253,-0.7,25.8,0,131,132,672
2008,19260,1927,2190,33926,33914,168,7.7,172,7.9,3755,1165,2590,3.4,11.1,3731,873,2858,2.6,11,24,0.1,22,0,132,132,592
2009,19260,1861,2118,31036,32229,134,6.3,178,8.3,2897,1047,1850,3.2,9,5282,1368,3914,4.2,16.4,-2385,-7.4,18,0,117,117,487
2010,19260,1850,2105,30640,30726,158,7.5,156,7.4,3522,1429,2093,4.7,11.5,3694,698,2996,2.3,12,-172,-0.5,23,0,104,104,347
2011,19260,1798,2044,31385,30906,126,6.1,167,8.1,4113,874,3239,2.8,13.3,3154,987,2167,3.2,10.2,959,3.1,20.4,0,117,117,644
2012,19260,1783,2027,32074,31685,148,7.3,161,7.9,3786,881,2905,2.8,11.9,3007,1061,1946,3.3,9.5,779,2.4,19,0,105,107,730
2013,19260,1750,1995,31752,31862,125,6.2,154,7.7,2569,807,1762,2.5,8.1,2788,617,2171,1.9,8.8,-219,-0.7,16.2,0,108,108,445
2014,19260,1728,1972,31446,31574,121,6.1,136,6.9,2652,752,1900,2.4,8.4,2907,851,2056,2.7,9.2,-255,-0.8,16.8,0,109,109,596
1977,19340,6613,7496,133154,129221,1212,16.5,888,12.1,23768,10840,12928,8.4,18.4,15901,6955,8946,5.4,12.3,7867,6.1,24.6,0,548,550,3965
1978,19340,6753,7648,137633,135369,1045,13.8,891,11.8,21273,7397,13876,5.5,15.7,16745,5378,11367,4,12.4,4528,3.3,24.8,0,593,603,2837
1979,19340,6754,7687,147358,142353,913,11.9,823,10.7,25370,7914,17456,5.6,17.8,15359,6184,9175,4.3,10.8,10011,7,21.6,0,608,608,3714
1980,19340,6677,7630,148642,147891,800,10.4,834,10.9,26211,7221,18990,4.9,17.7,24709,5743,18966,3.9,16.7,1502,1,33.4,0,596,596,3680
1981,19340,6483,7410,144783,145264,802,10.7,930,12.4,25271,7722,17549,5.3,17.4,26232,5991,20241,4.1,18.1,-961,-0.7,34.8,0,514,517,2326
1982,19340,6452,7501,133772,139315,964,12.9,801,10.7,15656,7306,8350,5.2,11.2,26741,6611,20130,4.7,19.2,-11085,-8,22.4,0,473,473,2752
1983,19340,6417,7470,121137,127129,795,10.6,859,11.5,14134,5287,8847,4.2,11.1,26118,5601,20517,4.4,20.5,-11984,-9.4,22.2,0,494,494,2635
1984,19340,6701,7756,140624,130931,941,12.4,705,9.3,32151,6300,25851,4.8,24.6,12764,4308,8456,3.3,9.7,19387,14.9,19.4,0,401,402,1957
1985,19340,6705,7737,124612,133905,879,11.3,917,11.8,16068,5983,10085,4.5,12,34654,7836,26818,5.9,25.9,-18586,-13.9,24,0,575,579,5006
1986,19340,6667,7728,129613,127107,876,11.3,854,11,22577,7906,14671,6.2,17.8,17565,5416,12149,4.3,13.8,5012,4,27.6,0,566,568,2875
1987,19340,6659,7735,126620,127923,899,11.6,877,11.3,20305,7138,13167,5.6,15.9,22910,8544,14366,6.7,17.9,-2605,-2,31.8,0,502,505,2892
1988,19340,6666,7820,127444,126037,876,11.3,739,9.5,19392,6663,12729,5.3,15.4,16579,5971,10608,4.7,13.2,2813,2.2,26.4,0,462,462,2318
1989,19340,6758,7916,132466,129777,780,9.9,692,8.8,19422,5418,14004,4.2,15,14043,5288,8755,4.1,10.8,5379,4.2,21.6,0,437,439,2535
1990,19340,6824,7957,135448,133876,746,9.4,674,8.5,18818,6362,12456,4.8,14.1,15674,5298,10376,4,11.7,3144,2.4,23.4,0,407,407,2204
1991,19340,6969,8176,138346,136631,832,10.3,621,7.7,18252,6901,11351,5.1,13.4,14822,4125,10697,3,10.8,3430,2.6,21.6,0,388,392,2302
1992,19340,6962,8266,139433,138973,836,10.2,737,9,19799,6793,13006,4.9,14.2,18878,4869,14009,3.5,13.6,921,0.6,27.2,0,450,456,2586
1993,19340,7021,8299,138022,138709,745,9,678,8.2,17210,4764,12446,3.4,12.4,18583,5802,12781,4.2,13.4,-1373,-1,24.8,0,434,438,3020
1994,19340,7116,8427,141040,139506,814,9.7,680,8.1,18413,5873,12540,4.2,13.2,15344,5033,10311,3.6,11,3069,2.2,22,0,442,443,2296
1995,19340,7167,8506,146232,143518,770,9.1,659,7.8,20073,6695,13378,4.7,14,14645,4090,10555,2.8,10.2,5428,3.8,20.4,0,442,442,2225
1996,19340,7275,8614,149822,148583,831,9.7,719,8.4,19838,7207,12631,4.9,13.4,17360,5118,12242,3.4,11.7,2478,1.7,23.4,0,455,455,2497
1997,19340,7271,8653,152483,150908,881,10.2,833,9.6,23313,8138,15175,5.4,15.4,20164,6872,13292,4.6,13.4,3149,2,26.8,0,476,476,3209
1998,19340,7340,8724,159580,156189,801,9.2,719,8.3,23798,6751,17047,4.3,15.2,17016,6351,10665,4.1,10.9,6782,4.3,21.8,0,440,440,2419
1999,19340,7305,8745,161540,160841,800,9.2,778,8.9,22372,7973,14399,5,13.9,20974,6934,14040,4.3,13,1398,0.9,26,0,484,484,3299
2000,19340,7268,8703,165103,163230,772,8.8,817,9.4,23488,9387,14101,5.8,14.4,19742,7753,11989,4.7,12.1,3746,2.3,24.2,0,463,463,3366
2001,19340,7187,8676,168260,168861,745,8.6,825,9.5,20189,6153,14036,3.6,12,21390,6320,15070,3.7,12.7,-1201,-0.7,24,0,479,482,2448
2002,19340,7099,8596,163630,165879,892,10.3,962,11.1,23545,8935,14610,5.4,14.2,28042,8796,19246,5.3,16.9,-4497,-2.7,28.4,0,466,466,2636
2003,19340,7063,8561,162423,162346,816,9.6,703,8.2,22020,6710,15310,4.1,13.6,21866,5191,16675,3.2,13.5,154,0.1,27,0,470,471,3408
2004,19340,7115,8603,163532,162336,783,9.2,666,7.8,23314,7061,16253,4.3,14.4,20922,4880,16042,3,12.9,2392,1.5,25.8,0,406,407,2278
2005,19340,7193,8676,163303,162901,858,10,686,8,20604,6663,13941,4.1,12.6,19800,5977,13823,3.7,12.2,804,0.4,24.4,0,459,468,3101
2006,19340,7186,8717,165816,164140,833,9.6,698,8,22702,10137,12565,6.2,13.8,19350,4856,14494,3,11.8,3352,2,23.6,0,421,422,2589
2007,19340,7194,8731,162747,164260,774,8.9,764,8.8,19480,5699,13781,3.5,11.9,22506,8047,14459,4.9,13.7,-3026,-1.8,23.8,0,449,457,3493
2008,19340,7149,8694,165953,164051,731,8.4,706,8.1,19680,6537,13143,4,12,15875,5057,10818,3.1,9.7,3805,2.3,19.4,0,490,491,3587
2009,19340,6984,8531,160374,162805,594,6.9,703,8.2,17397,6266,11131,3.8,10.7,22258,5152,17106,3.2,13.7,-4861,-3,21.4,0,475,475,3487
2010,19340,6862,8414,155653,157649,565,6.7,635,7.5,15257,6182,9075,3.9,9.7,19249,4955,14294,3.1,12.2,-3992,-2.5,19.4,0,397,400,3165
2011,19340,6763,8324,156591,155973,574,6.9,621,7.4,18136,4121,14015,2.6,11.6,16900,5703,11197,3.7,10.8,1236,0.8,21.6,0,395,396,3137
2012,19340,6790,8332,158540,157226,660,7.9,659,7.9,20177,5228,14949,3.3,12.8,17549,5214,12335,3.3,11.2,2628,1.6,22.4,0,402,405,2787
2013,19340,6746,8335,162430,160238,630,7.6,610,7.3,17543,5466,12077,3.4,10.9,13159,3601,9558,2.2,8.2,4384,2.7,16.4,0,393,393,2547
2014,19340,6628,8232,165077,163345,560,6.8,591,7.2,18593,8604,9989,5.3,11.4,15128,3776,11352,2.3,9.3,3465,2.1,18.6,0,415,416,2440
1977,19380,11685,14178,264806,260663,2106,15.1,1673,12,42087,17367,24720,6.7,16.1,33801,12649,21152,4.9,13,8286,3.1,26,0,1015,1024,6963
1978,19380,11965,14513,280542,272668,1901,13.3,1563,10.9,47203,13710,33493,5,17.3,31455,14374,17081,5.3,11.5,15748,5.8,23,0,1014,1016,6771
1979,19380,12175,14779,291618,285938,1881,12.8,1549,10.6,49566,14850,34716,5.2,17.3,38206,11732,26474,4.1,13.4,11360,3.9,26.8,0,996,1000,6236
1980,19380,12200,14824,295222,293355,1650,11.1,1555,10.5,46272,14587,31685,5,15.8,42537,12170,30367,4.1,14.5,3735,1.3,29,0,1014,1027,5665
1981,19380,11824,14357,277538,283956,1604,11,1935,13.3,36641,17605,19036,6.2,12.9,49476,20222,29254,7.1,17.4,-12835,-4.5,25.8,0,1040,1042,5642
1982,19380,11740,14451,269393,273308,1857,12.9,1604,11.1,39680,18591,21089,6.8,14.5,47509,11012,36497,4,17.4,-7829,-2.9,29,0,854,854,4616
1983,19380,11992,14681,264946,267310,1554,10.7,1458,10,36522,14417,22105,5.4,13.7,41249,12788,28461,4.8,15.4,-4727,-1.7,27.4,0,879,890,5057
1984,19380,12295,14996,278555,271723,1724,11.6,1446,9.7,43390,12879,30511,4.7,16,29726,10325,19401,3.8,10.9,13664,5.1,21.8,0,872,882,4094
1985,19380,12500,15228,294914,286456,1724,11.4,1470,9.7,46408,13795,32613,4.8,16.2,29494,12325,17169,4.3,10.3,16914,5.9,20.6,0,908,909,5821
1986,19380,12776,15560,301932,297709,1878,12.2,1490,9.7,46070,16807,29263,5.6,15.5,37624,12793,24831,4.3,12.6,8446,2.9,25.2,0,919,919,5407
1987,19380,13054,15984,316787,311768,2081,13.2,1579,10,51160,19598,31562,6.3,16.4,41122,15232,25890,4.9,13.2,10038,3.2,26.4,0,942,957,6472
1988,19380,13236,16247,323974,318604,1848,11.5,1567,9.7,50871,17240,33631,5.4,16,40131,12880,27251,4,12.6,10740,3.4,25.2,0,948,949,5180
1989,19380,13429,16612,333972,329771,1817,11.1,1500,9.1,53688,21012,32676,6.4,16.3,45285,16245,29040,4.9,13.7,8403,2.6,27.4,0,956,961,6345
1990,19380,13478,16812,339964,338185,1801,10.8,1526,9.1,49158,19851,29307,5.9,14.5,45600,15540,30060,4.6,13.5,3558,1,27,0,1006,1019,7512
1991,19380,13586,16997,333023,336041,1795,10.6,1581,9.4,47008,18357,28651,5.5,14,53043,17604,35439,5.2,15.8,-6035,-1.8,28,0,933,939,7825
1992,19380,13554,17036,326055,329251,1765,10.4,1705,10,43813,15044,28769,4.6,13.3,50205,14910,35295,4.5,15.2,-6392,-1.9,26.6,0,1033,1053,7069
1993,19380,13594,16942,335321,330714,1562,9.2,1638,9.6,47479,12767,34712,3.9,14.4,38265,13660,24605,4.1,11.6,9214,2.8,23.2,0,961,966,5478
1994,19380,13838,17262,345756,340494,1824,10.7,1479,8.6,51066,17667,33399,5.2,15,40542,13210,27332,3.9,11.9,10524,3.1,23.8,0,917,927,5903
1995,19380,14015,17497,363826,354640,1800,10.4,1523,8.8,58042,18399,39643,5.2,16.4,39669,13514,26155,3.8,11.2,18373,5.2,22.4,0,921,923,6219
1996,19380,14054,17499,363200,364458,1671,9.6,1665,9.5,48362,15846,32516,4.3,13.3,50877,14532,36345,4,14,-2515,-0.7,26.6,0,1004,1004,6539
1997,19380,14182,17632,374031,369386,1933,11,1807,10.3,64036,22472,41564,6.1,17.3,54745,19031,35714,5.2,14.8,9291,2.5,29.6,0,987,987,7091
1998,19380,14118,17619,372889,373012,1743,9.9,1697,9.6,53886,18476,35410,5,14.4,54131,19273,34858,5.2,14.5,-245,-0.1,28.8,0,1019,1019,6992
1999,19380,14044,17551,371750,371820,1539,8.8,1560,8.9,49114,16595,32519,4.5,13.2,49254,16495,32759,4.4,13.2,-140,0,26.4,0,925,925,6037
2000,19380,13937,17549,382298,377455,1595,9.1,1628,9.3,53621,20315,33306,5.4,14.2,43934,12706,31228,3.4,11.6,9687,2.6,23.2,0,965,965,5411
2001,19380,13768,17436,378553,381490,1534,8.8,1754,10,49689,16534,33155,4.3,13,55563,18000,37563,4.7,14.6,-5874,-1.6,26,0,978,980,5519
2002,19380,13623,17382,359486,369406,1805,10.4,1841,10.6,52900,21869,31031,5.9,14.3,72739,20983,51756,5.7,19.7,-19839,-5.4,28.6,0,871,873,5550
2003,19380,13575,17228,363221,359103,1554,9,1372,8,54532,16215,38317,4.5,15.2,46296,11903,34393,3.3,12.9,8236,2.3,25.8,0,866,874,5448
2004,19380,13454,17167,361602,360945,1514,8.8,1426,8.3,47740,16919,30821,4.7,13.2,46425,13629,32796,3.8,12.9,1315,0.3,25.8,0,884,887,7475
2005,19380,13414,17181,361809,360826,1553,9.1,1352,7.9,46092,16604,29488,4.6,12.8,44125,12034,32091,3.3,12.2,1967,0.6,24.4,0,894,895,6482
2006,19380,13369,17328,365242,360735,1763,10.3,1469,8.5,54322,20094,34228,5.6,15.1,45308,17897,27411,5,12.6,9014,2.5,25.2,0,939,943,8284
2007,19380,13253,17293,347682,355662,1614,9.3,1624,9.4,45992,18242,27750,5.1,12.9,61951,17055,44896,4.8,17.4,-15959,-4.5,25.8,0,959,983,7757
2008,19380,12909,16913,340007,342698,1306,7.7,1455,8.6,41546,16583,24963,4.8,12.1,46928,17771,29157,5.2,13.7,-5382,-1.6,24.2,0,955,955,11194
2009,19380,12545,16436,314975,324563,1162,7,1498,9,35233,17182,18051,5.3,10.9,54409,11461,42948,3.5,16.8,-19176,-5.9,21.8,0,968,982,6351
2010,19380,12246,16079,305140,309061,1109,6.8,1322,8.2,30981,9511,21470,3.1,10,38822,9432,29390,3.1,12.6,-7841,-2.6,20,0,815,815,5285
2011,19380,12121,15984,308844,306143,1141,7.1,1133,7.1,38320,11900,26420,3.9,12.5,32917,10858,22059,3.5,10.8,5403,1.7,21.6,0,719,719,6798
2012,19380,12159,15982,313588,310708,1330,8.3,1283,8.1,42583,14237,28346,4.6,13.7,36822,14404,22418,4.6,11.9,5761,1.8,23.8,0,739,749,6933
2013,19380,12060,16014,315594,313914,1262,7.9,1163,7.3,38843,11821,27022,3.8,12.4,35483,10371,25112,3.3,11.3,3360,1.1,22.6,0,700,701,6045
2014,19380,11976,15927,318472,315968,1162,7.3,1099,6.9,36199,7878,28321,2.5,11.5,31190,8635,22555,2.7,9.9,5009,1.6,19.8,0,732,734,5368
1977,19460,1705,1839,29466,29436,325,18,238,13.2,4672,2220,2452,7.5,15.9,4611,1560,3051,5.3,15.7,61,0.2,31.4,0,155,155,960
1978,19460,1764,1906,32260,30843,335,17.9,260,13.9,6014,1859,4155,6,19.5,3179,1109,2070,3.6,10.3,2835,9.2,20.6,0,192,194,907
1979,19460,1819,1983,34282,33219,351,18.1,262,13.5,6580,3038,3542,9.1,19.8,4453,2073,2380,6.2,13.4,2127,6.4,26.8,0,184,184,823
1980,19460,1836,1987,33875,34085,259,13,249,12.5,5098,1742,3356,5.1,15,5517,2021,3496,5.9,16.2,-419,-1.2,30,0,180,181,1149
1981,19460,1749,1887,33715,33261,240,12.4,306,15.9,6498,3831,2667,11.5,19.5,5589,2036,3553,6.1,16.8,909,2.7,33.6,0,207,207,1067
1982,19460,1728,1886,33870,33822,242,12.8,220,11.7,4451,1866,2585,5.5,13.2,4355,1131,3224,3.3,12.9,96,0.3,25.8,0,136,136,704
1983,19460,1791,1937,30585,31890,246,12.9,201,10.5,4051,1856,2195,5.8,12.7,6661,2904,3757,9.1,20.9,-2610,-8.2,25.4,0,133,134,917
1984,19460,1909,2062,33261,31967,337,16.9,217,10.9,5823,1796,4027,5.6,18.2,3234,1236,1998,3.9,10.1,2589,8.1,20.2,0,145,145,802
1985,19460,1995,2139,35685,35198,295,14,227,10.8,5529,1705,3824,4.8,15.7,4554,1612,2942,4.6,12.9,975,2.8,25.8,0,161,162,1078
1986,19460,2072,2229,36547,36105,341,15.6,244,11.2,6158,2504,3654,6.9,17.1,5274,1670,3604,4.6,14.6,884,2.5,29.2,0,171,171,1119
1987,19460,2162,2332,38255,37377,377,16.5,265,11.6,6284,2583,3701,6.9,16.8,4527,2012,2515,5.4,12.1,1757,4.7,24.2,0,171,177,1181
1988,19460,2168,2343,36678,37092,327,14,290,12.4,5720,2353,3367,6.3,15.4,6547,2668,3879,7.2,17.7,-827,-2.3,30.8,0,188,188,1260
1989,19460,2182,2378,38632,37749,313,13.3,281,11.9,5806,2431,3375,6.4,15.4,4039,1547,2492,4.1,10.7,1767,4.7,21.4,0,199,199,1034
1990,19460,2258,2449,41113,39803,331,13.7,238,9.9,7376,1925,5451,4.8,18.5,4755,1460,3295,3.7,11.9,2621,6.6,23.8,0,175,175,756
1991,19460,2304,2497,39900,40530,306,12.4,263,10.6,4537,1653,2884,4.1,11.2,5796,2106,3690,5.2,14.3,-1259,-3.1,22.4,0,168,168,1011
1992,19460,2338,2541,41242,40574,327,13,275,10.9,6121,2069,4052,5.1,15.1,4784,1479,3305,3.6,11.8,1337,3.3,23.6,0,202,203,923
1993,19460,2411,2614,41537,41389,338,13.1,254,9.9,5757,2096,3661,5.1,13.9,5461,1828,3633,4.4,13.2,296,0.7,26.4,0,188,188,1013
1994,19460,2461,2674,43134,42741,335,12.7,273,10.3,5768,2163,3605,5.1,13.5,4982,1454,3528,3.4,11.7,786,1.8,23.4,0,202,202,1013
1995,19460,2536,2762,46802,44937,354,13,262,9.6,8129,2512,5617,5.6,18.1,4398,1592,2806,3.5,9.8,3731,8.3,19.6,0,183,183,1020
1996,19460,2575,2798,48163,47538,330,11.9,290,10.4,6616,2986,3630,6.3,13.9,5366,1670,3696,3.5,11.3,1250,2.6,22.6,0,203,203,1131
1997,19460,2617,2872,50325,49242,386,13.6,317,11.2,8227,2920,5307,5.9,16.7,6061,1943,4118,3.9,12.3,2166,4.4,24.6,0,231,231,1212
1998,19460,2607,2878,51944,51124,321,11.2,308,10.7,7850,2474,5376,4.8,15.4,6209,2322,3887,4.5,12.1,1641,3.3,24.2,0,223,223,1373
1999,19460,2639,2928,51353,51774,355,12.2,295,10.2,6697,2734,3963,5.3,12.9,7539,2698,4841,5.2,14.6,-842,-1.7,25.8,0,205,205,1890
2000,19460,2648,2945,52571,51973,298,10.1,287,9.8,7198,2410,4788,4.6,13.8,6001,1852,4149,3.6,11.5,1197,2.3,23,0,205,205,1107
2001,19460,2576,2895,51075,51896,254,8.7,324,11.1,5786,1696,4090,3.3,11.1,7428,2606,4822,5,14.3,-1642,-3.2,22.2,0,210,210,1901
2002,19460,2592,2908,49880,50460,336,11.6,323,11.1,6640,2949,3691,5.8,13.2,7799,2275,5524,4.5,15.5,-1159,-2.3,26.4,0,183,183,1011
2003,19460,2596,2908,51188,50119,281,9.7,239,8.3,8109,3499,4610,7,16.2,5970,1244,4726,2.5,11.9,2139,4.3,23.8,0,179,179,953
2004,19460,2577,2894,51802,51443,268,9.3,254,8.8,8069,2734,5335,5.3,15.7,7350,1575,5775,3.1,14.3,719,1.4,28.6,0,195,195,910
2005,19460,2596,2913,50260,50720,290,10,237,8.2,7114,1992,5122,3.9,14,8034,2639,5395,5.2,15.8,-920,-1.8,28,0,159,159,1057
2006,19460,2592,2945,49321,49671,310,10.6,257,8.8,6402,2045,4357,4.1,12.9,7101,3387,3714,6.8,14.3,-699,-1.4,25.8,0,173,173,1724
2007,19460,2592,2961,50152,49595,282,9.6,264,8.9,7126,2627,4499,5.3,14.4,6012,1558,4454,3.1,12.1,1114,2.3,24.2,0,172,173,942
2008,19460,2613,2986,50311,50248,250,8.4,203,6.9,5512,1550,3962,3.1,11,5386,1165,4221,2.3,10.7,126,0.3,21.4,0,158,159,976
2009,19460,2551,2913,48135,49169,202,6.9,262,8.9,5386,2401,2985,4.9,11,7453,1744,5709,3.5,15.2,-2067,-4.2,22,0,180,180,775
2010,19460,2484,2867,45722,46506,232,8.1,242,8.4,4694,1663,3031,3.6,10.1,6261,1497,4764,3.2,13.5,-1567,-3.4,20.2,0,167,167,951
2011,19460,2470,2839,47000,46194,230,8.1,231,8.1,5904,1701,4203,3.7,12.8,4292,1161,3131,2.5,9.3,1612,3.5,18.6,0,140,140,685
2012,19460,2476,2851,46285,46560,250,8.8,230,8.1,5852,1866,3986,4,12.6,6401,1652,4749,3.5,13.7,-549,-1.1,25.2,0,156,156,818
2013,19460,2447,2806,47794,46874,195,6.9,231,8.2,6446,1567,4879,3.3,13.8,4605,1871,2734,4,9.8,1841,4,19.6,0,154,154,1032
2014,19460,2412,2765,45787,46697,191,6.9,211,7.6,6231,2720,3511,5.8,13.3,8050,3321,4729,7.1,17.2,-1819,-3.9,26.6,0,149,149,2068
1977,19500,2181,2397,48736,47990,346,14.7,267,11.3,7410,3195,4215,6.7,15.4,5917,2478,3439,5.2,12.3,1493,3.1,24.6,0,165,166,1304
1978,19500,2203,2428,52205,50474,313,13,284,11.8,8449,2045,6404,4.1,16.7,4986,1784,3202,3.5,9.9,3463,6.8,19.8,0,201,202,1154
1979,19500,2243,2480,52916,52544,340,13.9,283,11.5,7402,2507,4895,4.8,14.1,6658,1584,5074,3,12.7,744,1.4,25.4,0,196,196,811
1980,19500,2242,2475,51849,52385,277,11.2,274,11.1,5965,1860,4105,3.6,11.4,7036,1690,5346,3.2,13.4,-1071,-2,22.8,0,174,174,864
1981,19500,2142,2366,48018,49610,240,9.9,323,13.4,4950,2073,2877,4.2,10,8133,1879,6254,3.8,16.4,-3183,-6.4,20,0,178,183,884
1982,19500,2116,2362,47001,47527,280,11.8,258,10.9,5672,2400,3272,5,11.9,6724,1968,4756,4.1,14.1,-1052,-2.2,23.8,0,145,145,631
1983,19500,2087,2322,42594,44711,206,8.8,266,11.4,4249,1477,2772,3.3,9.5,8483,2743,5740,6.1,19,-4234,-9.5,19,0,146,152,1113
1984,19500,2141,2376,44784,43704,283,12.1,232,9.9,6163,1882,4281,4.3,14.1,4002,1543,2459,3.5,9.2,2161,4.9,18.4,0,146,146,790
1985,19500,2133,2373,44822,45119,232,9.7,250,10.5,5152,1378,3774,3.1,11.4,5745,1778,3967,3.9,12.7,-593,-1.3,22.8,0,169,169,1108
1986,19500,2131,2371,46052,45376,245,10.3,235,9.9,6277,2444,3833,5.4,13.8,4925,1703,3222,3.8,10.9,1352,2.9,21.8,0,148,151,806
1987,19500,2186,2442,45544,45932,306,12.7,235,9.8,7281,2931,4350,6.4,15.9,8057,2536,5521,5.5,17.5,-776,-1.6,31.8,0,142,143,902
1988,19500,2177,2444,47002,45908,264,10.8,244,10,7381,2165,5216,4.7,16.1,5192,1971,3221,4.3,11.3,2189,4.8,22.6,0,161,161,896
1989,19500,2188,2459,48418,47719,262,10.7,250,10.2,7856,2900,4956,6.1,16.5,6457,2234,4223,4.7,13.5,1399,3,27,0,151,151,889
1990,19500,2212,2495,49680,49031,255,10.3,210,8.5,6191,1681,4510,3.4,12.6,4892,1409,3483,2.9,10,1299,2.6,20,0,143,143,772
1991,19500,2245,2535,50585,50156,240,9.5,203,8.1,6625,2228,4397,4.4,13.2,5766,1396,4370,2.8,11.5,859,1.7,23,0,123,123,653
1992,19500,2245,2541,50758,50692,249,9.8,240,9.5,6613,2394,4219,4.7,13,6481,1610,4871,3.2,12.8,132,0.2,25.6,0,140,144,807
1993,19500,2257,2547,50737,50691,252,9.9,234,9.2,6011,2086,3925,4.1,11.9,5919,1607,4312,3.2,11.7,92,0.2,23.4,0,157,157,975
1994,19500,2259,2552,50703,50660,236,9.3,219,8.6,6197,1773,4424,3.5,12.2,6111,2181,3930,4.3,12.1,86,0.1,24.2,0,144,145,1158
1995,19500,2264,2557,51840,51219,254,9.9,238,9.3,6590,2147,4443,4.2,12.9,5347,1898,3449,3.7,10.4,1243,2.5,20.8,0,142,142,855
1996,19500,2256,2554,51835,51916,234,9.2,238,9.3,6242,1714,4528,3.3,12,6404,1658,4746,3.2,12.3,-162,-0.3,24,0,145,145,558
1997,19500,2248,2569,52697,52299,270,10.5,268,10.4,6913,2356,4557,4.5,13.2,6116,2299,3817,4.4,11.7,797,1.5,23.4,0,159,159,1133
1998,19500,2227,2546,53594,53118,223,8.7,241,9.4,6467,2136,4331,4,12.2,5515,1460,4055,2.7,10.4,952,1.8,20.8,0,156,156,744
1999,19500,2180,2508,54613,54099,200,7.9,230,9.1,5766,1490,4276,2.8,10.7,4737,1531,3206,2.8,8.8,1029,1.9,17.6,0,156,156,720
2000,19500,2155,2480,54338,54484,199,8,230,9.2,5661,1904,3757,3.5,10.4,5952,2125,3827,3.9,10.9,-291,-0.5,20.8,0,125,125,926
2001,19500,2130,2466,53031,53723,189,7.6,220,8.9,6166,1704,4462,3.2,11.5,7550,1758,5792,3.3,14.1,-1384,-2.6,23,0,121,121,534
2002,19500,2091,2419,51701,52348,202,8.3,251,10.3,5460,1815,3645,3.5,10.4,6753,1888,4865,3.6,12.9,-1293,-2.5,20.8,0,111,111,642
2003,19500,2079,2413,46499,47860,212,8.8,183,7.6,5410,2174,3236,4.5,11.3,8132,3194,4938,6.7,17,-2722,-5.7,22.6,0,111,111,959
2004,19500,2085,2426,46638,46449,231,9.6,189,7.8,5236,2221,3015,4.8,11.3,4857,1366,3491,2.9,10.5,379,0.8,21,0,120,120,834
2005,19500,2090,2441,47765,47016,236,9.7,192,7.9,6004,2053,3951,4.4,12.8,4505,1051,3454,2.2,9.6,1499,3.2,19.2,0,123,123,571
2006,19500,2080,2420,48407,47797,229,9.5,223,9.2,6184,1907,4277,4,12.9,4964,1675,3289,3.5,10.4,1220,2.5,20.8,0,141,141,815
2007,19500,2065,2412,47887,47985,201,8.3,199,8.3,5731,1989,3742,4.1,11.9,5927,1948,3979,4.1,12.4,-196,-0.5,23.8,0,129,129,692
2008,19500,2051,2406,49762,48607,178,7.4,160,6.7,6642,2594,4048,5.3,13.7,4332,1227,3105,2.5,8.9,2310,4.8,17.8,0,100,100,780
2009,19500,2010,2357,48461,49063,140,5.9,178,7.5,4328,1517,2811,3.1,8.8,5532,1242,4290,2.5,11.3,-1204,-2.5,17.6,0,111,111,625
2010,19500,1961,2317,47084,47706,168,7.2,190,8.2,4528,1421,3107,3,9.5,5771,2122,3649,4.4,12.1,-1243,-2.6,19,0,120,120,1498
2011,19500,1953,2311,46660,46902,154,6.7,152,6.6,4319,832,3487,1.8,9.2,4802,1438,3364,3.1,10.2,-483,-1,18.4,0,93,93,470
2012,19500,1923,2276,47654,47113,165,7.2,185,8.1,5817,1481,4336,3.1,12.3,4734,1553,3181,3.3,10,1083,2.3,20,0,95,95,554
2013,19500,1933,2289,46352,46774,178,7.8,164,7.2,4175,1256,2919,2.7,8.9,5018,1113,3905,2.4,10.7,-843,-1.8,17.8,0,101,101,650
2014,19500,1907,2256,46387,46289,148,6.6,150,6.6,4052,1272,2780,2.7,8.8,3856,1049,2807,2.3,8.3,196,0.5,16.6,0,100,100,432
1977,19660,4483,4984,52168,50459,1041,21.5,745,15.4,13396,7785,5611,15.4,26.5,9977,5126,4851,10.2,19.8,3419,6.7,39.6,0,522,527,3630
1978,19660,4656,5192,58224,55185,956,18.8,740,14.5,14933,6129,8804,11.1,27.1,8855,4645,4210,8.4,16,6078,11.1,32,0,537,539,2990
1979,19660,4856,5402,63424,60762,936,17.7,698,13.2,15225,5378,9847,8.9,25.1,9901,4919,4982,8.1,16.3,5324,8.8,32.6,0,505,509,2694
1980,19660,5020,5592,66003,64568,924,16.8,714,13,14098,5808,8290,9,21.8,11227,3601,7626,5.6,17.4,2871,4.4,34.8,0,561,563,2506
1981,19660,5097,5666,67505,66489,1015,18,877,15.6,13795,6276,7519,9.4,20.7,11762,5511,6251,8.3,17.7,2033,3,35.4,0,592,592,2985
1982,19660,5238,5913,70436,68827,1061,18.3,757,13.1,15158,8128,7030,11.8,22,11939,4444,7495,6.5,17.3,3219,4.7,34.6,0,468,468,2756
1983,19660,5444,6136,73620,72019,973,16.2,795,13.2,14934,6106,8828,8.5,20.7,11732,5270,6462,7.3,16.3,3202,4.4,32.6,0,523,523,2778
1984,19660,5864,6613,79570,76355,1226,19.2,753,11.8,19419,8696,10723,11.4,25.4,12989,5576,7413,7.3,17,6430,8.4,34,0,504,504,3304
1985,19660,6117,6908,86961,83594,1163,17.2,855,12.6,19843,8381,11462,10,23.7,13108,5654,7454,6.8,15.7,6735,8,31.4,0,566,566,3338
1986,19660,6387,7210,93597,90264,1223,17.3,892,12.6,21107,8266,12841,9.2,23.4,14440,6226,8214,6.9,16,6667,7.4,32,0,632,632,3635
1987,19660,6682,7598,95519,94412,1373,18.5,944,12.7,20974,10029,10945,10.6,22.2,18760,6743,12017,7.1,19.9,2214,2.3,39.8,0,645,649,4172
1988,19660,6925,7878,99996,97549,1330,17.2,1007,13,21701,9794,11907,10,22.2,16806,7887,8919,8.1,17.2,4895,5,34.4,0,735,735,4908
1989,19660,7066,8050,105451,103843,1148,14.4,973,12.2,21356,8721,12635,8.4,20.6,18140,6995,11145,6.7,17.5,3216,3.1,35,0,681,681,4570
1990,19660,7279,8307,106490,104718,1256,15.4,944,11.5,20676,8986,11690,8.6,19.7,17132,6306,10826,6,16.4,3544,3.3,32.8,0,698,704,4208
1991,19660,7394,8458,104708,105756,1165,13.9,1028,12.3,18264,7472,10792,7.1,17.3,20360,7331,13029,6.9,19.3,-2096,-2,34.6,0,658,662,4148
1992,19660,7500,8581,105713,106252,1274,14.9,1121,13.1,20078,8736,11342,8.2,18.9,21155,7764,13391,7.3,19.9,-1077,-1,37.8,0,755,771,4892
1993,19660,7690,8749,111274,109698,1234,14.2,1037,12,19986,7451,12535,6.8,18.2,16834,7050,9784,6.4,15.3,3152,2.9,30.6,0,744,761,4258
1994,19660,7839,8934,112131,110450,1223,13.8,1002,11.3,20321,8233,12088,7.5,18.4,16958,7474,9484,6.8,15.4,3363,3,30.8,0,727,728,3556
1995,19660,7956,9090,118385,115285,1232,13.7,1039,11.5,23973,9952,14021,8.6,20.8,17773,6825,10948,5.9,15.4,6200,5.4,30.8,0,752,752,4111
1996,19660,8083,9237,123302,120845,1201,13.1,1022,11.2,23651,11224,12427,9.3,19.6,18736,7252,11484,6,15.5,4915,4.1,31,0,709,709,4273
1997,19660,8149,9375,123829,123613,1320,14.2,1157,12.4,22380,9786,12594,7.9,18.1,21948,10388,11560,8.4,17.8,432,0.3,35.6,0,795,795,4832
1998,19660,8141,9354,126830,125156,1186,12.7,1164,12.4,22534,9509,13025,7.6,18,19186,8145,11041,6.5,15.3,3348,2.7,30.6,0,813,813,4517
1999,19660,8223,9479,131195,129049,1298,13.8,1177,12.5,24030,9897,14133,7.7,18.6,19737,8920,10817,6.9,15.3,4293,3.3,30.6,0,819,819,4702
2000,19660,8233,9494,133658,132311,1157,12.2,1129,11.9,20747,7419,13328,5.6,15.7,18052,8801,9251,6.7,13.6,2695,2.1,27.2,0,751,751,4406
2001,19660,8277,9592,134275,134142,1227,12.8,1200,12.6,22033,8852,13181,6.6,16.4,21766,9597,12169,7.2,16.2,267,0.2,32.4,0,750,750,3969
2002,19660,8465,9770,130946,132428,1400,14.5,1202,12.4,21606,9539,12067,7.2,16.3,24570,9506,15064,7.2,18.6,-2964,-2.3,32.6,0,683,684,3289
2003,19660,8699,10009,133882,131709,1442,14.6,1036,10.5,25262,9640,15622,7.3,19.2,20916,9456,11460,7.2,15.9,4346,3.3,31.8,0,730,730,4354
2004,19660,9297,10575,138316,135387,1739,16.9,1097,10.7,25452,9497,15955,7,18.8,19593,8756,10837,6.5,14.5,5859,4.3,29,0,759,761,4223
2005,19660,9767,11149,142702,139773,1792,16.5,1119,10.3,24012,10962,13050,7.8,17.2,18154,5627,12527,4,13,5858,4.2,26,0,817,817,4175
2006,19660,10086,11559,148462,144502,1785,15.7,1286,11.3,26606,11850,14756,8.2,18.4,18685,7896,10789,5.5,12.9,7921,5.5,25.8,0,936,936,5050
2007,19660,10045,11582,146184,146914,1578,13.7,1501,13,23666,9799,13867,6.7,16.1,25126,9636,15490,6.6,17.1,-1460,-1,32.2,0,1032,1035,5037
2008,19660,9670,11243,145121,145694,1284,11.3,1514,13.3,21906,9734,12172,6.7,15,23051,7633,15418,5.2,15.8,-1145,-0.8,30,0,1137,1137,4892
2009,19660,9084,10581,131837,137556,1126,10.4,1549,14.3,16002,7451,8551,5.4,11.6,27439,9073,18366,6.6,19.9,-11437,-8.3,23.2,0,1132,1138,6502
2010,19660,8893,10378,128831,129536,1103,10.6,1256,12,17116,8302,8814,6.4,13.2,18525,6229,12296,4.8,14.3,-1409,-1.1,26.4,0,867,867,4297
2011,19660,8785,10298,127068,127615,1138,11,1163,11.3,15648,6439,9209,5,12.3,16741,6091,10650,4.8,13.1,-1093,-0.8,24.6,0,797,797,3730
2012,19660,9021,10546,130443,128573,1260,12.1,1029,9.9,18660,7666,10994,6,14.5,14919,5443,9476,4.2,11.6,3741,2.9,23.2,0,663,671,3115
2013,19660,9066,10578,131546,130640,1059,10.1,1060,10.1,17025,5079,11946,3.9,13,15213,5966,9247,4.6,11.6,1812,1.4,23.2,0,685,685,4177
2014,19660,9203,10758,136296,133645,1248,11.7,1010,9.5,20913,6989,13924,5.2,15.6,15610,5957,9653,4.5,11.7,5303,3.9,23.4,0,754,755,3965
1977,19740,25920,30316,485360,471613,6220,21.3,3985,13.6,109434,48687,60747,10.3,23.2,81939,33299,48640,7.1,17.4,27495,5.8,34.8,0,2705,2709,18583
1978,19740,25230,29881,522949,503208,5167,17.2,5319,17.7,122109,39954,82155,7.9,24.3,82627,43389,39238,8.6,16.4,39482,7.9,32.8,0,3130,3155,22142
1979,19740,28111,32880,579620,551837,5783,18.4,2970,9.5,129473,47403,82070,8.6,23.5,73907,25843,48064,4.7,13.4,55566,10.1,26.8,0,63,71,2554
1980,19740,29086,33981,598171,587670,5777,17.3,4494,13.4,118919,44981,73938,7.7,20.2,97917,40405,57512,6.9,16.7,21002,3.5,33.4,0,3026,3041,22009
1981,19740,29129,34116,617664,606644,5745,16.9,5440,16,134686,56969,77717,9.4,22.2,112645,43604,69041,7.2,18.6,22041,3.6,37.2,0,3249,3266,22740
1982,19740,30584,36277,681606,649887,7019,19.9,4605,13.1,176193,97186,79007,15,27.1,112755,41060,71695,6.3,17.3,63438,9.8,34.6,0,2350,2352,16843
1983,19740,31908,37794,635905,656008,6106,16.5,4764,12.9,121516,54646,66870,8.3,18.5,161722,40665,121057,6.2,24.7,-40206,-6.2,37,0,3052,3067,18977
1984,19740,33599,39722,674188,654949,6642,17.1,4771,12.3,144799,58903,85896,9,22.1,106322,37997,68325,5.8,16.2,38477,5.9,32.4,0,3075,3082,18992
1985,19740,34516,40864,695895,684900,6738,16.7,5596,13.9,140130,56763,83367,8.3,20.5,118140,47731,70409,7,17.2,21990,3.3,34.4,0,3696,3705,27095
1986,19740,35000,41616,708587,701891,6853,16.6,5943,14.4,146678,68036,78642,9.7,20.9,133285,55792,77493,7.9,19,13393,1.9,38,0,3793,3807,28582
1987,19740,35080,42027,682743,702495,7099,17,6541,15.6,131183,63896,67287,9.1,18.7,170686,76951,93735,11,24.3,-39503,-5.6,37.4,0,4087,4116,33668
1988,19740,34732,41906,682595,680849,6350,15.1,6291,15,130782,53133,77649,7.8,19.2,127289,53450,73839,7.9,18.7,3493,0.5,37.4,0,4175,4175,24276
1989,19740,34687,41927,692405,688050,5914,14.1,5860,14,132053,56223,75830,8.2,19.2,123343,55038,68305,8,17.9,8710,1.3,35.8,0,3756,3769,27893
1990,19740,35311,42668,714235,703696,6054,14.3,5080,12,133181,56193,76988,8,18.9,112104,50342,61762,7.2,15.9,21077,3,31.8,0,3284,3304,27440
1991,19740,36814,44523,729830,722483,6678,15.3,4870,11.2,131792,54157,77635,7.5,18.2,117098,45982,71116,6.4,16.2,14694,2,32.4,0,3023,3056,22008
1992,19740,37810,45503,750596,739919,6618,14.7,5476,12.2,143609,55672,87937,7.5,19.4,122255,49137,73118,6.6,16.5,21354,2.9,33,0,3309,3368,25759
1993,19740,39452,46900,775629,762181,6592,14.3,5095,11,139073,45874,93199,6,18.2,112176,44648,67528,5.9,14.7,26897,3.5,29.4,0,3173,3190,20829
1994,19740,41234,49031,803407,789336,7361,15.3,5098,10.6,144931,56222,88709,7.1,18.4,116789,43259,73530,5.5,14.8,28142,3.6,29.6,0,3345,3363,20359
1995,19740,42932,51022,847379,824694,7589,15.2,5384,10.8,165258,67031,98227,8.1,20,119887,40753,79134,4.9,14.5,45371,5.5,29,0,3443,3451,21590
1996,19740,43965,52079,869439,858199,7320,14.2,6116,11.9,177240,78220,99020,9.1,20.7,154761,66552,88209,7.8,18,22479,2.7,36,0,3774,3775,24792
1997,19740,45415,54015,899998,884551,8396,15.8,6390,12,191792,82172,109620,9.3,21.7,160898,62328,98570,7,18.2,30894,3.5,36.4,0,3759,3759,25013
1998,19740,46248,55475,952745,927200,8087,14.8,6475,11.8,194375,75222,119153,8.1,21,143284,54846,88438,5.9,15.5,51091,5.5,31,0,4117,4117,25746
1999,19740,47000,56756,990494,971264,7951,14.2,6589,11.7,202439,85255,117184,8.8,20.8,163979,69920,94059,7.2,16.9,38460,3.9,33.8,0,4049,4049,28437
2000,19740,47578,57689,1045234,1018226,7807,13.6,6856,12,207917,77923,129994,7.7,20.4,153901,58505,95396,5.7,15.1,54016,5.3,30.2,0,3928,3928,24886
2001,19740,48624,59552,1106265,1078812,8581,14.6,7155,12.2,238111,94735,143376,8.8,22.1,183205,72328,110877,6.7,17,54906,5.1,34,0,4094,4095,28303
2002,19740,48990,59901,1041883,1072987,8760,14.7,8309,13.9,192510,80273,112237,7.5,17.9,254717,95805,158912,8.9,23.7,-62207,-5.8,35.8,0,4268,4275,26001
2003,19740,49590,60565,1033043,1029372,8589,14.3,6705,11.2,187148,78229,108919,7.6,18.2,179805,60979,118826,5.9,17.5,7343,0.7,35,0,4258,4265,32712
2004,19740,50406,61494,1054759,1039824,8392,13.8,6787,11.1,191402,83333,108069,8,18.4,161531,56188,105343,5.4,15.5,29871,2.9,31,0,4217,4222,26678
2005,19740,51684,63166,1069077,1057455,8932,14.4,6577,10.6,178017,75607,102410,7.1,16.8,154772,57936,96836,5.5,14.6,23245,2.2,29.2,0,4235,4243,32996
2006,19740,52305,64155,1113271,1087901,8937,14.1,7209,11.4,194937,74703,120234,6.9,17.9,144197,55302,88895,5.1,13.3,50740,4.6,26.6,0,4671,4683,32589
2007,19740,53121,65477,1133637,1120110,9056,14,7497,11.6,210132,87061,123071,7.8,18.8,183079,62755,120324,5.6,16.3,27053,2.5,32.6,0,4489,4519,31594
2008,19740,53074,65690,1148658,1138454,8181,12.5,7332,11.2,187808,70672,117136,6.2,16.5,167399,57828,109571,5.1,14.7,20409,1.8,29.4,0,4817,4828,32254
2009,19740,51634,64173,1079774,1109817,7111,11,7892,12.2,139496,58369,81127,5.3,12.6,199581,59654,139927,5.4,18,-60085,-5.4,25.2,0,5064,5078,37827
2010,19740,51119,63532,1063100,1069243,7254,11.4,7329,11.5,151897,58835,93062,5.5,14.2,164183,54551,109632,5.1,15.4,-12286,-1.2,28.4,0,4480,4489,27601
2011,19740,51083,63682,1075294,1066325,7365,11.6,6768,10.7,154998,49627,105371,4.7,14.5,137062,43262,93800,4.1,12.9,17936,1.6,25.8,0,4167,4173,26171
2012,19740,51976,64615,1110192,1091831,7658,12,6603,10.3,170037,57862,112175,5.3,15.6,133315,46695,86620,4.3,12.2,36722,3.4,24.4,0,3769,3803,21712
2013,19740,53122,65771,1179833,1143340,7623,11.7,6472,10,202817,56062,146755,4.9,17.7,129833,46635,83198,4.1,11.4,72984,6.3,22.8,0,3836,3845,26490
2014,19740,54250,67224,1214440,1194014,8230,12.4,6273,9.5,208668,73496,135172,6.2,17.5,167816,45645,122171,3.8,14.1,40852,3.4,28.2,0,4129,4137,24169
1977,19780,7925,9043,151061,148119,1540,17.3,1299,14.6,27524,12249,15275,8.3,18.6,21640,10128,11512,6.8,14.6,5884,4,29.2,0,889,890,5787
1978,19780,8144,9290,159978,155488,1345,14.7,1088,11.9,28726,9668,19058,6.2,18.5,19746,7152,12594,4.6,12.7,8980,5.8,25.4,0,762,763,3818
1979,19780,8177,9354,167921,163870,1236,13.3,1128,12.1,30256,10203,20053,6.2,18.5,22154,8019,14135,4.9,13.5,8102,5,27,0,774,774,4489
1980,19780,8197,9401,164754,166090,1150,12.3,1053,11.2,24911,8504,16407,5.1,15,27582,9943,17639,6,16.6,-2671,-1.6,30,0,732,735,6229
1981,19780,7956,9150,159653,161607,1133,12.2,1321,14.3,23367,11876,11491,7.3,14.5,27275,8731,18544,5.4,16.9,-3908,-2.4,29,0,783,784,4388
1982,19780,7942,9284,161405,160294,1301,14.1,1066,11.6,28081,12766,15315,8,17.5,25859,8198,17661,5.1,16.1,2222,1.4,32.2,0,597,597,3463
1983,19780,8100,9438,157611,157882,1094,11.7,1008,10.8,27330,10416,16914,6.6,17.3,27871,9328,18543,5.9,17.7,-541,-0.4,34.6,0,653,653,3550
1984,19780,8298,9671,166026,161885,1232,12.9,994,10.4,30999,12891,18108,8,19.1,22716,6815,15901,4.2,14,8283,5.1,28,0,653,656,3678
1985,19780,8294,9678,171294,169446,1116,11.5,1119,11.6,28251,8714,19537,5.1,16.7,24554,11929,12625,7,14.5,3697,2.2,29,0,714,716,4340
1986,19780,8400,9846,178572,174948,1246,12.8,1050,10.8,32709,13537,19172,7.7,18.7,25461,9327,16134,5.3,14.6,7248,4.1,29.2,0,690,690,4750
1987,19780,8482,10018,184876,183596,1337,13.5,1121,11.3,29989,11320,18669,6.2,16.3,27428,12100,15328,6.6,14.9,2561,1.4,29.8,0,645,649,4922
1988,19780,8482,10072,194265,188644,1206,12,1090,10.9,35011,10632,24379,5.6,18.6,23769,9769,14000,5.2,12.6,11242,6,25.2,0,697,697,3940
1989,19780,8653,10327,202496,197450,1175,11.5,935,9.2,32991,11286,21705,5.7,16.7,22899,7106,15793,3.6,11.6,10092,5.1,23.2,0,615,616,4058
1990,19780,8842,10573,208412,205045,1152,11,876,8.4,31612,9777,21835,4.8,15.4,24877,8256,16621,4,12.1,6735,3.3,24.2,0,559,559,4728
1991,19780,9079,10939,212747,211082,1264,11.8,910,8.5,31822,11745,20077,5.6,15.1,28491,8724,19767,4.1,13.5,3331,1.6,27,0,551,561,4432
1992,19780,9210,11132,216288,216296,1287,11.7,1060,9.6,34779,13171,21608,6.1,16.1,34795,12840,21955,5.9,16.1,-16,0,32.2,0,629,636,5377
1993,19780,9335,11236,219112,217645,1191,10.6,1077,9.6,31691,10476,21215,4.8,14.6,28756,8582,20174,3.9,13.2,2935,1.4,26.4,0,660,660,3796
1994,19780,9586,11509,225979,222176,1369,12,1050,9.2,35445,13297,22148,6,16,27839,10354,17485,4.7,12.5,7606,3.5,25,0,640,651,4290
1995,19780,9747,11734,231513,228719,1305,11.2,1064,9.2,35643,12492,23151,5.5,15.6,30055,10453,19602,4.6,13.1,5588,2.5,26.2,0,710,713,4675
1996,19780,9869,11876,237312,234406,1275,10.8,1101,9.3,34535,12969,21566,5.5,14.7,28722,8892,19830,3.8,12.3,5813,2.4,24.6,0,687,687,3650
1997,19780,9880,11972,242100,239904,1384,11.6,1267,10.6,39296,14612,24684,6.1,16.4,34904,13942,20962,5.8,14.5,4392,1.9,29,0,745,745,5681
1998,19780,9971,12087,248456,245183,1279,10.6,1146,9.5,36453,12671,23782,5.2,14.9,29906,10265,19641,4.2,12.2,6547,2.7,24.4,0,708,708,4373
1999,19780,10011,12263,256175,252898,1317,10.8,1139,9.4,38344,11990,26354,4.7,15.2,31790,12129,19661,4.8,12.6,6554,2.6,25.2,0,706,706,3496
2000,19780,10066,12375,265880,261095,1328,10.8,1219,9.9,43737,18887,24850,7.2,16.8,34166,13738,20428,5.3,13.1,9571,3.7,26.2,0,696,696,4890
2001,19780,10015,12505,267910,267541,1281,10.3,1222,9.8,37807,14290,23517,5.3,14.1,37069,11421,25648,4.3,13.9,738,0.2,27.8,0,653,654,4764
2002,19780,10041,12547,265997,265313,1431,11.4,1352,10.8,38706,15525,23181,5.9,14.6,37337,13536,23801,5.1,14.1,1369,0.5,28.2,0,666,670,4131
2003,19780,10176,12692,267505,263905,1492,11.9,1106,8.8,41084,16460,24624,6.2,15.6,33883,9071,24812,3.4,12.8,7201,2.8,25.6,0,658,658,4615
2004,19780,10346,12835,273547,269851,1386,10.9,1110,8.7,44146,13941,30205,5.2,16.4,36753,15260,21493,5.7,13.6,7393,2.8,27.2,0,652,653,4274
2005,19780,10530,13103,280864,276523,1475,11.4,1096,8.5,40322,14405,25917,5.2,14.6,31640,9838,21802,3.6,11.4,8682,3.2,22.8,0,708,708,5223
2006,19780,10650,13396,288803,284281,1624,12.3,1217,9.2,43078,15241,27837,5.4,15.2,34033,11416,22617,4,12,9045,3.2,24,0,762,762,6211
2007,19780,10878,13633,291919,289765,1498,11.1,1225,9.1,41121,12193,28928,4.2,14.2,36812,10260,26552,3.5,12.7,4309,1.5,25.4,0,702,705,4617
2008,19780,10827,13628,296461,293450,1301,9.6,1176,8.7,41306,11051,30255,3.8,14.1,35284,9541,25743,3.3,12,6022,2.1,24,0,780,780,4924
2009,19780,10679,13463,289169,292358,1149,8.5,1219,9,34102,12693,21409,4.3,11.7,40480,7868,32612,2.7,13.8,-6378,-2.1,23.4,0,792,792,4849
2010,19780,10539,13359,283395,285515,1067,8,1090,8.2,28908,8052,20856,2.8,10.1,33148,7236,25912,2.5,11.6,-4240,-1.5,20.2,0,707,709,4487
2011,19780,10524,13380,288375,285422,1188,8.9,1078,8.1,35070,11339,23731,4,12.3,29164,8734,20430,3.1,10.2,5906,2.1,20.4,0,649,649,4473
2012,19780,10611,13547,298209,293009,1319,9.8,1143,8.5,38755,11316,27439,3.9,13.2,28355,9501,18854,3.2,9.7,10400,3.5,19.4,0,655,656,4497
2013,19780,10594,13646,304533,300956,1198,8.8,1071,7.9,34628,10720,23908,3.6,11.5,27474,7685,19789,2.6,9.1,7154,2.4,18.2,0,649,656,5441
2014,19780,10715,13763,310247,306767,1216,8.9,973,7.1,33199,8978,24221,2.9,10.8,26239,7298,18941,2.4,8.6,6960,2.2,17.2,0,628,630,3137
1977,19820,57766,68486,1421006,1366959,10732,15.9,8628,12.8,289672,102139,187533,7.5,21.2,181577,67596,113981,4.9,13.3,108095,7.9,26.6,0,5553,5585,35261
1978,19820,58830,69878,1496733,1450435,9711,14,8294,12,280704,93969,186735,6.5,19.4,188108,71916,116192,5,13,92596,6.4,26,0,5533,5556,32979
1979,19820,59883,71143,1564320,1529494,9457,13.4,7831,11.1,258146,80514,177632,5.3,16.9,188494,66962,121532,4.4,12.3,69652,4.6,24.6,0,5357,5380,34357
1980,19820,60043,71593,1459442,1511054,8755,12.3,8041,11.3,193984,76769,117215,5.1,12.8,297207,69762,227445,4.6,19.7,-103223,-6.9,25.6,0,5523,5542,33085
1981,19820,57936,68837,1367934,1409460,8118,11.6,10185,14.5,203419,87778,115641,6.2,14.4,286471,105522,180949,7.5,20.3,-83052,-5.9,28.8,0,5696,5739,32322
1982,19820,57871,69952,1299000,1332381,9630,13.9,7998,11.5,194341,81463,112878,6.1,14.6,261103,87433,173670,6.6,19.6,-66762,-5,29.2,0,4276,4280,27992
1983,19820,58930,70931,1300651,1305586,8207,11.7,7708,10.9,193770,73214,120556,5.6,14.8,203640,64421,139219,4.9,15.6,-9870,-0.8,29.6,0,4765,4812,28194
1984,19820,61126,73217,1393353,1341401,9416,13.1,7298,10.1,257723,77155,180568,5.8,19.2,153818,64770,89048,4.8,11.5,103905,7.7,23,0,4624,4658,25532
1985,19820,63164,75474,1475479,1431893,9892,13.3,7671,10.3,276861,106114,170747,7.4,19.3,189689,84198,105491,5.9,13.2,87172,6.1,26.4,0,5093,5125,32206
1986,19820,64732,77388,1577157,1526578,10363,13.6,8256,10.8,295491,109471,186020,7.2,19.4,194333,70694,123639,4.6,12.7,101158,6.7,25.4,0,5391,5399,36254
1987,19820,66452,79794,1598738,1593126,11595,14.7,8850,11.3,274140,105599,168541,6.6,17.2,262915,96534,166381,6.1,16.5,11225,0.7,33,0,5685,5741,39335
1988,19820,67065,80820,1613432,1604380,10275,12.8,9105,11.3,279986,114607,165379,7.1,17.5,261883,91453,170430,5.7,16.3,18103,1.2,32.6,0,5802,5802,35169
1989,19820,68353,82751,1661105,1638098,10168,12.4,8413,10.3,275920,92044,183876,5.6,16.8,229907,76113,153794,4.6,14,46013,2.8,28,0,5621,5644,41758.5
1990,19820,69130,83791,1674902,1667842,9805,11.8,8298,10,259394,96699,162695,5.8,15.6,245275,75909,169366,4.6,14.7,14119,0.9,29.4,0,5572,5596,38232
1991,19820,69576,84808,1619548,1647475,9678,11.5,8722,10.3,238216,100737,137479,6.1,14.5,294070,86410,207660,5.2,17.8,-55854,-3.3,29,0,5557,5624,43433
1992,19820,69921,85530,1647578,1633475,9717,11.4,8654,10.1,271228,86047,185181,5.3,16.6,243022,78996,164026,4.8,14.9,28206,1.7,29.8,0,5270,5350,38565
1993,19820,70652,86002,1673781,1659870,9084,10.6,8398,9.8,257205,77594,179611,4.7,15.5,229383,74026,155357,4.5,13.8,27822,1.7,27.6,0,5488,5537,36209
1994,19820,71657,87307,1716404,1696852,9461,10.9,7965,9.2,269475,89733,179742,5.3,15.9,230371,83935,146436,4.9,13.6,39104,2.3,27.2,0,5264,5314,35536
1995,19820,73144,89005,1793700,1754364,10197,11.6,8211,9.3,316444,115416,201028,6.6,18,237772,83412,154360,4.8,13.6,78672,4.4,27.2,0,5302,5325,37740
1996,19820,74569,90821,1821133,1807794,10282,11.4,8351,9.3,283937,96159,187778,5.3,15.7,257259,81138,176121,4.5,14.2,26678,1.5,28.4,0,5492,5492,39027
1997,19820,75444,91798,1868306,1845055,10838,11.9,9865,10.8,345245,117215,228030,6.4,18.7,298743,108430,190313,5.9,16.2,46502,2.5,32.4,0,5810,5810,41356
1998,19820,75675,92379,1919135,1891850,10217,11.1,9349,10.2,315675,118483,197192,6.3,16.7,261105,87346,173759,4.6,13.8,54570,2.9,27.6,0,6058,6058,44825
1999,19820,75771,92972,1946453,1933402,9904,10.7,9229,10,321244,125854,195390,6.5,16.6,295141,99137,196004,5.1,15.3,26103,1.3,30.6,0,5995,5995,45075
2000,19820,75700,93133,1974184,1960255,9792,10.5,9649,10.4,322494,106044,216450,5.4,16.5,294638,107593,187045,5.5,15,27856,1.5,30,0,5649,5649,41958
2001,19820,75589,93578,1950372,1964155,9838,10.5,10044,10.8,324174,122671,201503,6.2,16.5,351741,121182,230559,6.2,17.9,-27567,-1.4,33,0,5726,5727,45631
2002,19820,74900,92648,1898814,1923745,11159,12,11964,12.9,323492,137987,185505,7.2,16.8,373354,137826,235528,7.2,19.4,-49862,-2.6,33.6,0,5854,5874,46141
2003,19820,74881,92564,1883059,1878076,10446,11.3,8950,9.7,315416,121839,193577,6.5,16.8,305452,89197,216255,4.7,16.3,9964,0.5,32.6,0,5776,5855,54918
2004,19820,74953,92281,1880690,1874305,9788,10.6,8963,9.7,290524,105951,184573,5.7,15.5,277755,92957,184798,5,14.8,12769,0.7,29.6,0,5677,5702,45554
2005,19820,75230,92534,1805580,1837688,10171,11,9065,9.8,253982,103500,150482,5.6,13.8,318198,94497,223701,5.1,17.3,-64216,-3.5,27.6,0,5944,5968,58221
2006,19820,74889,92983,1831575,1813884,10313,11.1,9249,10,285783,105712,180071,5.8,15.8,250402,78342,172060,4.3,13.8,35381,2,27.6,0,6289,6310,45406
2007,19820,74066,92373,1747459,1782163,10081,10.9,10369,11.2,257765,96692,161073,5.4,14.5,327172,116913,210259,6.6,18.4,-69407,-3.9,29,0,6501,6590,43678
2008,19820,72611,91272,1719605,1727294,9234,10.1,9540,10.4,263416,102728,160688,5.9,15.3,278793,94333,184460,5.5,16.1,-15377,-0.8,30.6,0,6757,6774,63841
2009,19820,69494,87445,1572499,1640494,7629,8.6,10578,11.9,198212,73868,124344,4.5,12.1,334202,88328,245874,5.4,20.4,-135990,-8.3,24.2,0,6799,6829,50586
2010,19820,67822,85416,1523174,1542788,7533,8.7,8927,10.4,202506,71018,131488,4.6,13.1,241736,74137,167599,4.8,15.7,-39230,-2.6,26.2,0,5757,5764,41414
2011,19820,67613,85439,1586074,1552796,8170,9.6,7785,9.1,243777,67249,176528,4.3,15.7,177221,58843,118378,3.8,11.4,66556,4.3,22.8,0,4971,4980,35374
2012,19820,68833,86490,1637187,1609292,8648,10.1,7648,8.9,251409,73217,178192,4.5,15.6,195621,69025,126596,4.3,12.2,55788,3.4,24.4,0,4444,4480,31505
2013,19820,69347,86731,1677850,1656133,7967,9.2,7724,8.9,237080,71990,165090,4.3,14.3,193646,57435,136211,3.5,11.7,43434,2.6,23.4,0,4655,4665,33255
2014,19820,69540,86840,1714217,1690424,8112,9.4,7384,8.5,243007,63997,179010,3.8,14.4,195421,66170,129251,3.9,11.6,47586,2.8,23.2,0,4869,4889,37862
1977,20020,2077,2229,30328,30090,369,16.8,298,13.6,5662,2133,3529,7.1,18.8,5186,2403,2783,8,17.2,476,1.6,34.4,0,214,214,1484
1978,20020,2182,2345,33535,31965,374,16.4,266,11.6,7387,2694,4693,8.4,23.1,4246,1559,2687,4.9,13.3,3141,9.8,26.6,0,191,191,912
1979,20020,2221,2405,34601,34029,336,14.1,262,11,6376,2728,3648,8,18.7,5231,2143,3088,6.3,15.4,1145,3.3,30.8,0,206,207,1544
1980,20020,2222,2408,35861,35217,328,13.6,312,13,6728,2780,3948,7.9,19.1,5439,2407,3032,6.8,15.4,1289,3.7,30.8,0,225,225,1352
1981,20020,2144,2324,35745,35363,302,12.8,352,14.9,6100,3155,2945,8.9,17.2,5335,2303,3032,6.5,15.1,765,2.1,30.2,0,249,250,1441
1982,20020,2115,2341,36330,36114,313,13.4,267,11.4,6181,2648,3533,7.3,17.1,5748,2489,3259,6.9,15.9,433,1.2,31.8,0,154,154,955
1983,20020,2202,2426,35174,35783,312,13.1,267,11.2,4976,1814,3162,5.1,13.9,6194,1660,4534,4.6,17.3,-1218,-3.4,27.8,0,195,195,1035
1984,20020,2233,2447,37174,36181,292,12,272,11.2,5681,1767,3914,4.9,15.7,3694,1291,2403,3.6,10.2,1987,5.5,20.4,0,188,188,776
1985,20020,2288,2499,39572,38805,311,12.5,270,10.9,6072,1559,4513,4,15.6,4537,1858,2679,4.8,11.7,1535,3.9,23.4,0,191,191,1260
1986,20020,2351,2574,39210,39342,361,14.2,268,10.6,6248,2576,3672,6.5,15.9,6511,2032,4479,5.2,16.5,-263,-0.6,31.8,0,172,172,1039
1987,20020,2473,2744,40459,39196,446,16.7,271,10.2,8218,3610,4608,9.2,21,5692,2237,3455,5.7,14.5,2526,6.5,29,0,169,169,993
1988,20020,2416,2694,40005,39686,328,12.1,341,12.6,7739,3144,4595,7.9,19.5,7100,3452,3648,8.7,17.9,639,1.6,35.8,0,229,229,1257
1989,20020,2470,2772,44103,42060,369,13.5,290,10.6,8891,3870,5021,9.2,21.1,4804,2036,2768,4.8,11.4,4087,9.7,22.8,0,195,195,1170
1990,20020,2513,2827,45476,44726,337,12,266,9.5,7501,2300,5201,5.1,16.8,6001,1973,4028,4.4,13.4,1500,3.4,26.8,0,191,191,998
1991,20020,2534,2868,45286,45498,347,12.2,299,10.5,6847,2645,4202,5.8,15,7271,2788,4483,6.1,16,-424,-1,30,0,202,204,1552
1992,20020,2536,2900,47082,46231,323,11.2,291,10.1,7713,2760,4953,6,16.7,6011,1772,4239,3.8,13,1702,3.7,26,0,206,206,1284
1993,20020,2553,2891,47854,47412,296,10.2,284,9.8,8567,1985,6582,4.2,18.1,7683,3339,4344,7,16.2,884,1.9,32.4,0,179,179,2537
1994,20020,2654,3018,47517,47624,379,12.8,256,8.7,6695,2554,4141,5.4,14.1,6908,2315,4593,4.9,14.5,-213,-0.4,28.2,0,177,178,1276
1995,20020,2703,3047,50020,48768,360,11.9,322,10.6,8080,2364,5716,4.8,16.6,5576,1941,3635,4,11.4,2504,5.2,22.8,0,205,206,980
1996,20020,2787,3159,52432,51196,393,12.7,282,9.1,9383,2309,7074,4.5,18.3,6911,2367,4544,4.6,13.5,2472,4.8,27,0,196,196,1077
1997,20020,2840,3219,52716,52663,414,12.9,361,11.3,9007,4015,4992,7.6,17.1,8900,4482,4418,8.5,16.9,107,0.2,33.8,0,206,206,1145
1998,20020,2839,3238,54750,54709,392,12.1,372,11.5,8677,2651,6026,4.8,15.9,8595,4464,4131,8.2,15.7,82,0.2,31.4,0,258,258,1700
1999,20020,2841,3239,54883,54909,361,11.1,354,10.9,7948,3285,4663,6,14.5,8000,3015,4985,5.5,14.6,-52,-0.1,29,0,244,244,1509
2000,20020,2820,3207,54110,54440,379,11.8,407,12.6,8194,3468,4726,6.4,15.1,8853,4187,4666,7.7,16.3,-659,-1.2,30.2,0,250,250,1393
2001,20020,2850,3241,54026,54270,362,11.2,358,11.1,8025,3597,4428,6.6,14.8,8513,2839,5674,5.2,15.7,-488,-0.9,29.6,0,216,216,1227
2002,20020,2881,3258,61169,57575,395,12.2,377,11.6,15474,3568,11906,6.2,26.9,8286,2743,5543,4.8,14.4,7188,12.5,28.8,0,200,200,1095
2003,20020,2890,3271,60125,60473,364,11.2,285,8.8,9188,3101,6087,5.1,15.2,9883,1761,8122,2.9,16.3,-695,-1.1,30.4,0,210,210,780
2004,20020,2923,3304,58590,58878,362,11,302,9.2,8240,2354,5886,4,14,8816,2619,6197,4.4,15,-576,-1,28,0,195,198,1292
2005,20020,2987,3386,61526,59984,376,11.3,278,8.3,11258,2919,8339,4.9,18.8,8173,2653,5520,4.4,13.6,3085,5.2,27.2,0,223,223,1300
2006,20020,2968,3404,63135,62134,365,10.8,316,9.3,12443,7402,5041,11.9,20,10441,5876,4565,9.5,16.8,2002,3.2,33.6,0,220,220,4611
2007,20020,3039,3489,62620,62847,400,11.6,316,9.2,9332,2912,6420,4.6,14.8,9785,4309,5476,6.9,15.6,-453,-0.8,29.6,0,212,215,1321
2008,20020,3024,3471,58177,59892,311,9,310,8.9,7388,2616,4772,4.4,12.3,10818,6392,4426,10.7,18.1,-3430,-5.8,24.6,0,233,233,1193
2009,20020,2917,3343,52775,55264,234,6.9,319,9.4,4777,1889,2888,3.4,8.6,9754,2641,7113,4.8,17.6,-4977,-9,17.2,0,234,234,2152
2010,20020,2823,3265,51431,52045,228,6.9,277,8.4,5936,1878,4058,3.6,11.4,7163,2104,5059,4,13.8,-1227,-2.4,22.8,0,205,205,876
2011,20020,2767,3219,57511,54360,228,7.1,266,8.2,11900,7909,3991,14.5,21.9,5598,1312,4286,2.4,10.3,6302,11.6,20.6,0,199,199,718
2012,20020,2760,3203,57081,57119,282,8.8,283,8.8,6466,2213,4253,3.9,11.3,6541,2191,4350,3.8,11.5,-75,-0.2,22.6,0,194,197,1205
2013,20020,2727,3167,51102,53920,231,7.3,263,8.3,5032,1924,3108,3.6,9.3,10668,6844,3824,12.7,19.8,-5636,-10.5,18.6,0,179,179,907
2014,20020,2738,3177,51274,51124,237,7.5,209,6.6,5825,1544,4281,3,11.4,5524,1054,4470,2.1,10.8,301,0.6,21.6,0,159,160,775
1977,20100,1561,1712,24173,23527,276,16.7,168,10.1,4422,1919,2503,8.2,18.8,3129,1035,2094,4.4,13.3,1293,5.5,26.6,0,111,111,559
1978,20100,1602,1749,22894,23528,238,13.8,195,11.3,3747,1122,2625,4.8,15.9,5014,3268,1746,13.9,21.3,-1267,-5.4,31.8,0,134,134,568
1979,20100,1634,1782,22767,22802,244,13.8,203,11.5,3450,1242,2208,5.4,15.1,3519,1042,2477,4.6,15.4,-69,-0.3,30.2,0,138,138,590
1980,20100,1622,1764,22533,22631,203,11.5,213,12,3175,1139,2036,5,14,3371,1430,1941,6.3,14.9,-196,-0.9,28,0,154,158,745
1981,20100,1549,1692,23784,23149,184,10.7,246,14.2,4631,1657,2974,7.2,20,3361,1181,2180,5.1,14.5,1270,5.5,29,0,127,128,522
1982,20100,1561,1721,24256,24001,220,12.9,171,10,3555,1534,2021,6.4,14.8,3044,1012,2032,4.2,12.7,511,2.1,25.4,0,100,100,417
1983,20100,1647,1811,24600,24379,228,12.9,161,9.1,3364,1240,2124,5.1,13.8,2922,979,1943,4,12,442,1.8,24,0,97,97,378
1984,20100,1666,1829,26111,25345,211,11.6,193,10.6,5449,1580,3869,6.2,21.5,3916,1316,2600,5.2,15.5,1533,6,31,0,114,114,495
1985,20100,1734,1898,27448,26773,246,13.2,174,9.3,5503,1727,3776,6.5,20.6,4152,2151,2001,8,15.5,1351,5.1,31,0,106,106,863
1986,20100,1791,1964,30077,28726,281,14.6,198,10.3,5960,2135,3825,7.4,20.7,3257,1382,1875,4.8,11.3,2703,9.4,22.6,0,124,124,735
1987,20100,1906,2088,29829,30006,319,15.7,192,9.5,5858,2893,2965,9.6,19.5,6211,1578,4633,5.3,20.7,-353,-1.2,39,0,124,125,748
1988,20100,1898,2090,32446,31140,260,12.4,246,11.8,6735,2249,4486,7.2,21.6,4123,1673,2450,5.4,13.2,2612,8.4,26.4,0,139,139,800
1989,20100,2010,2233,37954,35205,338,15.7,199,9.2,10811,7583,3228,21.5,30.7,5312,1302,4010,3.7,15.1,5499,15.6,30.2,0,139,139,1013
1990,20100,2039,2264,40783,39353,252,11.2,217,9.7,6547,2296,4251,5.8,16.6,3686,1355,2331,3.4,9.4,2861,7.2,18.8,0,147,147,867
1991,20100,2111,2345,33542,36777,311,13.5,226,9.8,4903,1952,2951,5.3,13.3,11373,7063,4310,19.2,30.9,-6470,-17.6,26.6,0,138,141,980
1992,20100,2129,2375,35177,34368,280,11.8,247,10.5,6974,1893,5081,5.5,20.3,5355,1574,3781,4.6,15.6,1619,4.7,31.2,0,142,143,749
1993,20100,2147,2384,33743,34454,234,9.8,224,9.4,4995,1536,3459,4.5,14.5,6417,1275,5142,3.7,18.6,-1422,-4.1,29,0,149,150,674
1994,20100,2151,2394,35341,34539,264,11.1,249,10.4,6263,2820,3443,8.2,18.1,4659,1395,3264,4,13.5,1604,4.6,27,0,155,155,580
1995,20100,2215,2465,37330,36280,304,12.5,220,9.1,5713,2259,3454,6.2,15.7,3613,1478,2135,4.1,10,2100,5.7,20,0,145,145,545
1996,20100,2245,2487,37474,37457,265,10.7,249,10.1,6403,2290,4113,6.1,17.1,6368,2551,3817,6.8,17,35,0.1,34,0,162,162,1094
1997,20100,2258,2531,40036,38752,304,12.1,257,10.2,8584,3898,4686,10.1,22.2,6015,2387,3628,6.2,15.5,2569,6.7,31,0,173,173,1061
1998,20100,2311,2582,38744,39371,286,11.2,235,9.2,5840,2755,3085,7,14.8,7093,2904,4189,7.4,18,-1253,-3.2,29.6,0,149,149,1301
1999,20100,2306,2584,39857,39343,279,10.8,276,10.7,5820,2491,3329,6.3,14.8,4791,1749,3042,4.4,12.2,1029,2.6,24.4,0,174,174,863
2000,20100,2271,2565,41886,40861,263,10.2,279,10.8,7629,3484,4145,8.5,18.7,5578,2803,2775,6.9,13.7,2051,5,27.4,0,151,151,797
2001,20100,2315,2604,43733,42939,276,10.7,273,10.5,6876,2073,4803,4.8,16,5287,1514,3773,3.5,12.3,1589,3.7,24.6,0,149,149,735
2002,20100,2372,2679,45723,44641,363,13.8,283,10.7,8701,4303,4398,9.6,19.5,6536,2251,4285,5,14.6,2165,4.9,29.2,0,133,133,606
2003,20100,2438,2747,46394,45996,311,11.5,212,7.8,7319,2782,4537,6,15.9,6522,3245,3277,7.1,14.2,797,1.7,28.4,0,141,141,893
2004,20100,2489,2826,48136,48216,330,11.9,232,8.3,6672,2571,4101,5.3,13.8,6832,2322,4510,4.8,14.2,-160,-0.4,27.6,0,160,160,1126
2005,20100,2538,2871,49253,48540,335,11.8,258,9.1,6930,2391,4539,4.9,14.3,5504,1708,3796,3.5,11.3,1426,3,22.6,0,168,168,823
2006,20100,2564,2909,49936,49351,361,12.5,290,10.1,8302,3853,4449,7.8,16.8,7131,2312,4819,4.7,14.4,1171,2.4,28.8,0,203,203,1688
2007,20100,2585,2956,48905,49421,334,11.4,284,9.7,6545,2338,4207,4.7,13.2,7576,2094,5482,4.2,15.3,-1031,-2.1,26.4,0,187,187,1369
2008,20100,2591,2983,49140,48991,339,11.5,290,9.8,6911,2637,4274,5.4,14.1,6612,1824,4788,3.7,13.5,299,0.6,27,0,219,219,1346
2009,20100,2472,2848,47633,48243,251,8.6,336,11.6,6670,3878,2792,8,13.8,7889,2546,5343,5.3,16.4,-1219,-2.6,27.6,0,221,221,1012
2010,20100,2461,2854,45720,46596,272,9.6,264,9.3,4506,1831,2675,3.9,9.7,6257,1548,4709,3.3,13.4,-1751,-3.7,19.4,0,178,178,852
2011,20100,2416,2798,47033,46305,250,8.9,277,9.8,6197,1795,4402,3.9,13.4,4740,1355,3385,2.9,10.2,1457,3.2,20.4,0,192,192,924
2012,20100,2444,2832,46981,46945,323,11.5,281,10,5259,1822,3437,3.9,11.2,5187,1686,3501,3.6,11,72,0.2,22,0,173,173,1042
2013,20100,2459,2852,47039,46832,271,9.6,242,8.5,4836,1482,3354,3.2,10.3,4422,1022,3400,2.2,9.4,414,0.9,18.8,0,169,169,700
2014,20100,2467,2878,48935,47850,297,10.4,249,8.7,6315,2639,3676,5.5,13.2,4145,1222,2923,2.6,8.7,2170,4.5,17.4,0,167,167,893
1977,20220,1737,1880,36032,34919,289,15.7,197,10.7,5315,1644,3671,4.7,15.2,3088,1110,1978,3.2,8.8,2227,6.4,17.6,0,128,128,595
1978,20220,1775,1933,39802,37911,258,13.5,201,10.5,6707,1450,5257,3.8,17.7,2925,1142,1783,3,7.7,3782,10,15.4,0,140,140,759
1979,20220,1828,2000,40629,40203,242,12.3,165,8.4,4324,1553,2771,3.9,10.8,3472,1039,2433,2.6,8.6,852,2.2,17.2,0,118,118,532
1980,20220,1818,1987,40843,40684,212,10.6,219,11,4258,1418,2840,3.5,10.5,3940,1009,2931,2.5,9.7,318,0.8,19.4,0,160,160,651
1981,20220,1778,1941,37290,38929,196,10,234,11.9,3417,1544,1873,4,8.8,6695,1397,5298,3.6,17.2,-3278,-8.4,17.6,0,140,141,662
1982,20220,1755,1925,36183,36817,195,10.1,183,9.5,4245,1497,2748,4.1,11.5,5514,1165,4349,3.2,15,-1269,-3.5,23,0,95,95,446
1983,20220,1767,1938,32546,34356,163,8.4,179,9.3,3571,1321,2250,3.8,10.4,7191,1228,5963,3.6,20.9,-3620,-10.5,20.8,0,111,111,624
1984,20220,1799,1975,34415,33362,215,11,179,9.2,5846,1666,4180,5,17.5,3739,1073,2666,3.2,11.2,2107,6.3,22.4,0,113,114,464
1985,20220,1780,1965,35036,34737,194,9.8,203,10.3,3920,1289,2631,3.7,11.3,3322,1132,2190,3.3,9.6,598,1.7,19.2,0,141,141,724
1986,20220,1811,1991,37935,36480,213,10.8,182,9.2,6488,1858,4630,5.1,17.8,3577,1458,2119,4,9.8,2911,8,19.6,0,120,120,558
1987,20220,1812,1995,35630,36559,200,10,189,9.5,4645,1697,2948,4.6,12.7,6503,2292,4211,6.3,17.8,-1858,-5.1,25.4,0,120,120,1021
1988,20220,1805,2008,39102,37293,176,8.8,156,7.8,7418,2013,5405,5.4,19.9,3799,997,2802,2.7,10.2,3619,9.7,20.4,0,107,107,467
1989,20220,1829,2039,40506,39955,204,10.1,170,8.4,4756,1603,3153,4,11.9,3654,1129,2525,2.8,9.1,1102,2.8,18.2,0,126,126,824
1990,20220,1868,2092,41203,40829,213,10.3,153,7.4,4696,1589,3107,3.9,11.5,3947,1196,2751,2.9,9.7,749,1.8,19.4,0,108,109,749
1991,20220,1936,2184,41336,41359,225,10.5,145,6.8,4501,1687,2814,4.1,10.9,4546,882,3664,2.1,11,-45,-0.1,21.8,0,98,98,496
1992,20220,1968,2226,41904,41630,242,11,189,8.6,5458,1698,3760,4.1,13.1,4909,1880,3029,4.5,11.8,549,1.3,23.6,0,122,122,789
1993,20220,1959,2224,43449,42702,180,8.1,176,7.9,5803,1650,4153,3.9,13.6,4308,1289,3019,3,10.1,1495,3.5,20.2,0,123,123,857
1994,20220,1974,2247,44297,43849,201,9,172,7.7,4941,1749,3192,4,11.3,4044,1337,2707,3,9.2,897,2.1,18.4,0,126,126,1082
1995,20220,1999,2264,46481,45306,192,8.5,168,7.5,5338,983,4355,2.2,11.8,2987,844,2143,1.9,6.6,2351,5.2,13.2,0,117,117,564
1996,20220,2055,2318,46136,46393,217,9.5,157,6.9,4582,1104,3478,2.4,9.9,5095,1363,3732,2.9,11,-513,-1.1,19.8,0,101,101,466
1997,20220,2068,2352,47559,46863,233,10,199,8.5,6870,3125,3745,6.7,14.7,5478,963,4515,2.1,11.7,1392,3,23.4,0,122,122,531
1998,20220,2062,2346,46557,47035,194,8.3,198,8.4,4707,1192,3515,2.5,10,5663,2359,3304,5,12,-956,-2,20,0,129,129,1096
1999,20220,2070,2347,47576,47050,194,8.3,190,8.1,5745,2068,3677,4.4,12.2,4693,1408,3285,3,10,1052,2.2,20,0,126,126,850
2000,20220,2114,2399,49366,48459,210,8.9,163,6.9,6904,2353,4551,4.9,14.2,5090,1401,3689,2.9,10.5,1814,3.7,21,0,99,99,773
2001,20220,2103,2405,48310,48864,197,8.2,200,8.3,6230,2321,3909,4.7,12.7,7338,1874,5464,3.8,15,-1108,-2.3,25.4,0,119,119,934
2002,20220,2105,2409,49712,49017,233,9.7,226,9.4,8825,5691,3134,11.6,18,7435,2372,5063,4.8,15.2,1390,2.8,30.4,0,104,104,626
2003,20220,2129,2422,48710,49092,209,8.7,162,6.7,4793,1419,3374,2.9,9.8,5556,1277,4279,2.6,11.3,-763,-1.5,19.6,0,91,91,906
2004,20220,2169,2468,47084,46528,215,8.8,156,6.4,5271,1858,3413,4,11.3,4158,1031,3127,2.2,8.9,1113,2.4,17.8,0,104,104,667
2005,20220,2183,2476,47844,47101,186,7.5,162,6.6,5541,1156,4385,2.5,11.8,4054,864,3190,1.8,8.6,1487,3.2,17.2,0,107,107,526
2006,20220,2190,2509,50092,48914,248,10,191,7.7,7318,3245,4073,6.6,15,4961,1519,3442,3.1,10.1,2357,4.9,20.2,0,116,116,811
2007,20220,2200,2524,49842,50225,213,8.5,199,7.9,5574,1766,3808,3.5,11.1,6339,2015,4324,4,12.6,-765,-1.5,22.2,0,118,118,603
2008,20220,2162,2484,49282,49294,186,7.5,195,7.8,5006,1434,3572,2.9,10.2,5030,1507,3523,3.1,10.2,-24,0,20.4,0,133,133,996
2009,20220,2138,2460,50627,49999,170,6.9,189,7.7,6601,1861,4740,3.7,13.2,5345,1357,3988,2.7,10.7,1256,2.5,21.4,0,115,115,869
2010,20220,2160,2490,48981,49748,195,7.9,147,6,5005,1760,3245,3.5,10.1,6538,1042,5496,2.1,13.1,-1533,-3,20.2,0,86,86,565
2011,20220,2122,2455,49823,49182,151,6.1,183,7.4,5330,1129,4201,2.3,10.8,4048,776,3272,1.6,8.2,1282,2.6,16.4,0,106,106,483
2012,20220,2167,2513,51813,50720,193,7.8,132,5.3,6349,1902,4447,3.8,12.5,4163,1223,2940,2.4,8.2,2186,4.3,16.4,0,69,69,352
2013,20220,2157,2503,50915,51392,150,6,168,6.7,3989,576,3413,1.1,7.8,4942,1420,3522,2.8,9.6,-953,-1.8,15.6,0,96,96,655
2014,20220,2135,2496,52352,51616,154,6.2,151,6.1,4801,1779,3022,3.4,9.3,3328,781,2547,1.5,6.4,1473,2.9,12.8,0,101,101,356
1977,20260,4706,5313,78050,77826,793,15.1,630,12,13664,5967,7697,7.7,17.6,13216,6027,7189,7.7,17,448,0.6,34,0,416,418,3214
1978,20260,4792,5427,82335,80154,704,13.1,584,10.9,15811,5457,10354,6.8,19.7,11449,4639,6810,5.8,14.3,4362,5.4,28.6,0,411,414,2032
1979,20260,4845,5503,87815,85034,683,12.5,589,10.8,17247,5042,12205,5.9,20.3,11685,4180,7505,4.9,13.7,5562,6.6,27.4,0,399,399,2010
1980,20260,4852,5506,86853,87322,557,10.1,544,9.9,10766,3818,6948,4.4,12.3,11704,3759,7945,4.3,13.4,-938,-1.1,24.6,0,374,375,1984
1981,20260,4719,5337,82959,83810,551,10.2,655,12.1,12302,6043,6259,7.2,14.7,14003,4498,9505,5.4,16.7,-1701,-2,29.4,0,375,376,2134
1982,20260,4622,5305,75065,78882,588,11,527,9.9,9063,4153,4910,5.3,11.5,16697,3798,12899,4.8,21.2,-7634,-9.7,23,0,286,286,1314
1983,20260,4743,5410,68343,71460,514,9.6,478,8.9,9470,3779,5691,5.3,13.3,15704,4142,11562,5.8,22,-6234,-8.7,26.6,0,287,289,1605
1984,20260,4891,5546,71395,69937,697,12.7,569,10.4,12702,4259,8443,6.1,18.2,9785,4516,5269,6.5,14,2917,4.2,28,0,361,362,2421
1985,20260,4939,5569,72329,72381,626,11.2,615,11,10779,4790,5989,6.6,14.9,10882,3908,6974,5.4,15,-103,-0.1,29.8,0,392,393,2358
1986,20260,4875,5505,70269,71206,576,10.4,616,11.1,9874,3859,6015,5.4,13.9,11747,4120,7627,5.8,16.5,-1873,-2.6,27.8,0,393,393,2274
1987,20260,4976,5637,72363,71851,649,11.6,512,9.2,13059,4800,8259,6.7,18.2,12034,5248,6786,7.3,16.7,1025,1.5,33.4,0,309,311,2695
1988,20260,4974,5661,77192,74185,612,10.9,546,9.7,16375,5612,10763,7.6,22.1,10361,4625,5736,6.2,14,6014,8.1,28,0,348,348,1854
1989,20260,5071,5772,80003,78776,597,10.4,491,8.6,12034,3542,8492,4.5,15.3,9579,3311,6268,4.2,12.2,2455,3.1,24.4,0,328,328,1687
1990,20260,5141,5843,81889,80910,554,9.5,462,8,11821,4263,7558,5.3,14.6,9862,4471,5391,5.5,12.2,1959,2.4,24.4,0,306,306,2145
1991,20260,5238,6002,84144,83113,598,10.1,455,7.7,12991,4609,8382,5.5,15.6,10928,3971,6957,4.8,13.1,2063,2.5,26.2,0,299,299,2179
1992,20260,5255,6039,85261,84605,568,9.4,498,8.3,12345,4353,7992,5.1,14.6,11033,3523,7510,4.2,13,1312,1.6,26,0,327,328,1647
1993,20260,5356,6140,87025,86056,564,9.3,451,7.4,12629,5062,7567,5.9,14.7,10690,3352,7338,3.9,12.4,1939,2.3,24.8,0,304,305,1646
1994,20260,5428,6229,87348,86915,573,9.3,459,7.4,11790,3882,7908,4.5,13.6,10923,3268,7655,3.8,12.6,867,1,25.2,0,303,306,1886
1995,20260,5488,6306,89314,88335,597,9.5,508,8.1,11958,4472,7486,5.1,13.5,9999,3273,6726,3.7,11.3,1959,2.2,22.6,0,339,340,1950
1996,20260,5579,6397,92580,90969,612,9.6,523,8.2,12795,5464,7331,6,14.1,9572,3426,6146,3.8,10.5,3223,3.6,21,0,354,354,2031
1997,20260,5665,6514,93459,93316,658,10.2,539,8.3,13415,4702,8713,5,14.4,13128,5560,7568,6,14.1,287,0.3,28.2,0,329,329,2627
1998,20260,5665,6519,95148,94138,586,9,560,8.6,12832,4761,8071,5.1,13.6,10812,3411,7401,3.6,11.5,2020,2.1,23,0,380,380,2204
1999,20260,5646,6549,101196,99464,585,8.9,558,8.5,13288,4267,9021,4.3,13.4,9823,3588,6235,3.6,9.9,3465,3.5,19.8,0,360,360,1917
2000,20260,5624,6531,102822,101424,513,7.8,538,8.2,12909,4252,8657,4.2,12.7,10112,2877,7235,2.8,10,2797,2.7,20,0,334,334,1531
2001,20260,5647,6631,102004,102835,612,9.3,564,8.6,13334,5079,8255,4.9,13,14995,5916,9079,5.8,14.6,-1661,-1.6,26,0,334,334,2291
2002,20260,5626,6598,100280,101109,646,9.8,673,10.2,14505,5785,8720,5.7,14.3,16162,6030,10132,6,16,-1657,-1.7,28.6,0,343,343,2151
2003,20260,5623,6605,104292,101553,597,9.1,481,7.3,16311,6185,10126,6.1,16.1,10833,3137,7696,3.1,10.7,5478,5.4,21.4,0,311,311,1843
2004,20260,5659,6688,103546,103733,596,9,475,7.2,13901,5355,8546,5.2,13.4,14275,5427,8848,5.2,13.8,-374,-0.4,26.8,0,310,310,2117
2005,20260,5684,6711,103170,103157,580,8.7,517,7.7,12386,4198,8188,4.1,12,12359,3415,8944,3.3,12,27,0,24,0,339,339,2110
2006,20260,5689,6769,105598,104299,646,9.6,548,8.1,14228,4987,9241,4.8,13.6,11630,3846,7784,3.7,11.2,2598,2.4,22.4,0,350,350,2635
2007,20260,5704,6815,109942,107654,590,8.7,547,8.1,16576,6264,10312,5.8,15.4,11999,3720,8279,3.5,11.1,4577,4.3,22.2,0,319,320,1463
2008,20260,5638,6777,109991,109746,547,8.1,520,7.7,14114,3851,10263,3.5,12.9,13623,3137,10486,2.9,12.4,491,0.5,24.8,0,351,351,2176
2009,20260,5498,6624,103532,106591,451,6.7,584,8.7,9286,3016,6270,2.8,8.7,15403,4071,11332,3.8,14.5,-6117,-5.8,17.4,0,325,325,1777
2010,20260,5469,6609,106059,106152,449,6.8,450,6.8,11749,3378,8371,3.2,11.1,11934,4492,7442,4.2,11.2,-185,-0.1,22.2,0,271,271,1598
2011,20260,5349,6487,104204,105041,425,6.5,521,8,10410,2685,7725,2.6,9.9,12083,3032,9051,2.9,11.5,-1673,-1.6,19.8,0,320,320,2257
2012,20260,5320,6457,106690,105383,445,6.9,489,7.6,13208,3332,9876,3.2,12.5,10593,2907,7686,2.8,10.1,2615,2.4,20.2,0,272,273,1546
2013,20260,5243,6386,107150,106823,407,6.4,468,7.3,12540,3122,9418,2.9,11.7,11886,3088,8798,2.9,11.1,654,0.6,22.2,0,278,278,2130
2014,20260,5164,6298,108236,107565,402,6.4,455,7.2,10420,2087,8333,1.9,9.7,9078,2544,6534,2.4,8.4,1342,1.3,16.8,0,298,303,1917
1977,20500,4176,4663,91487,90464,788,17.3,549,12.1,13515,6050,7465,6.7,14.9,11469,4624,6845,5.1,12.7,2046,2.2,25.4,0,379,379,3161
1978,20500,4309,4797,97268,94373,687,14.5,547,11.6,14942,5278,9664,5.6,15.8,9151,3507,5644,3.7,9.7,5791,6.1,19.4,0,390,390,1890
1979,20500,4364,4882,103737,100455,677,14,560,11.6,16457,5187,11270,5.2,16.4,9893,4413,5480,4.4,9.8,6564,6.6,19.6,0,395,395,2361
1980,20500,4443,4964,108586,105996,641,13,529,10.7,16009,4183,11826,3.9,15.1,10829,3157,7672,3,10.2,5180,4.9,20.4,0,381,381,2069
1981,20500,4381,4895,109107,106923,606,12.3,626,12.7,18803,7040,11763,6.6,17.6,14435,4744,9691,4.4,13.5,4368,4.1,27,0,380,381,2005
1982,20500,4535,5094,113161,111045,769,15.4,520,10.4,17192,5815,11377,5.2,15.5,12960,3340,9620,3,11.7,4232,3.8,23.4,0,317,317,1532
1983,20500,4405,4970,109456,111204,628,12.5,694,13.8,13093,4270,8823,3.8,11.8,16588,4860,11728,4.4,14.9,-3495,-3.1,23.6,0,387,387,2176
1984,20500,5026,5619,119924,114841,866,16.4,323,6.1,23733,5426,18307,4.7,20.7,13567,5177,8390,4.5,11.8,10166,8.9,23.6,0,8,9,50
1985,20500,5308,5943,128968,126530,914,15.8,615,10.6,21854,8300,13554,6.6,17.3,16977,5107,11870,4,13.4,4877,3.9,26.8,0,402,402,2300
1986,20500,5649,6330,137982,133217,1002,16.3,580,9.5,22257,8768,13489,6.6,16.7,12726,4149,8577,3.1,9.6,9531,7.1,19.2,0,367,368,2036
1987,20500,5834,6550,137868,138754,999,15.5,757,11.7,20328,7897,12431,5.7,14.7,22099,8605,13494,6.2,15.9,-1771,-1.2,29.4,0,469,470,3189
1988,20500,5946,6773,149204,143405,1012,15.2,760,11.4,29777,9701,20076,6.8,20.8,18178,6532,11646,4.6,12.7,11599,8.1,25.4,0,509,509,2427
1989,20500,6068,6949,148015,148839,897,13.1,729,10.6,24300,8848,15452,5.9,16.3,25947,6771,19176,4.5,17.4,-1647,-1.1,32.6,0,461,461,2297
1990,20500,6218,7175,156469,152109,952,13.5,665,9.4,28218,6368,21850,4.2,18.6,19498,8154,11344,5.4,12.8,8720,5.8,25.6,0,458,463,6504
1991,20500,6382,7427,149221,152842,986,13.5,724,9.9,20700,9192,11508,6,13.5,27941,5561,22380,3.6,18.3,-7241,-4.8,27,0,460,463,3179
1992,20500,6509,7587,157698,153311,980,13,800,10.6,28952,7433,21519,4.8,18.9,20178,5934,14244,3.9,13.2,8774,5.7,26.4,0,485,487,2720
1993,20500,6636,7694,161605,159687,844,11,719,9.4,22381,5950,16431,3.7,14,18545,4217,14328,2.6,11.6,3836,2.4,23.2,0,473,473,1998
1994,20500,6797,7854,171952,166595,918,11.8,728,9.4,25921,7450,18471,4.5,15.6,15206,4654,10552,2.8,9.1,10715,6.5,18.2,0,474,474,2551
1995,20500,7088,8220,189357,180779,1091,13.6,712,8.9,35037,13715,21322,7.6,19.4,17881,5431,12450,3,9.9,17156,9.5,19.8,0,478,478,3405
1996,20500,7287,8458,192867,191297,1067,12.8,814,9.8,28492,7969,20523,4.2,14.9,25351,5792,19559,3,13.3,3141,1.6,26.6,0,528,528,2956
1997,20500,7635,8831,205826,201738,1235,14.3,876,10.1,34961,10726,24235,5.3,17.3,26784,8751,18033,4.3,13.3,8177,4,26.6,0,538,538,3138
1998,20500,7801,9042,212814,209196,1175,13.1,935,10.5,32204,12455,19749,6,15.4,24968,8146,16822,3.9,11.9,7236,3.5,23.8,0,602,602,3603
1999,20500,7881,9169,215573,214218,1067,11.7,932,10.2,30857,8974,21883,4.2,14.4,28146,7206,20940,3.4,13.1,2711,1.3,26.2,0,581,581,2996
2000,20500,7928,9247,219265,215628,1090,11.8,1019,11.1,33148,10114,23034,4.7,15.4,25874,8175,17699,3.8,12,7274,3.4,24,0,569,569,3556
2001,20500,8053,9471,229797,224725,1136,12.1,968,10.3,36708,11996,24712,5.3,16.3,26564,9230,17334,4.1,11.8,10144,4.5,23.6,0,543,543,2840
2002,20500,8114,9526,227184,228414,1243,13.1,1176,12.4,41222,19431,21791,8.5,18,43682,16356,27326,7.2,19.1,-2460,-1.1,36,0,567,568,3684
2003,20500,8198,9658,215224,219844,1249,13.1,896,9.4,27121,10092,17029,4.6,12.3,36361,8547,27814,3.9,16.5,-9240,-4.2,24.6,0,596,596,3741
2004,20500,8257,9722,219975,217054,1083,11.2,902,9.3,32834,9265,23569,4.3,15.1,26992,9979,17013,4.6,12.4,5842,2.7,24.8,0,572,573,3411
2005,20500,8479,10009,219419,218988,1191,12.1,792,8,28357,10348,18009,4.7,12.9,27494,6801,20693,3.1,12.6,863,0.3,25.2,0,512,513,3146
2006,20500,8678,10309,233848,226121,1329,13.1,947,9.3,38458,14930,23528,6.6,17,23004,7052,15952,3.1,10.2,15454,6.8,20.4,0,636,636,3861
2007,20500,8769,10432,230964,231303,1186,11.5,1028,9.9,30332,10494,19838,4.5,13.1,31010,8350,22660,3.6,13.4,-678,-0.3,26.2,0,627,633,3585
2008,20500,8804,10492,235055,232899,1058,10.2,883,8.5,30411,11739,18672,5,13.1,26099,5496,20603,2.4,11.2,4312,1.9,22.4,0,637,637,3159
2009,20500,8717,10388,225576,229641,1001,9.6,1029,9.9,22617,7520,15097,3.3,9.8,30747,7939,22808,3.5,13.4,-8130,-3.6,19.6,0,672,672,3805
2010,20500,8709,10443,217187,220850,1053,10.1,918,8.8,24555,11345,13210,5.1,11.1,31880,14534,17346,6.6,14.4,-7325,-3.3,22.2,0,596,596,3563
2011,20500,8640,10383,219881,218182,986,9.5,946,9.1,24557,9513,15044,4.4,11.3,21159,6556,14603,3,9.7,3398,1.6,19.4,0,621,623,4499
2012,20500,8728,10506,224211,221892,1051,10.1,924,8.9,26739,7636,19103,3.4,12.1,22101,6614,15487,3,10,4638,2.1,20,0,536,537,2676
2013,20500,8778,10594,223380,223437,1023,9.7,920,8.8,25798,12034,13764,5.4,11.5,25911,9233,16678,4.1,11.6,-113,-0.1,23,0,563,563,3491
2014,20500,8866,10695,231689,226835,1070,10.1,882,8.3,30216,7004,23212,3.1,13.3,20508,6913,13595,3,9,9708,4.3,18,0,606,606,2831
1977,20740,2178,2335,32781,32139,375,16.4,257,11.3,5766,2535,3231,7.9,17.9,4481,1758,2723,5.5,13.9,1285,4,27.8,0,165,166,758
1978,20740,2313,2476,34914,33824,369,15.3,233,9.7,6093,2076,4017,6.1,18,3912,1966,1946,5.8,11.6,2181,6.4,23.2,0,149,149,864
1979,20740,2382,2560,36892,35879,332,13.2,238,9.5,6692,2912,3780,8.1,18.7,4666,1612,3054,4.5,13,2026,5.7,26,0,170,170,694
1980,20740,2368,2549,36328,36662,289,11.3,288,11.3,5369,2370,2999,6.5,14.6,6037,2100,3937,5.7,16.5,-668,-1.9,29.2,0,190,193,659
1981,20740,2346,2515,36019,35941,288,11.4,304,12,5172,1804,3368,5,14.4,5016,1998,3018,5.6,14,156,0.4,28,0,169,170,1107
1982,20740,2366,2563,36500,36283,339,13.3,248,9.8,5371,2631,2740,7.3,14.8,4937,1482,3455,4.1,13.6,434,1.2,27.2,0,149,149,665
1983,20740,2441,2628,35454,36121,272,10.5,239,9.2,4426,1937,2489,5.4,12.3,5759,1954,3805,5.4,15.9,-1333,-3.6,24.6,0,148,148,690
1984,20740,2525,2718,36428,35958,342,12.8,252,9.4,5358,2169,3189,6,14.9,4417,1389,3028,3.9,12.3,941,2.6,24.6,0,158,158,644
1985,20740,2536,2732,37700,36980,322,11.8,286,10.5,5780,2048,3732,5.5,15.6,4340,1630,2710,4.4,11.7,1440,3.9,23.4,0,190,190,925
1986,20740,2410,2612,38502,37874,285,10.7,363,13.6,6794,2344,4450,6.2,17.9,5537,2789,2748,7.4,14.6,1257,3.3,29.2,0,201,201,1003
1987,20740,2630,2904,42476,40694,454,16.4,184,6.7,7819,3386,4433,8.3,19.2,4254,1058,3196,2.6,10.5,3565,8.7,21,0,48,48,210
1988,20740,2661,2939,43525,42888,331,11.3,279,9.6,7019,2351,4668,5.5,16.4,5744,1985,3759,4.6,13.4,1275,3,26.8,0,178,178,1015
1989,20740,2661,2964,45937,44745,320,10.8,295,10,7769,3094,4675,6.9,17.4,5385,2185,3200,4.9,12,2384,5.4,24,0,186,187,1273
1990,20740,2718,3023,47124,46540,338,11.3,265,8.9,6621,2867,3754,6.2,14.2,5452,1402,4050,3,11.7,1169,2.5,23.4,0,174,174,876
1991,20740,2751,3097,47324,47090,337,11,257,8.4,6320,2361,3959,5,13.4,5851,2215,3636,4.7,12.4,469,1,24.8,0,190,190,1611
1992,20740,2798,3157,49863,48679,327,10.4,262,8.4,8612,2491,6121,5.1,17.7,6243,2870,3373,5.9,12.8,2369,4.9,25.6,0,160,161,928
1993,20740,2828,3179,50078,49959,303,9.6,274,8.6,8212,2411,5801,4.8,16.4,7974,3120,4854,6.2,16,238,0.4,32,0,188,193,1651
1994,20740,2856,3227,50136,50082,329,10.3,267,8.3,6636,2796,3840,5.6,13.3,6528,2149,4379,4.3,13,108,0.3,26,0,183,183,1268
1995,20740,2950,3319,53826,52306,347,10.6,249,7.6,7802,2709,5093,5.2,14.9,4762,1414,3348,2.7,9.1,3040,5.8,18.2,0,153,160,752
1996,20740,2983,3372,56399,55128,325,9.7,261,7.8,9532,4367,5165,7.9,17.3,6989,2164,4825,3.9,12.7,2543,4.6,25.4,0,166,166,812
1997,20740,3009,3397,56811,56562,338,10,310,9.2,8490,3081,5409,5.4,15,7992,2060,5932,3.6,14.1,498,0.9,28.2,0,181,181,790
1998,20740,3048,3447,59424,58048,361,10.6,298,8.7,9240,3634,5606,6.3,15.9,6487,2312,4175,4,11.2,2753,4.7,22.4,0,204,204,1532
1999,20740,3086,3492,62446,60953,315,9.1,273,7.9,9978,2661,7317,4.4,16.4,6991,2080,4911,3.4,11.5,2987,4.9,23,0,184,184,1173
2000,20740,3111,3553,64068,63196,358,10.2,293,8.3,9369,3558,5811,5.6,14.8,7625,2539,5086,4,12.1,1744,2.7,24.2,0,182,182,1095
2001,20740,3128,3594,64385,64328,321,9,319,8.9,8753,3114,5639,4.8,13.6,8639,2726,5913,4.2,13.4,114,0.2,26.8,0,186,187,1031
2002,20740,3133,3601,64141,64248,391,10.9,384,10.7,10074,4531,5543,7.1,15.7,10287,3097,7190,4.8,16,-213,-0.3,31.4,0,194,194,1037
2003,20740,3148,3622,64738,64030,342,9.5,277,7.7,8708,3099,5609,4.8,13.6,7291,2235,5056,3.5,11.4,1417,2.2,22.8,0,188,188,1432
2004,20740,3160,3636,64798,64434,335,9.3,286,7.9,8626,3222,5404,5,13.4,7898,2717,5181,4.2,12.3,728,1.1,24.6,0,178,179,1462
2005,20740,3225,3724,67482,65949,375,10.2,266,7.2,10756,3129,7627,4.7,16.3,7690,2546,5144,3.9,11.7,3066,4.6,23.4,0,200,200,1845
2006,20740,3199,3722,68442,67723,366,9.9,329,8.9,10145,3914,6231,5.8,15,8707,2681,6026,4,12.9,1438,2.1,25.8,0,219,220,1578
2007,20740,3231,3760,68415,68387,398,10.7,353,9.4,8211,2532,5679,3.7,12,8155,2590,5565,3.8,11.9,56,0.1,23.8,0,209,210,1341
2008,20740,3189,3732,68772,68448,319,8.5,314,8.4,7732,2143,5589,3.1,11.3,7084,2077,5007,3,10.3,648,1,20.6,0,210,210,1506
2009,20740,3152,3714,66169,67378,314,8.5,299,8,5815,2247,3568,3.3,8.6,8232,1593,6639,2.4,12.2,-2417,-3.6,17.2,0,200,200,949
2010,20740,3200,3785,67368,66502,337,9,234,6.3,8823,2999,5824,4.5,13.3,7090,1912,5178,2.9,10.7,1733,2.6,21.4,0,144,144,1014
2011,20740,3167,3760,68474,67855,286,7.6,296,7.9,7320,1865,5455,2.7,10.8,6081,1817,4264,2.7,9,1239,1.8,18,0,196,196,1067
2012,20740,3253,3830,69771,69108,376,9.9,307,8.1,9764,3162,6602,4.6,14.1,8437,2206,6231,3.2,12.2,1327,1.9,24.4,0,184,185,1072
2013,20740,3270,3822,69590,69520,313,8.2,295,7.8,7484,2252,5232,3.2,10.8,7344,2260,5084,3.3,10.6,140,0.2,21.2,0,176,176,1282
2014,20740,3238,3784,70833,69975,301,7.9,309,8.2,7842,2877,4965,4.1,11.2,6125,2126,3999,3,8.8,1717,2.4,17.6,0,213,214,1621
1977,20940,1482,1622,15165,14925,281,17.7,202,12.7,3707,2191,1516,14.7,24.8,3226,1502,1724,10.1,21.6,481,3.2,43.2,0,127,128,1057
1978,20940,1496,1638,15083,15119,238,14.6,225,13.8,3158,1089,2069,7.2,20.9,3230,1860,1370,12.3,21.4,-72,-0.5,41.8,0,140,140,1202
1979,20940,1512,1652,17308,16207,220,13.4,197,12,5345,2775,2570,17.1,33,3143,1187,1956,7.3,19.4,2202,13.6,38.8,0,130,130,701
1980,20940,1536,1683,18612,17956,247,14.8,214,12.8,4351,1682,2669,9.4,24.2,3039,1193,1846,6.6,16.9,1312,7.3,33.8,0,149,149,664
1981,20940,1531,1671,16580,17212,274,16.4,257,15.4,3790,2103,1687,12.2,22,5054,1638,3416,9.5,29.4,-1264,-7.4,44,0,168,168,936
1982,20940,1508,1680,17248,16954,252,15,220,13.1,4071,1589,2482,9.4,24,3482,1408,2074,8.3,20.5,589,3.5,41,0,118,118,538
1983,20940,1521,1700,15906,16562,216,12.8,209,12.4,3090,1482,1608,8.9,18.7,4402,1335,3067,8.1,26.6,-1312,-7.9,37.4,0,141,141,674
1984,20940,1500,1677,17438,16721,192,11.4,216,12.8,4973,1261,3712,7.5,29.7,3538,2147,1391,12.8,21.2,1435,8.5,42.4,0,133,133,1520
1985,20940,1513,1683,16824,17244,193,11.5,184,10.9,3167,1150,2017,6.7,18.4,4006,1293,2713,7.5,23.2,-839,-4.8,36.8,0,109,110,641
1986,20940,1538,1704,17845,17326,220,13,191,11.3,3720,1337,2383,7.7,21.5,2681,892,1789,5.1,15.5,1039,6,31,0,125,125,549
1987,20940,1565,1727,17954,17810,230,13.4,189,11,4043,1728,2315,9.7,22.7,3754,1179,2575,6.6,21.1,289,1.6,42.2,0,117,117,604
1988,20940,1580,1744,18119,17906,194,11.2,177,10.2,3485,1352,2133,7.6,19.5,3058,989,2069,5.5,17.1,427,2.4,34.2,0,105,105,491
1989,20940,1694,1864,22576,20424,247,13.7,133,7.4,6637,2137,4500,10.5,32.5,2333,950,1383,4.7,11.4,4304,21.1,22.8,0,90,90,664
1990,20940,1736,1917,24956,23213,267,14.1,186,9.8,7139,2072,5067,8.9,30.8,3653,1495,2158,6.4,15.7,3486,15.1,31.4,0,128,128,1015
1991,20940,1805,1986,23467,24008,272,13.9,206,10.6,5429,2741,2688,11.4,22.6,6511,1668,4843,6.9,27.1,-1082,-4.5,45.2,0,133,133,906
1992,20940,1825,2010,23525,23405,259,12.9,228,11.4,4911,1642,3269,7,21,4670,1668,3002,7.1,20,241,1,40,0,155,155,1010
1993,20940,1806,1989,23009,23094,220,11,239,12,5474,2327,3147,10.1,23.7,5644,1807,3837,7.8,24.4,-170,-0.7,47.4,0,177,178,1019
1994,20940,1777,1964,22551,22599,214,10.8,236,11.9,4007,1614,2393,7.1,17.7,4103,1851,2252,8.2,18.2,-96,-0.5,35.4,0,155,156,863
1995,20940,1798,1982,23019,22962,251,12.7,217,11,4404,2396,2008,10.4,19.2,4290,1628,2662,7.1,18.7,114,0.5,37.4,0,162,164,771
1996,20940,1821,2011,22218,22678,246,12.3,204,10.2,3761,1353,2408,6,16.6,4680,1181,3499,5.2,20.6,-919,-4,33.2,0,150,150,614
1997,20940,1836,2032,21978,22142,237,11.7,218,10.8,4367,1878,2489,8.5,19.7,4694,1945,2749,8.8,21.2,-327,-1.5,39.4,0,144,144,986
1998,20940,1830,2025,22060,21973,215,10.6,210,10.4,4055,1572,2483,7.2,18.5,3880,1465,2415,6.7,17.7,175,0.8,35.4,0,144,144,926
1999,20940,1838,2046,23392,23001,242,11.9,224,11,4332,1809,2523,7.9,18.8,3549,1808,1741,7.9,15.4,783,3.4,30.8,0,141,141,1010
2000,20940,1841,2050,24626,23988,223,10.9,218,10.6,4552,1522,3030,6.3,19,3276,1450,1826,6,13.7,1276,5.3,27.4,0,133,133,706
2001,20940,1869,2087,26083,26003,235,11.3,242,11.6,4486,2195,2291,8.4,17.3,4325,1717,2608,6.6,16.6,161,0.7,33.2,0,124,124,798
2002,20940,1909,2130,25912,25995,268,12.7,223,10.6,4813,1839,2974,7.1,18.5,4978,1787,3191,6.9,19.1,-165,-0.6,37,0,115,115,877
2003,20940,1893,2110,27702,26689,237,11.2,217,10.3,5399,2615,2784,9.8,20.2,3373,1165,2208,4.4,12.6,2026,7.6,25.2,0,156,157,760
2004,20940,1898,2124,28521,28011,234,11.1,213,10.1,5059,2055,3004,7.3,18.1,4039,1488,2551,5.3,14.4,1020,3.7,28.8,0,155,155,935
2005,20940,1933,2172,30271,29338,261,12.2,194,9,5528,2441,3087,8.3,18.8,3661,1296,2365,4.4,12.5,1867,6.3,25,0,142,142,947
2006,20940,1977,2238,33726,31659,307,14,221,10,7679,2809,4870,8.9,24.3,3546,1138,2408,3.6,11.2,4133,13.1,22.4,0,159,159,767
2007,20940,2027,2332,34323,34004,324,14.2,236,10.3,6212,3203,3009,9.4,18.3,5573,1550,4023,4.6,16.4,639,1.9,32.8,0,161,161,982
2008,20940,1999,2304,34182,34046,243,10.5,242,10.5,4977,1451,3526,4.3,14.6,4705,2203,2502,6.5,13.8,272,0.8,27.6,0,173,173,1377
2009,20940,1962,2261,31150,32468,204,9,225,9.9,3719,1965,1754,6.1,11.5,6355,2113,4242,6.5,19.6,-2636,-8.1,23,0,156,160,1503
2010,20940,1888,2202,29635,30342,180,8.1,220,9.9,3281,1563,1718,5.2,10.8,4694,1500,3194,4.9,15.5,-1413,-4.7,21.6,0,169,169,1122
2011,20940,1866,2181,30245,29945,188,8.6,205,9.4,3846,1547,2299,5.2,12.8,3245,1262,1983,4.2,10.8,601,2,21.6,0,142,144,766
2012,20940,1886,2197,31446,30856,212,9.7,198,9.1,4329,1437,2892,4.7,14,3148,1014,2134,3.3,10.2,1181,3.8,20.4,0,110,113,513
2013,20940,1866,2184,31859,31633,187,8.6,200,9.2,4153,1295,2858,4.1,13.1,3701,1563,2138,4.9,11.7,452,1.4,23.4,0,126,129,1089
2014,20940,1882,2229,32716,32261,247,11.2,190,8.6,4017,1697,2320,5.3,12.5,3106,1292,1814,4,9.6,911,2.9,19.2,0,132,132,801
1977,21060,1133,1198,13038,12401,214,18.4,134,11.5,2868,1091,1777,8.8,23.1,1594,529,1065,4.3,12.9,1274,10.2,25.8,0,89,90,353
1978,21060,1205,1281,13710,13371,226,18.2,138,11.1,2527,995,1532,7.4,18.9,1849,635,1214,4.7,13.8,678,5.1,27.6,0,87,87,285
1979,21060,1199,1279,14344,14017,175,13.7,165,12.9,2549,912,1637,6.5,18.2,1894,712,1182,5.1,13.5,655,4.7,27,0,127,127,485
1980,21060,1187,1267,14420,14348,168,13.2,172,13.5,2227,1225,1002,8.5,15.5,2082,810,1272,5.6,14.5,145,1,29,0,121,121,453
1981,21060,1179,1260,14106,14305,168,13.3,159,12.6,1895,868,1027,6.1,13.2,2294,982,1312,6.9,16,-399,-2.8,26.4,0,103,103,411
1982,21060,1173,1279,15076,14629,180,14.1,149,11.7,2780,1085,1695,7.4,19,1885,801,1084,5.5,12.9,895,6.1,25.8,0,79,79,255
1983,21060,1221,1323,15476,15289,155,11.9,133,10.2,2354,916,1438,6,15.4,1980,596,1384,3.9,13,374,2.4,26,0,87,87,308
1984,21060,1288,1389,15719,15218,227,16.8,157,11.6,3081,1475,1606,9.7,20.2,2078,881,1197,5.8,13.7,1003,6.5,27.4,0,105,105,554
1985,21060,1335,1438,17630,17279,182,12.8,146,10.3,2957,960,1997,5.6,17.1,2255,975,1280,5.6,13.1,702,4,26.2,0,96,98,445
1986,21060,1384,1496,19064,18331,217,14.8,150,10.2,3703,2016,1687,11,20.2,2236,717,1519,3.9,12.2,1467,8,24.4,0,100,100,391
1987,21060,1440,1556,22145,21428,240,15.7,178,11.6,4205,2006,2199,9.4,19.6,2772,1396,1376,6.5,12.9,1433,6.7,25.8,0,112,112,560
1988,21060,1432,1567,23081,22331,193,12.4,161,10.3,4639,2558,2081,11.5,20.8,3139,1594,1545,7.1,14.1,1500,6.7,28.2,0,106,106,432
1989,21060,1479,1616,23876,23572,208,13.1,156,9.8,3423,1185,2238,5,14.5,2815,945,1870,4,11.9,608,2.6,23.8,0,113,113,563
1990,21060,1515,1661,25244,24537,209,12.8,154,9.4,4355,1960,2395,8,17.7,2940,772,2168,3.1,12,1415,5.7,24,0,113,113,539
1991,21060,1509,1682,25686,25401,194,11.6,163,9.8,4297,1646,2651,6.5,16.9,3726,973,2753,3.8,14.7,571,2.2,29.4,0,117,117,664
1992,21060,1577,1767,25895,25808,252,14.6,158,9.2,3925,1676,2249,6.5,15.2,3750,1166,2584,4.5,14.5,175,0.7,29,0,105,107,554
1993,21060,1581,1755,26535,26206,188,10.7,199,11.3,3802,978,2824,3.7,14.5,3143,1087,2056,4.1,12,659,2.5,24,0,129,129,580
1994,21060,1604,1780,27076,26806,197,11.1,168,9.5,3596,1311,2285,4.9,13.4,3055,987,2068,3.7,11.4,541,2,22.8,0,122,122,638
1995,21060,1665,1845,28637,27878,231,12.7,159,8.8,4038,1292,2746,4.6,14.5,2520,974,1546,3.5,9,1518,5.5,18,0,109,109,488
1996,21060,1679,1858,29506,29052,205,11.1,186,10.1,4184,1623,2561,5.6,14.4,3276,1065,2211,3.7,11.3,908,3.1,22.6,0,124,124,655
1997,21060,1706,1910,30106,29821,250,13.2,194,10.3,5042,2743,2299,9.2,16.9,4471,1502,2969,5,15,571,1.9,30,0,123,123,579
1998,21060,1740,1954,31698,30922,232,12,182,9.4,5595,2239,3356,7.2,18.1,4042,1651,2391,5.3,13.1,1553,5,26.2,0,123,123,601
1999,21060,1754,1980,33386,33192,223,11.3,196,10,4910,2252,2658,6.8,14.8,4522,1288,3234,3.9,13.6,388,1.2,27.2,0,131,131,677
2000,21060,1752,1983,35008,34176,213,10.7,211,10.6,5349,1493,3856,4.4,15.7,3685,1436,2249,4.2,10.8,1664,4.9,21.6,0,135,135,551
2001,21060,1756,1989,35529,35320,194,9.8,203,10.2,4317,1345,2972,3.8,12.2,3898,1019,2879,2.9,11,419,1.2,22,0,113,113,487
2002,21060,1786,2055,32594,34026,283,14,213,10.5,4685,1805,2880,5.3,13.8,7549,1099,6450,3.2,22.2,-2864,-8.4,27.6,0,135,135,559
2003,21060,1830,2109,33702,32978,232,11.2,148,7.1,4793,1542,3251,4.7,14.5,3345,835,2510,2.5,10.1,1448,4.4,20.2,0,114,114,658
2004,21060,1842,2128,35160,34338,195,9.2,154,7.3,5269,1087,4182,3.2,15.3,3625,965,2660,2.8,10.6,1644,4.7,21.2,0,107,107,467
2005,21060,1879,2184,36026,35522,233,10.8,164,7.6,5026,1595,3431,4.5,14.1,4017,1106,2911,3.1,11.3,1009,2.8,22.6,0,116,116,776
2006,21060,1883,2210,36981,36466,233,10.6,184,8.4,5062,1912,3150,5.2,13.9,4031,1585,2446,4.3,11.1,1031,2.8,22.2,0,117,117,841
2007,21060,1902,2231,36760,36817,216,9.7,186,8.4,6748,3142,3606,8.5,18.3,6861,2764,4097,7.5,18.6,-113,-0.3,36.6,0,116,116,2305
2008,21060,1909,2236,38753,37713,187,8.4,174,7.8,6060,1857,4203,4.9,16.1,3980,795,3185,2.1,10.6,2080,5.5,21.2,0,113,113,532
2009,21060,1845,2153,35634,36981,145,6.6,211,9.6,3620,1018,2602,2.8,9.8,6314,1578,4736,4.3,17.1,-2694,-7.3,19.6,0,121,121,493
2010,21060,1887,2215,34740,35203,217,10,154,7.1,4693,2252,2441,6.4,13.3,5618,1071,4547,3,16,-925,-2.7,26.6,0,97,97,601
2011,21060,1910,2252,36879,35698,221,9.9,166,7.5,5492,1392,4100,3.9,15.4,3129,903,2226,2.5,8.8,2363,6.6,17.6,0,117,117,520
2012,21060,1902,2240,37703,37101,198,8.8,214,9.5,5487,1033,4454,2.8,14.8,4283,1267,3016,3.4,11.5,1204,3.3,23,0,126,127,681
2013,21060,1954,2280,37948,37736,228,10.1,175,7.8,4109,1370,2739,3.6,10.9,3685,829,2856,2.2,9.8,424,1.1,19.6,0,110,110,553
2014,21060,1996,2331,36429,37101,261,11.4,188,8.2,3732,1140,2592,3.1,10.1,5076,2409,2667,6.5,13.7,-1344,-3.6,20.2,0,135,136,2000
1977,21140,2851,3158,69201,65312,508,16.5,342,11.1,14957,5224,9733,8,22.9,7179,3317,3862,5.1,11,7778,11.9,22,0,234,235,2167
1978,21140,2937,3257,72733,70967,423,13.2,321,10,12496,3761,8735,5.3,17.6,8964,3286,5678,4.6,12.6,3532,5,25.2,0,211,212,1919
1979,21140,2977,3307,77658,75147,398,12.1,328,10,13480,3528,9952,4.7,17.9,8458,3421,5037,4.6,11.3,5022,6.6,22.6,0,230,230,1330
1980,21140,2932,3267,66165,71780,344,10.5,366,11.1,8204,4079,4125,5.7,11.4,19433,6345,13088,8.8,27.1,-11229,-15.7,22.8,0,265,266,2819
1981,21140,2801,3123,60177,62439,338,10.6,453,14.2,7831,3404,4427,5.5,12.5,12354,4815,7539,7.7,19.8,-4523,-7.3,25,0,277,278,1691
1982,21140,2868,3221,62028,61091,451,14.2,321,10.1,10558,5225,5333,8.6,17.3,8683,2972,5711,4.9,14.2,1875,3.1,28.4,0,186,186,1086
1983,21140,2796,3142,65920,63922,342,10.8,396,12.4,12161,2725,9436,4.3,19,8164,3522,4642,5.5,12.8,3997,6.2,25.6,0,202,203,1389
1984,21140,3114,3485,78181,72208,471,14.2,197,5.9,17939,5402,12537,7.5,24.8,5993,2548,3445,3.5,8.3,11946,16.5,16.6,1,2,2,
1985,21140,3257,3637,80544,79821,494,13.9,358,10,13112,5738,7374,7.2,16.4,11665,4372,7293,5.5,14.6,1447,1.8,29.2,0,228,230,1944
1986,21140,3353,3738,83270,81861,477,12.9,361,9.8,14237,5559,8678,6.8,17.4,11418,4155,7263,5.1,13.9,2819,3.5,27.8,0,265,266,2745
1987,21140,3435,3832,88462,85880,511,13.5,411,10.9,16238,5076,11162,5.9,18.9,11073,4217,6856,4.9,12.9,5165,6,25.8,0,268,271,2005
1988,21140,3520,3962,92778,89980,519,13.3,367,9.4,15177,5769,9408,6.4,16.9,9580,2923,6657,3.2,10.6,5597,6.3,21.2,0,259,259,2135
1989,21140,3639,4105,97348,95276,521,12.9,380,9.4,15446,4676,10770,4.9,16.2,11301,4415,6886,4.6,11.9,4145,4.3,23.8,0,271,271,2247
1990,21140,3684,4152,93717,95486,472,11.4,401,9.7,12990,5183,7807,5.4,13.6,16528,4617,11911,4.8,17.3,-3538,-3.7,27.2,0,282,284,2162
1991,21140,3694,4197,85908,90066,463,11.1,414,9.9,10212,5014,5198,5.6,11.3,18528,4144,14384,4.6,20.6,-8316,-9.3,22.6,0,292,293,2356
1992,21140,3693,4195,93013,89454,447,10.6,441,10.5,17314,4661,12653,5.2,19.4,10195,5266,4929,5.9,11.4,7119,8,22.8,0,280,281,2564
1993,21140,3803,4291,97855,95437,472,11.1,363,8.6,15557,4518,11039,4.7,16.3,10720,4736,5984,5,11.2,4837,5.1,22.4,0,242,245,2189
1994,21140,3867,4385,102316,100017,474,10.9,365,8.4,16811,4630,12181,4.6,16.8,12213,4745,7468,4.7,12.2,4598,4.6,24.4,0,254,254,1804
1995,21140,3949,4484,109036,105654,461,10.4,347,7.8,18856,6375,12481,6,17.8,12091,3091,9000,2.9,11.4,6765,6.4,22.8,0,233,233,1542
1996,21140,4021,4558,106271,107723,479,10.6,403,8.9,14101,5241,8860,4.9,13.1,17005,5433,11572,5,15.8,-2904,-2.7,26.2,0,279,279,2807
1997,21140,4012,4560,107122,106663,469,10.3,457,10,16056,4459,11597,4.2,15.1,15137,5269,9868,4.9,14.2,919,0.9,28.4,0,291,291,2478
1998,21140,3966,4558,108345,107672,409,9,400,8.8,13982,4080,9902,3.8,13,12635,3829,8806,3.6,11.7,1347,1.3,23.4,0,278,278,2050
1999,21140,3969,4580,113723,111016,415,9.1,387,8.5,18353,5169,13184,4.7,16.5,12939,4356,8583,3.9,11.7,5414,4.8,23.4,0,257,257,2068
2000,21140,3991,4583,118195,116000,403,8.8,409,8.9,17584,5495,12089,4.7,15.2,13194,4618,8576,4,11.4,4390,3.8,22.8,0,267,267,1763
2001,21140,3986,4587,110880,114636,415,9,440,9.6,11519,4838,6681,4.2,10,19030,4359,14671,3.8,16.6,-7511,-6.6,20,0,255,255,1604
2002,21140,4042,4661,108351,109546,520,11.3,440,9.5,15729,7451,8278,6.8,14.4,18118,6668,11450,6.1,16.5,-2389,-2.1,28.8,0,264,265,2892
2003,21140,4060,4691,112438,109218,460,9.9,359,7.7,17901,6001,11900,5.5,16.4,11461,4810,6651,4.4,10.5,6440,5.9,21,0,248,251,3090
2004,21140,4082,4713,118393,114529,424,9,354,7.6,17857,5742,12115,5,15.6,10129,3270,6859,2.9,8.8,7728,6.8,17.6,0,241,241,2159
2005,21140,4096,4741,123199,120754,396,8.4,339,7.2,17576,6209,11367,5.1,14.6,12685,3925,8760,3.3,10.5,4891,4.1,21,0,257,257,3071
2006,21140,4086,4756,136254,129483,461,9.7,417,8.8,25841,3948,21893,3,20,12299,4744,7555,3.7,9.5,13542,10.5,19,0,290,291,3092
2007,21140,4114,4802,124098,126800,427,8.9,389,8.1,13430,4908,8522,3.9,10.6,18833,3837,14996,3,14.9,-5403,-4.3,21.2,0,268,268,2223
2008,21140,4082,4775,120192,121804,399,8.4,375,7.9,11619,4279,7340,3.5,9.5,14842,3865,10977,3.2,12.2,-3223,-2.7,19,0,280,280,2744
2009,21140,3939,4597,92517,105615,333,7.1,441,9.4,8253,3791,4462,3.6,7.8,34448,6516,27932,6.2,32.6,-26195,-24.8,15.6,0,253,254,2677
2010,21140,3837,4462,94063,92384,289,6.4,383,8.5,15005,2306,12699,2.5,16.2,11647,4101,7546,4.4,12.6,3358,3.6,25.2,0,253,253,2043
2011,21140,3799,4444,101485,97536,345,7.8,334,7.5,15900,4028,11872,4.1,16.3,8001,2412,5589,2.5,8.2,7899,8.1,16.4,0,228,229,1512
2012,21140,3805,4459,108775,104945,369,8.3,357,8,16673,4607,12066,4.4,15.9,9013,3814,5199,3.6,8.6,7660,7.3,17.2,0,246,248,2296
2013,21140,3805,4466,111054,109762,323,7.3,315,7.1,14297,2887,11410,2.6,13,11712,4469,7243,4.1,10.7,2585,2.3,21.4,0,197,197,3328
2014,21140,3754,4423,117027,113507,309,7,320,7.2,15822,3866,11956,3.4,13.9,8781,3796,4985,3.3,7.7,7041,6.2,15.4,0,229,229,1739
1977,21300,1533,1710,32978,32382,219,12.9,185,10.9,6446,2441,4005,7.5,19.9,5254,1374,3880,4.2,16.2,1192,3.7,32.4,0,119,119,636
1978,21300,1572,1739,32766,32871,208,12.1,178,10.3,4027,1228,2799,3.7,12.3,4236,1534,2702,4.7,12.9,-209,-0.6,24.6,0,118,118,1250
1979,21300,1558,1717,32850,32800,161,9.3,173,10,4198,1353,2845,4.1,12.8,4098,1666,2432,5.1,12.5,100,0.3,25,0,111,111,475
1980,21300,1537,1691,33155,32996,155,9.1,173,10.2,4306,851,3455,2.6,13.1,3987,1336,2651,4,12.1,319,1,24.2,0,119,119,425
1981,21300,1473,1639,27628,30296,156,9.4,203,12.2,2694,1159,1535,3.8,8.9,8029,3924,4105,13,26.5,-5335,-17.6,17.8,0,116,116,393
1982,21300,1488,1671,28748,28172,184,11.1,135,8.1,4572,1533,3039,5.4,16.2,3419,893,2526,3.2,12.1,1153,4.1,24.2,0,72,72,191
1983,21300,1473,1660,27154,28092,145,8.7,169,10.1,2409,619,1790,2.2,8.6,4285,797,3488,2.8,15.3,-1876,-6.7,17.2,0,103,103,410
1984,21300,1487,1667,28306,27729,166,10,161,9.7,3892,1221,2671,4.4,14,2738,1235,1503,4.5,9.9,1154,4.1,19.8,0,92,92,321
1985,21300,1518,1702,28721,28568,180,10.7,153,9.1,3622,1198,2424,4.2,12.7,3315,1764,1551,6.2,11.6,307,1.1,23.2,0,100,101,674
1986,21300,1535,1724,29865,29923,179,10.4,149,8.7,3895,1544,2351,5.2,13,4010,1340,2670,4.5,13.4,-115,-0.4,26,0,94,94,398
1987,21300,1573,1787,31963,31225,230,13.1,160,9.1,4986,1737,3249,5.6,16,3510,1021,2489,3.3,11.2,1476,4.8,22.4,0,100,100,748
1988,21300,1571,1792,33018,31725,174,9.7,157,8.8,5585,979,4606,3.1,17.6,2998,1077,1921,3.4,9.4,2587,8.2,18.8,0,104,104,514
1989,21300,1591,1821,34642,33848,167,9.2,138,7.6,5034,1656,3378,4.9,14.9,3445,749,2696,2.2,10.2,1589,4.7,20.4,0,91,92,500
1990,21300,1615,1843,34746,34694,152,8.3,127,6.9,3910,1016,2894,2.9,11.3,3805,908,2897,2.6,11,105,0.3,22,0,79,80,402
1991,21300,1617,1845,33407,33935,149,8.1,145,7.9,2948,863,2085,2.5,8.7,4004,922,3082,2.7,11.8,-1056,-3.1,17.4,0,85,85,507
1992,21300,1639,1868,31536,32454,179,9.6,153,8.2,3370,1302,2068,4,10.4,5205,1856,3349,5.7,16,-1835,-5.6,20.8,0,100,100,963
1993,21300,1620,1853,32019,31868,140,7.5,153,8.2,3929,1409,2520,4.4,12.3,3627,980,2647,3.1,11.4,302,0.9,22.8,0,102,102,394
1994,21300,1594,1834,32810,32433,137,7.4,151,8.2,3909,1298,2611,4,12.1,3155,959,2196,3,9.7,754,2.4,19.4,0,103,105,582
1995,21300,1576,1817,34009,33415,139,7.6,157,8.6,4502,1227,3275,3.7,13.5,3314,1103,2211,3.3,9.9,1188,3.6,19.8,0,102,102,471
1996,21300,1558,1789,34903,34567,120,6.7,143,7.9,4176,1667,2509,4.8,12.1,3503,1101,2402,3.2,10.1,673,2,20.2,0,86,86,407
1997,21300,1536,1763,35378,35154,153,8.6,174,9.8,4229,1100,3129,3.1,12,3781,1076,2705,3.1,10.8,448,1.2,21.6,0,97,97,411
1998,21300,1538,1772,36391,35884,141,8,135,7.6,4271,1063,3208,3,11.9,3256,953,2303,2.7,9.1,1015,2.8,18.2,0,91,91,428
1999,21300,1517,1752,36282,36328,138,7.8,153,8.7,4708,1661,3047,4.6,13,4800,1153,3647,3.2,13.2,-92,-0.2,26,0,90,90,443
2000,21300,1518,1766,35006,35205,147,8.4,130,7.4,4287,1178,3109,3.3,12.2,4684,1355,3329,3.8,13.3,-397,-1.1,24.4,0,76,76,361
2001,21300,1512,1758,35691,35464,140,7.9,161,9.1,4583,1349,3234,3.8,12.9,4129,1125,3004,3.2,11.6,454,1.3,23.2,0,91,91,401
2002,21300,1509,1761,34369,34899,172,9.8,162,9.2,4214,1467,2747,4.2,12.1,5273,1495,3778,4.3,15.1,-1059,-3,24.2,0,80,80,548
2003,21300,1520,1778,33786,33899,150,8.5,113,6.4,3263,1030,2233,3,9.6,3488,696,2792,2.1,10.3,-225,-0.7,19.2,0,73,73,344
2004,21300,1518,1768,33503,33573,126,7.1,118,6.7,3549,1514,2035,4.5,10.6,3689,701,2988,2.1,11,-140,-0.4,21.2,0,75,75,415
2005,21300,1511,1757,32893,32758,120,6.8,110,6.3,3071,684,2387,2.1,9.4,2800,538,2262,1.6,8.5,271,0.9,17,0,79,79,372
2006,21300,1512,1785,32791,32703,168,9.5,132,7.5,4375,1661,2714,5.1,13.4,4199,1658,2541,5.1,12.8,176,0.6,25.6,0,93,93,981
2007,21300,1472,1729,33309,33029,130,7.4,170,9.7,4012,1414,2598,4.3,12.1,3451,826,2625,2.5,10.4,561,1.7,20.8,0,100,108,427
2008,21300,1475,1740,34050,33654,123,7.1,101,5.8,3637,849,2788,2.5,10.8,2844,623,2221,1.9,8.5,793,2.3,17,0,69,69,452
2009,21300,1466,1736,32269,33110,118,6.8,112,6.5,2592,666,1926,2,7.8,4274,487,3787,1.5,12.9,-1682,-5.1,15.6,0,71,72,341
2010,21300,1457,1726,32619,32238,111,6.4,110,6.4,3490,1011,2479,3.1,10.8,2727,561,2166,1.7,8.5,763,2.3,17,0,72,72,428
2011,21300,1426,1696,32896,32510,106,6.2,120,7,3953,976,2977,3,12.2,3181,1116,2065,3.4,9.8,772,2.4,19.6,0,85,85,425
2012,21300,1417,1686,32370,32726,109,6.4,122,7.2,3417,1267,2150,3.9,10.4,4128,884,3244,2.7,12.6,-711,-2.2,20.8,0,69,69,381
2013,21300,1416,1673,32170,32233,105,6.3,115,6.9,2837,551,2286,1.7,8.8,2962,657,2305,2,9.2,-125,-0.4,17.6,0,63,63,342
2014,21300,1398,1671,32077,31686,126,7.6,108,6.5,3528,949,2579,3,11.1,2746,726,2020,2.3,8.7,782,2.4,17.4,0,71,71,391
1977,21340,6064,7149,108851,109774,1338,19.3,904,13,21448,10225,11223,9.3,19.5,23293,7813,15480,7.1,21.2,-1845,-1.7,39,0,607,608,4663
1978,21340,5805,6897,114602,111434,1055,15,1203,17.1,25915,8890,17025,8,23.3,19578,11137,8441,10,17.6,6337,5.7,35.2,0,688,694,5668
1979,21340,6380,7576,125420,120149,1210,16.7,602,8.3,27871,12280,15591,10.2,23.2,17329,5113,12216,4.3,14.4,10542,8.8,28.8,0,9,11,214
1980,21340,4844,6003,116072,118413,320,4.7,1225,18,17307,4183,13124,3.5,14.6,21989,10145,11844,8.6,18.6,-4682,-4,29.2,0,905,906,6375
1981,21340,6427,7591,128620,125818,1375,20.3,737,10.9,23409,10678,12731,8.5,18.6,17804,6765,11039,5.4,14.2,5605,4.4,28.4,0,368,370,3065
1982,21340,6690,8081,134911,131575,1434,18.3,863,11,29621,14827,14794,11.3,22.5,22951,9717,13234,7.4,17.4,6670,5.1,34.8,0,504,504,3674
1983,21340,6951,8311,128382,131541,1168,14.3,1012,12.3,22733,10696,12037,8.1,17.3,29051,7446,21605,5.7,22.1,-6318,-4.8,34.6,0,630,633,3923
1984,21340,7029,8403,132563,130300,1248,14.9,1130,13.5,26104,9339,16765,7.2,20,21577,9584,11993,7.4,16.6,4527,3.4,33.2,0,718,720,4733
1985,21340,7254,8626,136566,134851,1258,14.8,1026,12,27882,11010,16872,8.2,20.7,24452,10530,13922,7.8,18.1,3430,2.6,36.2,0,643,651,5265
1986,21340,7484,8856,138279,137373,1313,15,1050,12,28250,11661,16589,8.5,20.6,26438,11318,15120,8.2,19.2,1812,1.4,38.4,0,684,684,4879
1987,21340,7706,9200,144052,141777,1559,17.3,1173,13,31805,16129,15676,11.4,22.4,27254,11596,15658,8.2,19.2,4551,3.2,38.4,0,760,783,6224
1988,21340,7677,9191,152420,148294,1330,14.5,1275,13.9,37109,15725,21384,10.6,25,28857,12261,16596,8.3,19.5,8252,5.5,39,0,791,791,6536
1989,21340,7841,9416,153661,153293,1291,13.9,1092,11.7,31579,13990,17589,9.1,20.6,30842,12587,18255,8.2,20.1,737,0.5,40.2,0,717,721,6916
1990,21340,8089,9695,157334,155248,1353,14.2,996,10.4,29699,10704,18995,6.9,19.1,25527,9138,16389,5.9,16.4,4172,2.7,32.8,0,684,685,5410
1991,21340,8303,9971,161484,159439,1383,14.1,1107,11.3,33540,15470,18070,9.7,21,29449,9773,19676,6.1,18.5,4091,2.5,37,0,684,684,6281
1992,21340,8482,10219,167536,164287,1516,15,1221,12.1,36089,13355,22734,8.1,22,29590,10873,18717,6.6,18,6499,4,36,0,805,819,6213
1993,21340,8608,10312,174906,171282,1289,12.6,1189,11.6,32785,12254,20531,7.2,19.1,25536,11312,14224,6.6,14.9,7249,4.2,29.8,0,822,831,7603
1994,21340,8769,10528,178476,176284,1396,13.4,1126,10.8,31214,12174,19040,6.9,17.7,26830,8445,18385,4.8,15.2,4384,2.5,30.4,0,779,779,5122
1995,21340,8847,10630,183641,180801,1385,13.1,1233,11.7,35643,13399,22244,7.4,19.7,29963,14142,15821,7.8,16.6,5680,3.1,33.2,0,811,818,8879
1996,21340,8976,10780,186429,185197,1448,13.5,1286,12,36018,14835,21183,8,19.4,33556,12989,20567,7,18.1,2462,1.3,36.2,0,842,842,6244
1997,21340,8937,10834,190988,188833,1423,13.1,1361,12.6,37890,13625,24265,7.2,20.1,33581,11831,21750,6.3,17.8,4309,2.3,35.6,0,874,874,5604
1998,21340,9116,11041,195776,193184,1451,13.3,1227,11.2,34384,14355,20029,7.4,17.8,29201,9736,19465,5,15.1,5183,2.7,30.2,0,775,775,4730
1999,21340,9135,11086,193390,194646,1369,12.4,1301,11.8,37759,15659,22100,8,19.4,40271,13697,26574,7,20.7,-2512,-1.3,38.8,0,842,842,6222
2000,21340,9000,10940,197267,195199,1186,10.8,1337,12.1,34806,11994,22812,6.1,17.8,30669,11053,19616,5.7,15.7,4137,2.1,31.4,0,774,774,5063
2001,21340,9011,11047,201839,199694,1346,12.2,1313,11.9,34190,12980,21210,6.5,17.1,29899,11711,18188,5.9,15,4291,2.1,30,0,775,775,5085
2002,21340,9115,11201,198462,199873,1547,13.9,1376,12.4,37372,15382,21990,7.7,18.7,40194,13669,26525,6.8,20.1,-2822,-1.4,37.4,0,730,737,5615
2003,21340,9095,11219,196855,195348,1394,12.5,1100,9.9,34764,13178,21586,6.7,17.8,31749,11224,20525,5.7,16.3,3015,1.5,32.6,0,777,777,6925
2004,21340,9201,11345,199895,197190,1322,11.8,1075,9.6,31461,10697,20764,5.4,16,26051,7891,18160,4,13.2,5410,2.8,26.4,0,729,729,4122
2005,21340,9374,11582,201787,199584,1457,12.7,1097,9.6,37560,16129,21431,8.1,18.8,33154,9387,23767,4.7,16.6,4406,2.2,33.2,0,794,794,5313
2006,21340,9416,11700,209644,205081,1415,12.2,1155,9.9,37397,14759,22638,7.2,18.2,28271,10162,18109,5,13.8,9126,4.4,27.6,0,765,773,5205
2007,21340,9560,11950,212497,210546,1508,12.8,1243,10.5,37174,13220,23954,6.3,17.7,33271,9721,23550,4.6,15.8,3903,1.9,31.6,0,792,806,5498
2008,21340,9641,12157,219249,215515,1417,11.8,1126,9.4,39361,13523,25838,6.3,18.3,31893,8320,23573,3.9,14.8,7468,3.5,29.6,0,862,862,5591
2009,21340,9501,12061,214213,215943,1227,10.2,1229,10.2,32769,13797,18972,6.4,15.2,36229,9759,26470,4.5,16.8,-3460,-1.6,30.4,0,882,884,4886
2010,21340,9557,12110,218967,216006,1240,10.3,1090,9.1,32436,12967,19469,6,15,26514,6907,19607,3.2,12.3,5922,2.7,24.6,0,773,773,3908
2011,21340,9764,12393,222603,220427,1418,11.6,1071,8.8,33537,12901,20636,5.9,15.2,29184,6355,22829,2.9,13.2,4353,2,26.4,0,759,763,4066
2012,21340,9865,12566,226229,224475,1353,10.9,1194,9.6,33380,11668,21712,5.2,14.9,29871,8142,21729,3.6,13.3,3509,1.6,26.6,0,762,770,4228
2013,21340,9916,12644,230637,228022,1245,9.9,1196,9.5,34762,9330,25432,4.1,15.2,29532,10004,19528,4.4,13,5230,2.2,26,0,779,789,4955
2014,21340,9930,12786,228638,228570,1357,10.7,1119,8.8,33439,12752,20687,5.6,14.6,33303,10281,23022,4.5,14.6,136,0,29.2,0,813,814,6082
1977,21500,4333,4964,84928,83240,709,14.6,518,10.6,15041,6722,8319,8.1,18.1,11665,3522,8143,4.2,14,3376,4.1,28,0,317,320,1815
1978,21500,4412,5042,99386,92116,577,11.5,501,10,23519,12210,11309,13.3,25.5,8979,3677,5302,4,9.7,14540,15.8,19.4,0,312,315,1675
1979,21500,4424,5065,101140,100229,563,11.1,517,10.2,13259,3992,9267,4,13.2,11436,3645,7791,3.6,11.4,1823,1.8,22.8,0,347,347,1801
1980,21500,4360,5019,100605,100948,491,9.7,506,10,12033,3873,8160,3.8,11.9,12718,4057,8661,4,12.6,-685,-0.7,23.8,0,333,333,1671
1981,21500,4203,4813,108136,104097,471,9.6,636,13,23231,15878,7353,15.3,22.3,15152,5379,9773,5.2,14.6,8079,7.7,29.2,0,340,346,2716
1982,21500,4213,4884,96991,102553,612,12.6,497,10.2,13284,5839,7445,5.7,13,24408,3562,20846,3.5,23.8,-11124,-10.8,26,0,261,261,1409
1983,21500,4315,4967,90254,93654,498,10.1,451,9.2,10789,3892,6897,4.2,11.5,17588,3795,13793,4.1,18.8,-6799,-7.3,23,0,278,281,2005
1984,21500,4450,5101,93704,91970,549,10.9,413,8.2,13887,4173,9714,4.5,15.1,10419,2833,7586,3.1,11.3,3468,3.8,22.6,0,239,239,1298
1985,21500,4527,5162,95438,94650,569,11.1,508,9.9,12880,3855,9025,4.1,13.6,11303,4281,7022,4.5,11.9,1577,1.7,23.8,0,280,280,1868
1986,21500,4633,5261,95321,95348,611,11.7,500,9.6,13790,5772,8018,6.1,14.5,13844,4975,8869,5.2,14.5,-54,0,29,0,307,308,2364
1987,21500,4794,5478,98115,97661,729,13.6,490,9.1,15343,6659,8684,6.8,15.7,14434,6861,7573,7,14.8,909,0.9,29.6,0,304,304,4692
1988,21500,4800,5482,97712,97734,582,10.6,545,10,14065,4735,9330,4.8,14.4,14109,4284,9825,4.4,14.4,-44,0,28.8,0,348,348,1684
1989,21500,4892,5601,103480,100690,604,10.9,502,9.1,16118,5699,10419,5.7,16,10537,3849,6688,3.8,10.5,5581,5.5,21,0,344,354,2066
1990,21500,4932,5677,107648,105448,523,9.3,421,7.5,15384,4152,11232,3.9,14.6,10983,3343,7640,3.2,10.4,4401,4.2,20.8,0,279,286,1726
1991,21500,5015,5819,110884,109244,559,9.7,407,7.1,17319,6837,10482,6.3,15.9,14038,3433,10605,3.1,12.9,3281,3,25.8,0,266,266,1760
1992,21500,5048,5932,109952,109976,561,9.5,450,7.6,18624,9579,9045,8.7,16.9,18672,9387,9285,8.5,17,-48,-0.1,33.8,0,284,285,1744
1993,21500,5060,5929,109819,109932,483,8.1,473,8,14976,3948,11028,3.6,13.6,15201,5439,9762,4.9,13.8,-225,-0.2,27.2,0,297,297,2349
1994,21500,5064,5946,107480,108569,535,9,498,8.4,12250,4346,7904,4,11.3,14428,5125,9303,4.7,13.3,-2178,-2,22.6,0,315,317,2091
1995,21500,5109,5981,110889,109034,511,8.6,441,7.4,14783,5023,9760,4.6,13.6,11072,3988,7084,3.7,10.2,3711,3.4,20.4,0,282,284,1658
1996,21500,5155,6017,111560,111421,534,8.9,493,8.2,12653,4807,7846,4.3,11.4,12375,3736,8639,3.4,11.1,278,0.3,22.2,0,316,318,1434
1997,21500,5215,6123,113274,112581,625,10.3,524,8.6,16576,7104,9472,6.3,14.7,15189,4239,10950,3.8,13.5,1387,1.2,27,0,318,318,1906
1998,21500,5264,6187,115394,114330,572,9.3,497,8.1,14329,5096,9233,4.5,12.5,12200,3523,8677,3.1,10.7,2129,1.8,21.4,0,304,304,1658
1999,21500,5214,6157,118659,116986,513,8.3,527,8.5,15482,4901,10581,4.2,13.2,12136,3761,8375,3.2,10.4,3346,2.8,20.8,0,315,315,1572
2000,21500,5240,6173,122667,120920,537,8.7,532,8.6,16607,6090,10517,5,13.7,13113,4541,8572,3.8,10.8,3494,2.9,21.6,0,319,319,2033
2001,21500,5215,6190,122695,122775,545,8.8,560,9.1,14848,4454,10394,3.6,12.1,15007,3787,11220,3.1,12.2,-159,-0.1,24.2,0,333,333,1937
2002,21500,5165,6143,116559,118693,595,9.7,614,10,15168,6108,9060,5.1,12.8,19436,5159,14277,4.3,16.4,-4268,-3.6,25.6,0,303,303,1921
2003,21500,5173,6147,115646,115287,568,9.3,470,7.7,13616,5221,8395,4.5,11.8,12897,3267,9630,2.8,11.2,719,0.6,22.4,0,331,331,1914
2004,21500,5107,6083,116561,115735,486,8,494,8.1,13666,4647,9019,4,11.8,12014,3236,8778,2.8,10.4,1652,1.4,20.8,0,338,339,2199
2005,21500,5045,6013,116942,116511,490,8.1,514,8.5,14798,3119,11679,2.7,12.7,13936,4923,9013,4.2,12,862,0.7,24,0,352,352,2000
2006,21500,4965,6035,118525,117451,571,9.5,484,8.1,13743,4660,9083,4,11.7,11594,3250,8344,2.8,9.9,2149,1.8,19.8,0,348,349,2290
2007,21500,4983,6027,118554,118183,575,9.6,577,9.6,14745,5426,9319,4.6,12.5,14003,3850,10153,3.3,11.8,742,0.7,23.6,0,333,333,2028
2008,21500,4964,6024,119947,118787,454,7.6,394,6.6,12867,3475,9392,2.9,10.8,10547,2397,8150,2,8.9,2320,1.9,17.8,0,262,262,1576
2009,21500,4939,5969,114421,116474,386,6.5,417,7,10461,2322,8139,2,9,14567,2784,11783,2.4,12.5,-4106,-3.5,18,0,265,265,1434
2010,21500,4747,5743,113304,113891,364,6.2,537,9.2,11230,2877,8353,2.5,9.9,12404,2447,9957,2.1,10.9,-1174,-1,19.8,0,385,385,1790
2011,21500,4730,5752,116756,114724,405,7.1,374,6.5,13922,3824,10098,3.3,12.1,9858,2834,7024,2.5,8.6,4064,3.5,17.2,0,231,231,1751
2012,21500,4733,5800,117468,116989,458,7.9,392,6.8,13104,3735,9369,3.2,11.2,12146,2710,9436,2.3,10.4,958,0.8,20.8,0,222,231,1397
2013,21500,4706,5811,115063,116046,355,6.1,347,6,11598,3794,7804,3.3,10,13563,3589,9974,3.1,11.7,-1965,-1.7,20,0,215,216,1943
2014,21500,4626,5739,113952,114142,357,6.2,375,6.5,10339,3021,7318,2.6,9.1,10718,2328,8390,2,9.4,-379,-0.3,18.2,0,251,251,1312
1977,21660,5081,5553,69061,65881,1227,23,787,14.7,16148,7406,8742,11.2,24.5,9787,4830,4957,7.3,14.9,6361,9.6,29.8,0,538,539,3110
1978,21660,5469,5970,78534,73786,1244,21.6,835,14.5,20334,7342,12992,10,27.6,10838,5901,4937,8,14.7,9496,12.9,29.4,0,565,567,3329
1979,21660,5736,6258,82330,80194,1224,20,882,14.4,18397,7369,11028,9.2,22.9,14124,6470,7654,8.1,17.6,4273,5.3,35.2,0,636,636,3340
1980,21660,5846,6386,81725,81916,1112,17.6,936,14.8,15339,7356,7983,9,18.7,15721,5429,10292,6.6,19.2,-382,-0.5,37.4,0,689,693,3904
1981,21660,5613,6120,75660,77233,963,15.4,1139,18.3,14696,6976,7720,9,19,17841,8300,9541,10.7,23.1,-3145,-4.1,38,0,736,739,4252
1982,21660,5430,5996,68359,71454,942,15.5,974,16.1,12027,6603,5424,9.2,16.8,18216,6047,12169,8.5,25.5,-6189,-8.7,33.6,0,561,562,3165
1983,21660,5466,6022,66291,67319,801,13.3,824,13.7,12178,5110,7068,7.6,18.1,14233,4794,9439,7.1,21.1,-2055,-3,36.2,0,540,543,3248
1984,21660,5718,6300,72209,69170,976,15.8,711,11.5,15745,5950,9795,8.6,22.8,9667,4263,5404,6.2,14,6078,8.8,28,0,490,490,2440
1985,21660,5848,6426,78688,76841,954,15,846,13.3,16356,6688,9668,8.7,21.3,12661,5237,7424,6.8,16.5,3695,4.8,33,0,591,597,3122
1986,21660,6018,6586,78815,78702,1008,15.5,832,12.8,14946,6574,8372,8.4,19,14719,6132,8587,7.8,18.7,227,0.3,37.4,0,560,560,3022
1987,21660,6224,6863,83734,81155,1179,17.5,877,13,18190,7594,10596,9.4,22.4,13032,6319,6713,7.8,16.1,5158,6.3,32.2,0,596,597,4052
1988,21660,6225,6897,86120,83520,975,14.2,877,12.8,18806,7777,11029,9.3,22.5,13606,5905,7701,7.1,16.3,5200,6.2,32.6,0,619,619,3427
1989,21660,5585,6263,83449,84886,810,12.3,1448,22,15995,5707,10288,6.7,18.8,18868,11280,7588,13.3,22.2,-2873,-3.4,37.6,0,544,546,3357
1990,21660,6437,7168,94515,88876,1564,23.3,618,9.2,24629,14342,10287,16.1,27.7,13351,4721,8630,5.3,15,11278,12.7,30,0,439,439,2764
1991,21660,6561,7348,91785,92955,1019,14,823,11.3,16015,7359,8656,7.9,17.2,18354,6457,11897,6.9,19.7,-2339,-2.5,34.4,0,563,573,4056
1992,21660,6712,7555,93269,92463,1024,13.7,772,10.3,17427,7794,9633,8.4,18.8,15815,6060,9755,6.6,17.1,1612,1.7,34.2,0,514,514,3378
1993,21660,6845,7641,94494,93688,893,11.8,774,10.2,15045,4526,10519,4.8,16.1,13432,4925,8507,5.3,14.3,1613,1.8,28.6,0,526,527,2737
1994,21660,7087,7912,100126,97534,1012,13,739,9.5,17378,6522,10856,6.7,17.8,12194,4371,7823,4.5,12.5,5184,5.3,25,0,489,490,2249
1995,21660,7283,8083,105932,102946,1017,12.7,808,10.1,19439,6455,12984,6.3,18.9,13466,6263,7203,6.1,13.1,5973,5.8,26.2,0,539,539,3536
1996,21660,7420,8250,108846,107528,1057,12.9,864,10.6,20065,6418,13647,6,18.7,17428,7918,9510,7.4,16.2,2637,2.5,32.4,0,606,606,5340
1997,21660,7590,8485,112566,110741,1104,13.2,880,10.5,22295,7946,14349,7.2,20.1,18645,5579,13066,5,16.8,3650,3.3,33.6,0,579,579,3270
1998,21660,7578,8489,113894,113118,995,11.7,958,11.3,18960,7965,10995,7,16.8,17407,5776,11631,5.1,15.4,1553,1.4,30.8,0,651,651,3626
1999,21660,7618,8558,118747,116263,1019,12,933,10.9,20877,7446,13431,6.4,18,15908,6087,9821,5.2,13.7,4969,4.3,27.4,0,626,626,2938
2000,21660,7536,8495,120156,119490,935,11,996,11.7,18694,5729,12965,4.8,15.6,17361,6675,10686,5.6,14.5,1333,1.1,29,0,596,596,2879
2001,21660,7576,8575,118267,119431,930,10.9,933,10.9,15100,5981,9119,5,12.6,17427,5341,12086,4.5,14.6,-2327,-2,25.2,0,562,563,2531
2002,21660,7468,8506,117498,117729,986,11.6,1037,12.2,19531,7035,12496,6,16.6,19992,6036,13956,5.1,17,-461,-0.4,33.2,0,553,554,2455
2003,21660,7570,8632,120621,118433,995,11.7,723,8.5,19689,6799,12890,5.7,16.6,15313,4598,10715,3.9,12.9,4376,3.7,25.8,0,483,483,2267
2004,21660,7635,8686,119009,119097,949,11,806,9.3,16005,5983,10022,5,13.4,16181,5804,10377,4.9,13.6,-176,-0.2,26.8,0,539,544,3663
2005,21660,7819,8896,123725,121193,1020,11.6,754,8.6,18567,5819,12748,4.8,15.3,13502,5580,7922,4.6,11.1,5065,4.2,22.2,0,528,528,3263
2006,21660,7884,9030,125944,124557,1001,11.2,789,8.8,17854,6881,10973,5.5,14.3,15079,4936,10143,4,12.1,2775,2.2,24.2,0,551,551,3553
2007,21660,8055,9201,127139,126292,1048,11.5,863,9.5,18758,6619,12139,5.2,14.9,17063,5469,11594,4.3,13.5,1695,1.4,27,0,542,553,3068
2008,21660,8008,9198,128749,127293,914,10,838,9.1,18226,7062,11164,5.5,14.3,15313,3951,11362,3.1,12,2913,2.3,24,0,600,600,2776
2009,21660,7654,8851,115940,122841,689,7.7,933,10.4,12379,5128,7251,4.2,10.1,26180,4274,21906,3.5,21.3,-13801,-11.2,20.2,0,631,631,2837
2010,21660,7506,8684,112548,113830,678,7.8,807,9.2,12128,3745,8383,3.3,10.7,14691,4672,10019,4.1,12.9,-2563,-2.2,21.4,0,528,529,2756
2011,21660,7399,8581,112099,112120,735,8.5,794,9.2,13244,4310,8934,3.8,11.8,13285,3629,9656,3.2,11.8,-41,0,23.6,0,547,548,2436
2012,21660,7400,8569,114513,113334,765,8.9,782,9.1,15774,5387,10387,4.8,13.9,13416,4375,9041,3.9,11.8,2358,2.1,23.6,0,445,449,2162
2013,21660,7508,8679,116742,115071,732,8.5,622,7.2,16613,5622,10991,4.9,14.4,13271,3421,9850,3,11.5,3342,2.9,23,0,421,421,2584
2014,21660,7513,8655,122331,119013,751,8.7,711,8.2,19395,4930,14465,4.1,16.3,12758,4651,8107,3.9,10.7,6637,5.6,21.4,0,491,493,2078
1977,21780,5635,6359,106600,102958,1011,16.2,725,11.7,19466,9275,10191,9,18.9,12182,5196,6986,5,11.8,7284,7.1,23.6,0,454,457,2920
1978,21780,5835,6597,119949,113250,974,15,728,11.2,26872,7619,19253,6.7,23.7,13473,6478,6995,5.7,11.9,13399,11.8,23.8,0,492,496,3667
1979,21780,5904,6672,119699,119744,819,12.3,705,10.6,18838,5204,13634,4.3,15.7,18927,4621,14306,3.9,15.8,-89,-0.1,31.4,0,500,500,2710
1980,21780,5876,6662,117353,118204,738,11.1,730,10.9,15419,5690,9729,4.8,13,17120,4954,12166,4.2,14.5,-1701,-1.5,26,0,530,530,2731
1981,21780,5681,6426,125910,120613,692,10.6,842,12.9,27792,8051,19741,6.7,23,17198,7121,10077,5.9,14.3,10594,8.7,28.6,0,488,489,2444
1982,21780,5745,6655,129749,127903,892,13.6,622,9.5,19815,9637,10178,7.5,15.5,16123,4513,11610,3.5,12.6,3692,2.9,25.2,0,354,354,2110
1983,21780,5540,6444,105852,117474,650,9.9,802,12.2,14449,5332,9117,4.5,12.3,37693,16363,21330,13.9,32.1,-23244,-19.8,24.6,0,429,430,2768
1984,21780,5996,6922,117494,112194,869,13,484,7.2,22373,7175,15198,6.4,19.9,11772,4056,7716,3.6,10.5,10601,9.4,21,0,92,92,491
1985,21780,6191,7068,117366,118095,820,11.7,720,10.3,15708,5770,9938,4.9,13.3,17166,7153,10013,6.1,14.5,-1458,-1.2,26.6,0,454,456,2731
1986,21780,6377,7275,123580,120417,893,12.5,673,9.4,20476,7897,12579,6.6,17,14150,4409,9741,3.7,11.8,6326,5.2,23.6,0,456,456,2936
1987,21780,6476,7440,126680,125446,984,13.4,791,10.7,19679,7714,11965,6.1,15.7,17211,6571,10640,5.2,13.7,2468,2,27.4,0,506,507,3009
1988,21780,6406,7416,128074,126482,833,11.2,809,10.9,21522,8558,12964,6.8,17,18338,6178,12160,4.9,14.5,3184,2.5,29,0,546,546,2804
1989,21780,6400,7451,134225,131232,734,9.9,701,9.4,20685,5932,14753,4.5,15.8,14699,4781,9918,3.6,11.2,5986,4.6,22.4,0,484,484,2659
1990,21780,6449,7520,134430,134367,777,10.4,678,9.1,17529,5701,11828,4.2,13,17402,4536,12866,3.4,13,127,0,26,0,426,428,2657
1991,21780,6507,7629,135326,134955,791,10.4,683,9,18255,6876,11379,5.1,13.5,17513,5162,12351,3.8,13,742,0.5,26,0,440,444,2947
1992,21780,6533,7676,137683,136468,808,10.5,735,9.6,21144,6416,14728,4.7,15.5,18713,6217,12496,4.6,13.7,2431,1.8,27.4,0,456,468,2837
1993,21780,6579,7720,141181,139267,730,9.5,655,8.5,18969,5596,13373,4,13.6,15141,4697,10444,3.4,10.9,3828,2.7,21.8,0,445,448,2495
1994,21780,6652,7812,144383,142808,753,9.7,639,8.2,19418,5994,13424,4.2,13.6,16268,4551,11717,3.2,11.4,3150,2.2,22.8,0,432,433,2463
1995,21780,6753,7939,148319,146261,851,10.8,698,8.9,20525,6764,13761,4.6,14,16409,4962,11447,3.4,11.2,4116,2.8,22.4,0,464,468,2717
1996,21780,6821,8048,147485,147927,819,10.3,696,8.7,18494,6114,12380,4.1,12.5,19377,5667,13710,3.8,13.1,-883,-0.6,25,0,469,469,2743
1997,21780,6848,8186,150953,149393,938,11.5,816,10,22337,8966,13371,6,15,19217,5753,13464,3.9,12.9,3120,2.1,25.8,0,544,544,2610
1998,21780,6911,8248,154790,152888,853,10.4,783,9.5,22246,8247,13999,5.4,14.6,18441,6659,11782,4.4,12.1,3805,2.5,24.2,0,483,483,2809
1999,21780,6844,8161,156833,155780,729,8.9,807,9.8,21386,6454,14932,4.1,13.7,19279,6807,12472,4.4,12.4,2107,1.3,24.8,0,529,529,3046
2000,21780,6795,8147,163465,160182,808,9.9,823,10.1,26511,9881,16630,6.2,16.6,19945,6648,13297,4.2,12.5,6566,4.1,25,0,453,453,2338
2001,21780,6774,8146,158511,161218,740,9.1,804,9.9,21099,7023,14076,4.4,13.1,26512,7605,18907,4.7,16.4,-5413,-3.3,26.2,0,451,451,2759
2002,21780,6768,8162,158594,158463,835,10.2,816,10,22463,8642,13821,5.5,14.2,22200,7125,15075,4.5,14,263,0.2,28,0,441,446,3049
2003,21780,6715,8099,160638,158695,697,8.6,630,7.8,24449,7373,17076,4.6,15.4,20562,5180,15382,3.3,13,3887,2.4,26,0,437,441,2757
2004,21780,6749,8130,163783,161829,729,9,631,7.8,23830,6489,17341,4,14.7,19923,8443,11480,5.2,12.3,3907,2.4,24.6,0,419,419,3600
2005,21780,6731,8167,164466,163663,710,8.7,615,7.6,19820,6353,13467,3.9,12.1,18215,4367,13848,2.7,11.1,1605,1,22.2,0,431,436,2893
2006,21780,6721,8198,167003,165500,766,9.4,670,8.2,20899,7031,13868,4.2,12.6,17893,5643,12250,3.4,10.8,3006,1.8,21.6,0,453,453,3172
2007,21780,6736,8273,165054,165607,754,9.2,662,8.1,23469,6685,16784,4,14.2,24575,8288,16287,5,14.8,-1106,-0.6,28.4,0,405,409,2569
2008,21780,6661,8193,164304,164000,664,8.1,653,8,20405,7397,13008,4.5,12.4,19796,5177,14619,3.2,12.1,609,0.3,24.2,0,432,432,3024
2009,21780,6545,8071,158495,161110,553,6.8,637,7.9,17014,5666,11348,3.5,10.6,22244,4393,17851,2.7,13.8,-5230,-3.2,21.2,0,436,438,2604
2010,21780,6402,7948,156665,157229,514,6.4,589,7.4,15860,5472,10388,3.5,10.1,16988,4002,12986,2.5,10.8,-1128,-0.7,20.2,0,389,389,2747
2011,21780,6299,7868,159745,157958,554,7,574,7.3,19528,5368,14160,3.4,12.4,15954,6052,9902,3.8,10.1,3574,2.3,20.2,0,381,381,3087
2012,21780,6365,7916,160884,160135,641,8.1,585,7.4,18806,5690,13116,3.6,11.7,17308,4529,12779,2.8,10.8,1498,0.9,21.6,0,340,345,2023
2013,21780,6385,7938,160899,160629,555,7,524,6.6,16617,4475,12142,2.8,10.3,16077,4455,11622,2.8,10,540,0.3,20,0,353,353,2439
2014,21780,6294,7847,159996,160213,536,6.8,578,7.3,15340,4586,10754,2.9,9.6,15774,4827,10947,3,9.8,-434,-0.2,19.2,0,396,397,2867
1977,21820,939,1035,18518,20945,270,26.8,213,21.1,6191,2599,3592,12.4,29.6,11044,2949,8095,14.1,52.7,-4853,-23.1,59.2,0,139,139,1091
1978,21820,946,1025,13899,16211,236,22.9,244,23.7,3503,1576,1927,9.7,21.6,8126,3894,4232,24,50.1,-4623,-28.5,43.2,0,131,131,1755
1979,21820,963,1045,12019,12947,204,19.7,171,16.5,2899,1167,1732,9,22.4,4755,2425,2330,18.7,36.7,-1856,-14.3,44.8,0,113,113,812
1980,21820,957,1033,12359,12182,150,14.4,148,14.3,2859,780,2079,6.4,23.5,2505,896,1609,7.4,20.6,354,2.9,41.2,0,100,103,460
1981,21820,943,1016,12437,12269,161,15.7,166,16.2,3176,1147,2029,9.3,25.9,2839,1073,1766,8.7,23.1,337,2.8,46.2,0,82,82,386
1982,21820,1050,1136,14476,13428,252,23.4,127,11.8,4606,1958,2648,14.6,34.3,2510,913,1597,6.8,18.7,2096,15.6,37.4,0,71,71,456
1983,21820,1150,1248,14422,14481,252,21.1,151,12.7,3800,1232,2568,8.5,26.2,3918,1463,2455,10.1,27.1,-118,-0.9,52.4,0,84,84,644
1984,21820,1286,1385,15082,14753,296,22.5,152,11.6,3547,1664,1883,11.3,24,2888,936,1952,6.3,19.6,659,4.4,39.2,0,91,91,452
1985,21820,1332,1443,16304,15653,283,20,221,15.6,4488,1937,2551,12.4,28.7,3185,1438,1747,9.2,20.3,1303,8.4,40.6,0,151,151,734
1986,21820,1402,1515,15783,16016,309,20.9,227,15.4,4022,2376,1646,14.8,25.1,4488,1986,2502,12.4,28,-466,-2.9,50.2,0,146,146,975
1987,21820,1354,1477,16265,16760,247,16.5,280,18.7,3092,1328,1764,7.9,18.4,4081,1458,2623,8.7,24.3,-989,-5.9,36.8,0,191,195,963
1988,21820,1370,1490,16099,16172,248,16.7,228,15.4,3542,1211,2331,7.5,21.9,3687,1705,1982,10.5,22.8,-145,-0.9,43.8,0,150,150,872
1989,21820,1178,1296,14980,15526,173,12.4,359,25.8,2792,1463,1329,9.4,18,3883,2004,1879,12.9,25,-1091,-7,36,0,124,125,652
1990,21820,1383,1510,16947,15956,348,24.8,128,9.1,4020,2009,2011,12.6,25.2,2037,1040,997,6.5,12.8,1983,12.4,25.6,0,88,88,713
1991,21820,1425,1565,17508,17202,227,14.8,163,10.6,3421,1253,2168,7.3,19.9,2808,1100,1708,6.4,16.3,613,3.6,32.6,0,98,98,648
1992,21820,1460,1627,17634,17557,243,15.2,172,10.8,4086,1938,2148,11,23.3,3932,912,3020,5.2,22.4,154,0.9,44.8,0,94,97,564
1993,21820,1510,1669,18179,17896,196,11.9,155,9.4,3080,709,2371,4,17.2,2513,673,1840,3.8,14,567,3.2,28,0,98,98,348
1994,21820,1556,1718,18223,18184,221,13,159,9.4,3450,1292,2158,7.1,19,3371,942,2429,5.2,18.5,79,0.5,37,0,92,92,477
1995,21820,1582,1736,19079,18636,227,13.2,197,11.4,3636,1356,2280,7.3,19.5,2749,1249,1500,6.7,14.8,887,4.7,29.6,0,122,122,646
1996,21820,1626,1779,19550,19313,228,13,184,10.5,3109,1157,1952,6,16.1,2634,1025,1609,5.3,13.6,475,2.5,27.2,0,112,112,470
1997,21820,1659,1826,20494,20004,224,12.4,173,9.6,4247,1601,2646,8,21.2,3266,1010,2256,5,16.3,981,4.9,32.6,0,106,106,458
1998,21820,1683,1845,20585,20542,228,12.4,208,11.3,3520,1342,2178,6.5,17.1,3434,1424,2010,6.9,16.7,86,0.4,33.4,0,135,135,698
1999,21820,1664,1829,20594,20571,189,10.3,195,10.6,3234,1011,2223,4.9,15.7,3187,1079,2108,5.2,15.5,47,0.2,31,0,122,122,528
2000,21820,1658,1812,20770,20684,203,11.2,219,12,3261,1523,1738,7.4,15.8,3089,1402,1687,6.8,14.9,172,0.9,29.8,0,123,123,587
2001,21820,1693,1873,23619,22513,228,12.3,185,10,5265,2702,2563,12,23.4,3053,1107,1946,4.9,13.6,2212,9.8,27.2,0,96,96,477
2002,21820,1703,1893,24236,23870,248,13.2,215,11.5,4497,1524,2973,6.4,18.8,3765,1163,2602,4.9,15.8,732,3,31.6,0,103,103,528
2003,21820,1760,1937,25041,24528,255,13.4,181,9.5,4319,1343,2976,5.5,17.6,3292,1232,2060,5,13.4,1027,4.2,26.8,0,97,97,535
2004,21820,1809,1999,26306,25527,252,12.9,173,8.8,4679,1982,2697,7.8,18.3,3121,878,2243,3.4,12.2,1558,6.1,24.4,0,112,112,639
2005,21820,1850,2049,26190,26224,223,11,159,7.9,3689,1136,2553,4.3,14.1,3757,772,2985,2.9,14.3,-68,-0.2,28.2,0,103,103,433
2006,21820,1875,2112,26736,26422,273,13.1,194,9.3,4335,1495,2840,5.7,16.4,3706,857,2849,3.2,14,629,2.4,28,0,116,116,452
2007,21820,1920,2170,27620,27153,279,13,232,10.8,4976,1503,3473,5.5,18.3,4041,1051,2990,3.9,14.9,935,3.4,29.8,0,139,141,650
2008,21820,1889,2135,27235,27302,214,10,221,10.3,3854,1332,2522,4.9,14.1,3987,949,3038,3.5,14.6,-133,-0.5,28.2,0,141,142,720
2009,21820,1839,2100,26520,26821,212,10,225,10.7,3350,987,2363,3.7,12.5,3951,1078,2873,4,14.7,-601,-2.2,25,0,127,127,504
2010,21820,1842,2116,27204,26834,201,9.5,186,8.8,4056,1019,3037,3.8,15.1,3316,880,2436,3.3,12.4,740,2.7,24.8,0,114,114,476
2011,21820,1832,2109,26939,27062,173,8.2,172,8.2,3108,1080,2028,4,11.5,3354,916,2438,3.4,12.4,-246,-0.9,23,0,99,99,492
2012,21820,1829,2098,26607,26768,192,9.1,198,9.4,3467,958,2509,3.6,13,3789,881,2908,3.3,14.2,-322,-1.2,26,0,93,95,408
2013,21820,1859,2125,27284,26937,213,10.1,194,9.2,3517,1094,2423,4.1,13.1,2823,747,2076,2.8,10.5,694,2.6,21,0,103,103,371
2014,21820,1832,2109,26948,26970,200,9.5,192,9.1,3667,1183,2484,4.4,13.6,3710,1002,2708,3.7,13.8,-43,-0.2,27.2,0,122,122,641
1977,22020,2909,3191,45159,44283,530,17,390,12.5,8714,3731,4983,8.4,19.7,6962,3217,3745,7.3,15.7,1752,4,31.4,0,253,255,2439
1978,22020,3004,3296,49091,47126,469,14.5,363,11.2,9790,2982,6808,6.3,20.8,5859,2342,3517,5,12.4,3931,8.4,24.8,0,262,262,1399
1979,22020,3073,3372,52508,50733,453,13.6,351,10.5,11173,3801,7372,7.5,22,7623,2457,5166,4.8,15,3550,7,30,0,247,247,1814
1980,22020,3020,3319,52941,52602,357,10.7,397,11.9,9299,2784,6515,5.3,17.7,8620,2352,6268,4.5,16.4,679,1.3,32.8,0,281,281,1647
1981,22020,2931,3210,53831,52763,366,11.3,422,13,10971,3211,7760,6.1,20.8,8834,3108,5726,5.9,16.7,2137,4.1,33.4,0,239,239,1550
1982,22020,2906,3241,49898,51746,429,13.3,356,11,7609,3079,4530,6,14.7,11305,2288,9017,4.4,21.8,-3696,-7.1,29.4,0,196,196,1243
1983,22020,2969,3292,48742,48962,351,10.7,327,10,7448,3066,4382,6.3,15.2,7888,3725,4163,7.6,16.1,-440,-0.9,30.4,0,198,198,1561
1984,22020,3098,3433,51557,50276,452,13.4,326,9.7,8750,4127,4623,8.2,17.4,6188,2409,3779,4.8,12.3,2562,5.1,24.6,0,191,192,1248
1985,22020,3220,3553,54073,53434,446,12.7,351,10,7898,2681,5217,5,14.8,6620,2738,3882,5.1,12.4,1278,2.4,24.8,0,226,226,1508
1986,22020,3290,3652,55618,54877,457,12.7,352,9.8,8698,3431,5267,6.3,15.8,7216,2648,4568,4.8,13.1,1482,2.7,26.2,0,235,235,1429
1987,22020,3433,3833,59089,57696,553,14.8,359,9.6,10435,4505,5930,7.8,18.1,7648,2972,4676,5.2,13.3,2787,4.8,26.6,0,229,230,1204
1988,22020,3419,3834,58729,58196,427,11.2,391,10.2,9431,3451,5980,5.9,16.2,8365,3600,4765,6.2,14.4,1066,1.8,28.8,0,260,260,1457
1989,22020,3453,3893,60332,59547,393,10.2,337,8.7,8499,2884,5615,4.8,14.3,6928,2323,4605,3.9,11.6,1571,2.7,23.2,0,229,229,1537
1990,22020,3508,3940,63882,62056,397,10.1,323,8.2,9709,2742,6967,4.4,15.6,6057,1885,4172,3,9.8,3652,5.8,19.6,0,223,224,1106
1991,22020,3580,4066,65316,64592,479,12,355,8.9,10477,3882,6595,6,16.2,9029,3016,6013,4.7,14,1448,2.2,28,0,217,218,2068
1992,22020,3615,4143,67186,66158,465,11.3,372,9.1,10013,3614,6399,5.5,15.1,7956,2675,5281,4,12,2057,3.1,24,0,248,248,1711
1993,22020,3749,4283,69656,68446,485,11.5,337,8,10373,3507,6866,5.1,15.2,7952,2608,5344,3.8,11.6,2421,3.6,23.2,0,218,219,1224
1994,22020,3886,4449,72911,71261,533,12.2,367,8.4,11032,3563,7469,5,15.5,7733,2606,5127,3.7,10.9,3299,4.6,21.8,0,249,250,1533
1995,22020,3965,4542,77773,75296,489,10.9,368,8.2,13574,4648,8926,6.2,18,8621,3509,5112,4.7,11.4,4953,6.6,22.8,0,242,242,1241
1996,22020,4045,4606,80812,79310,444,9.7,374,8.2,13596,5716,7880,7.2,17.1,10591,2778,7813,3.5,13.4,3005,3.7,26.8,0,241,241,1517
1997,22020,3992,4534,87268,84071,455,9.9,519,11.3,18170,5792,12378,6.9,21.6,11776,5506,6270,6.5,14,6394,7.6,28,0,345,345,3214
1998,22020,4076,4637,84420,85854,485,10.6,371,8.1,12349,3892,8457,4.5,14.4,15217,3718,11499,4.3,17.7,-2868,-3.3,28.8,0,239,239,2023
1999,22020,4076,4664,86056,85263,447,9.6,419,9,12407,4976,7431,5.8,14.6,10820,4506,6314,5.3,12.7,1587,1.9,25.4,0,254,254,1705
2000,22020,4097,4713,88023,87016,503,10.7,451,9.6,12830,4726,8104,5.4,14.7,10816,3863,6953,4.4,12.4,2014,2.3,24.8,0,266,266,2210
2001,22020,4164,4809,88843,88535,509,10.7,454,9.5,11715,4286,7429,4.8,13.2,11098,3094,8004,3.5,12.5,617,0.7,25,0,269,269,1804
2002,22020,4204,4885,88224,88522,542,11.2,458,9.5,13399,6146,7253,6.9,15.1,13995,5464,8531,6.2,15.8,-596,-0.7,30.2,0,242,242,1843
2003,22020,4253,4963,91700,89583,522,10.6,378,7.7,13551,5353,8198,6,15.1,9317,2930,6387,3.3,10.4,4234,4.7,20.8,0,239,239,1918
2004,22020,4330,5038,93537,92425,551,11,428,8.6,13887,4665,9222,5,15,11663,5873,5790,6.4,12.6,2224,2.4,25.2,0,271,271,1943
2005,22020,4489,5234,97832,95558,603,11.8,390,7.6,13557,4473,9084,4.7,14.2,9009,2561,6448,2.7,9.4,4548,4.8,18.8,0,266,266,1355
2006,22020,4580,5351,99754,98651,615,11.6,444,8.4,13879,3960,9919,4,14.1,11672,4290,7382,4.3,11.8,2207,2.3,23.6,0,289,289,1955
2007,22020,4754,5559,105124,103050,633,11.6,430,7.9,17271,7300,9971,7.1,16.8,13124,4205,8919,4.1,12.7,4147,4.1,25.4,0,237,238,2289
2008,22020,4826,5639,109891,107290,544,9.7,420,7.5,16194,5638,10556,5.3,15.1,10993,3752,7241,3.5,10.2,5201,4.9,20.4,0,272,273,3091
2009,22020,4791,5606,109807,109644,467,8.3,464,8.3,14522,5631,8891,5.1,13.2,14196,2676,11520,2.4,12.9,326,0.3,25.8,0,280,280,1586
2010,22020,4850,5676,107690,108520,529,9.4,413,7.3,12933,4155,8778,3.8,11.9,14593,4109,10484,3.8,13.4,-1660,-1.5,23.8,0,233,233,1739
2011,22020,4804,5672,108662,108071,477,8.4,454,8,13096,4727,8369,4.4,12.1,11914,3937,7977,3.6,11,1182,1.1,22,0,288,288,2579
2012,22020,4880,5750,113695,110936,551,9.7,477,8.4,16369,4831,11538,4.4,14.8,10851,4255,6596,3.8,9.8,5518,5,19.6,0,276,281,2535
2013,22020,4942,5841,114870,113999,505,8.7,405,7,15215,4893,10322,4.3,13.3,13473,4956,8517,4.3,11.8,1742,1.5,23.6,0,274,274,2276
2014,22020,5051,5952,118117,116264,527,9,387,6.6,15178,4565,10613,3.9,13.1,11471,3612,7859,3.1,9.9,3707,3.2,19.8,0,263,264,1678
1977,22140,1264,1367,16484,15796,287,21.9,179,13.6,4495,2348,2147,14.9,28.5,3119,844,2275,5.3,19.7,1376,8.8,39.4,0,130,130,579
1978,22140,1233,1342,19611,18021,243,17.9,257,19,6017,1841,4176,10.2,33.4,2836,1440,1396,8,15.7,3181,17.7,31.4,0,171,171,922
1979,22140,1350,1469,22516,21080,268,19.1,147,10.5,5762,1753,4009,8.3,27.3,2890,1045,1845,5,13.7,2872,13.6,27.4,0,6,6,66
1980,22140,1363,1487,22107,22268,221,15,191,12.9,5204,2250,2954,10.1,23.4,5526,1549,3977,7,24.8,-322,-1.4,46.8,0,134,134,818
1981,22140,1384,1514,24378,23097,260,17.4,221,14.7,6187,2037,4150,8.8,26.8,3624,1338,2286,5.8,15.7,2563,11.1,31.4,0,141,141,760
1982,22140,1470,1611,24008,24082,309,19.8,203,13,5616,2535,3081,10.5,23.3,5763,1890,3873,7.8,23.9,-147,-0.6,46.6,0,116,116,717
1983,22140,1512,1659,22807,23321,262,16,215,13.2,5241,2094,3147,9,22.5,6269,2040,4229,8.7,26.9,-1028,-4.4,45,0,134,134,858
1984,22140,1520,1675,22553,22751,263,15.8,242,14.5,4189,1794,2395,7.9,18.4,4584,1365,3219,6,20.1,-395,-1.7,36.8,0,165,165,667
1985,22140,1548,1706,23928,23545,251,14.8,218,12.9,4737,1384,3353,5.9,20.1,3970,1549,2421,6.6,16.9,767,3.2,33.8,0,142,142,822
1986,22140,1570,1719,24494,24203,232,13.6,211,12.3,5026,1675,3351,6.9,20.8,4443,1309,3134,5.4,18.4,583,2.4,36.8,0,124,124,666
1987,22140,1531,1682,22064,23239,211,12.4,231,13.6,3772,1505,2267,6.5,16.2,6121,1534,4587,6.6,26.3,-2349,-10.1,32.4,0,148,148,857
1988,22140,1499,1669,22010,21709,217,13,217,13,3701,1250,2451,5.8,17,3099,1162,1937,5.4,14.3,602,2.7,28.6,0,145,145,598
1989,22140,1489,1659,20978,21521,192,11.5,215,12.9,3982,1429,2553,6.6,18.5,5068,2076,2992,9.6,23.5,-1086,-5,37,0,140,143,1609
1990,22140,1528,1700,24177,22497,213,12.7,161,9.6,5828,1655,4173,7.4,25.9,2468,1098,1370,4.9,11,3360,14.9,22,0,106,106,653
1991,22140,1610,1799,26269,25243,236,13.5,139,7.9,5937,1737,4200,6.9,23.5,3885,1575,2310,6.2,15.4,2052,8.1,30.8,0,80,81,518
1992,22140,1605,1793,26343,26290,203,11.3,201,11.2,5457,2109,3348,8,20.8,5350,1560,3790,5.9,20.3,107,0.5,40.6,0,120,122,727
1993,22140,1691,1875,27835,27097,262,14.3,176,9.6,4910,1908,3002,7,18.1,3434,1086,2348,4,12.7,1476,5.4,25.4,0,125,125,671
1994,22140,1753,1951,29348,28639,252,13.2,176,9.2,5402,1965,3437,6.9,18.9,3983,1078,2905,3.8,13.9,1419,5,27.8,0,118,118,612
1995,22140,1799,1998,29490,29379,254,12.9,195,9.9,4570,1750,2820,6,15.6,4348,1407,2941,4.8,14.8,222,0.8,29.6,0,142,142,1036
1996,22140,1883,2101,31455,30444,309,15.1,201,9.8,5561,1943,3618,6.4,18.3,3539,1064,2475,3.5,11.6,2022,6.7,23.2,0,144,144,598
1997,22140,1907,2149,31815,31612,294,13.8,237,11.1,6396,2513,3883,7.9,20.2,5989,1819,4170,5.8,18.9,407,1.3,37.8,0,147,147,773
1998,22140,1920,2172,32092,31979,270,12.5,232,10.7,5458,2522,2936,7.9,17.1,5231,2038,3193,6.4,16.4,227,0.7,32.8,0,146,146,1099
1999,22140,1966,2225,34293,33214,235,10.7,182,8.3,6562,1588,4974,4.8,19.8,4403,1448,2955,4.4,13.3,2159,6.5,26.6,0,112,112,830
2000,22140,1965,2226,34058,34079,247,11.1,244,11,5453,2300,3153,6.7,16,5494,1449,4045,4.3,16.1,-41,-0.1,32,0,151,151,744
2001,22140,2011,2313,36165,35200,285,12.5,224,9.9,6387,2404,3983,6.8,18.1,4457,1444,3013,4.1,12.7,1930,5.4,25.4,0,118,118,730
2002,22140,2072,2348,34534,35273,293,12.6,254,10.9,6133,2511,3622,7.1,17.4,7611,1869,5742,5.3,21.6,-1478,-4.2,34.8,0,134,134,747
2003,22140,2093,2360,34773,34401,273,11.7,214,9.1,5632,2265,3367,6.6,16.4,4887,1336,3551,3.9,14.2,745,2.2,28.4,0,141,141,810
2004,22140,2121,2395,36369,35410,281,11.8,214,9,6399,2012,4387,5.7,18.1,4480,2053,2427,5.8,12.7,1919,5.4,25.4,0,132,132,822
2005,22140,2214,2508,37506,36885,311,12.7,180,7.4,5903,2079,3824,5.6,16,4660,1062,3598,2.9,12.6,1243,3.4,25.2,0,113,113,623
2006,22140,2277,2585,39730,38607,324,12.7,246,9.7,7190,2399,4791,6.2,18.6,4944,2015,2929,5.2,12.8,2246,5.8,25.6,0,155,155,1009
2007,22140,2283,2620,41303,40372,290,11.2,249,9.6,7733,2925,4808,7.2,19.2,5870,1856,4014,4.6,14.5,1863,4.7,29,0,154,154,1064
2008,22140,2320,2642,41508,41042,254,9.7,211,8,5858,1572,4286,3.8,14.3,4925,1239,3686,3,12,933,2.3,24,0,135,136,623
2009,22140,2314,2640,41012,41201,236,8.9,222,8.4,4802,1363,3439,3.3,11.7,5179,1028,4151,2.5,12.6,-377,-0.9,23.4,0,162,162,696
2010,22140,2279,2589,37925,39334,186,7.1,225,8.6,3457,1077,2380,2.7,8.8,6274,958,5316,2.4,16,-2817,-7.2,17.6,0,136,136,540
2011,22140,2259,2586,37595,37708,242,9.4,228,8.8,4315,1477,2838,3.9,11.4,4541,1230,3311,3.3,12,-226,-0.6,22.8,0,163,163,877
2012,22140,2271,2626,38447,37932,253,9.7,215,8.3,5021,1589,3432,4.2,13.2,3990,1206,2784,3.2,10.5,1031,2.7,21,0,142,143,619
2013,22140,2269,2621,40224,39277,195,7.4,209,8,6263,2202,4061,5.6,15.9,4368,1179,3189,3,11.1,1895,4.8,22.2,0,136,136,670
2014,22140,2251,2598,39331,39635,199,7.6,206,7.9,4106,997,3109,2.5,10.4,4713,901,3812,2.3,11.9,-607,-1.5,20.8,0,140,140,432
1977,22180,3024,3422,45127,45060,670,20.1,488,14.6,10484,6114,4370,13.6,23.3,10350,3851,6499,8.5,23,134,0.3,46,0,345,345,2556
1978,22180,3076,3466,46839,45973,526,15.3,475,13.8,8681,3347,5334,7.3,18.9,6949,2546,4403,5.5,15.1,1732,3.8,30.2,0,326,330,1476
1979,22180,3039,3424,49853,48283,483,14,503,14.6,9657,3317,6340,6.9,20,6517,2844,3673,5.9,13.5,3140,6.5,27,0,343,345,1711
1980,22180,3062,3474,49009,49396,513,14.9,450,13,8708,4210,4498,8.5,17.6,9481,4669,4812,9.5,19.2,-773,-1.6,35.2,0,327,328,3683
1981,22180,3023,3417,46352,47634,466,13.5,496,14.4,7225,3333,3892,7,15.2,9789,4314,5475,9.1,20.6,-2564,-5.4,30.4,0,287,287,1924
1982,22180,3063,3500,46900,46574,496,14.3,381,11,8060,4090,3970,8.8,17.3,7408,2235,5173,4.8,15.9,652,1.4,31.8,0,222,222,1190
1983,22180,2927,3370,47685,47225,406,11.8,505,14.7,7731,3039,4692,6.4,16.4,6810,3456,3354,7.3,14.4,921,2,28.8,0,281,282,1619
1984,22180,3322,3766,52240,50127,599,16.8,267,7.5,9833,4087,5746,8.2,19.6,5606,2041,3565,4.1,11.2,4227,8.4,22.4,0,8,8,65
1985,22180,3403,3872,55312,53855,554,14.5,450,11.8,9867,4042,5825,7.5,18.3,6953,2869,4084,5.3,12.9,2914,5.4,25.8,0,294,294,1145
1986,22180,3534,4036,57430,56232,570,14.4,386,9.8,9645,4180,5465,7.4,17.2,7248,2210,5038,3.9,12.9,2397,4.3,25.8,0,243,243,1242
1987,22180,3659,4216,63301,61606,657,15.9,469,11.4,11899,4620,7279,7.5,19.3,8509,3741,4768,6.1,13.8,3390,5.5,27.6,0,309,309,1778
1988,22180,3672,4273,65281,64206,597,14.1,525,12.4,12335,5183,7152,8.1,19.2,10184,4492,5692,7,15.9,2151,3.3,31.8,0,324,324,1616
1989,22180,3743,4374,66988,66237,592,13.7,490,11.3,10980,5127,5853,7.7,16.6,9477,3667,5810,5.5,14.3,1503,2.3,28.6,0,315,315,1940
1990,22180,3762,4414,70545,68696,500,11.4,427,9.7,11516,4315,7201,6.3,16.8,7817,2968,4849,4.3,11.4,3699,5.4,22.8,0,270,273,1434
1991,22180,3721,4426,66265,68356,483,10.9,475,10.7,7928,3819,4109,5.6,11.6,12109,3249,8860,4.8,17.7,-4181,-6.1,23.2,0,297,300,1770
1992,22180,3794,4528,70200,68183,564,12.6,457,10.2,12285,4129,8156,6.1,18,8251,3553,4698,5.2,12.1,4034,5.9,24.2,0,272,273,1830
1993,22180,3928,4655,74891,72531,541,11.8,408,8.9,12507,4770,7737,6.6,17.2,7786,3229,4557,4.5,10.7,4721,6.5,21.4,0,275,275,1561
1994,22180,4031,4760,75867,75317,582,12.4,464,9.9,10717,3560,7157,4.7,14.2,9616,3794,5822,5,12.8,1101,1.4,25.6,0,322,322,2252
1995,22180,4161,4870,78239,77039,574,11.9,452,9.4,10464,4280,6184,5.6,13.6,8063,2577,5486,3.3,10.5,2401,3.1,21,0,293,295,1544
1996,22180,4238,4952,80492,79346,610,12.4,512,10.4,11994,4411,7583,5.6,15.1,9702,3448,6254,4.3,12.2,2292,2.9,24.4,0,346,346,1687
1997,22180,4318,5060,82510,81559,658,13.1,557,11.1,13199,4600,8599,5.6,16.2,11297,4679,6618,5.7,13.9,1902,2.3,27.8,0,362,362,2835
1998,22180,4305,5052,90641,86573,574,11.4,576,11.4,18789,9463,9326,10.9,21.7,10652,4163,6489,4.8,12.3,8137,9.4,24.6,0,396,396,1850
1999,22180,4302,5115,92888,91743,584,11.5,501,9.9,17049,8551,8498,9.3,18.6,14758,3709,11049,4,16.1,2291,2.5,32.2,0,330,330,2288
2000,22180,4256,5075,92891,92888,534,10.5,587,11.5,12527,4642,7885,5,13.5,12520,4627,7893,5,13.5,7,0,27,0,360,360,2406
2001,22180,4220,5053,90504,91811,541,10.7,598,11.8,11524,5191,6333,5.7,12.6,14137,5229,8908,5.7,15.4,-2613,-2.8,25.2,0,344,344,1979
2002,22180,4245,5097,88181,89249,619,12.2,571,11.3,12953,5903,7050,6.6,14.5,15089,4915,10174,5.5,16.9,-2136,-2.4,29,0,293,293,1786
2003,22180,4268,5151,90436,88839,564,11.1,429,8.4,14348,5370,8978,6,16.2,11154,3029,8125,3.4,12.6,3194,3.6,25.2,0,318,318,2045
2004,22180,4339,5241,92274,91099,566,10.9,434,8.4,13640,3560,10080,3.9,15,11290,3397,7893,3.7,12.4,2350,2.6,24.8,0,292,292,1967
2005,22180,4469,5408,92731,92408,647,12.2,440,8.3,13836,5097,8739,5.5,15,13189,2984,10205,3.2,14.3,647,0.7,28.6,0,291,293,1697
2006,22180,4549,5528,95307,93513,700,12.9,484,8.9,15758,6754,9004,7.2,16.9,12169,3682,8487,3.9,13,3589,3.9,26,0,326,326,2364
2007,22180,4659,5646,101951,98491,624,11.2,522,9.3,21379,6800,14579,6.9,21.7,14458,4198,10260,4.3,14.7,6921,7,29.4,0,319,327,1887
2008,22180,4638,5628,101043,101196,509,9.1,480,8.6,14503,4330,10173,4.3,14.3,14808,3505,11303,3.5,14.6,-305,-0.3,28.6,0,346,346,2430
2009,22180,4563,5609,96813,98704,526,9.4,497,8.9,10922,3942,6980,4,11.1,14703,4266,10437,4.3,14.9,-3781,-3.8,22.2,0,364,364,2212
2010,22180,4586,5627,98114,97431,547,9.8,515,9.2,13734,5895,7839,6.1,14.1,12368,3538,8830,3.6,12.7,1366,1.4,25.4,0,338,338,2322
2011,22180,4494,5568,99976,98904,478,8.6,496,8.9,12708,3620,9088,3.7,12.8,10564,3158,7406,3.2,10.7,2144,2.1,21.4,0,357,357,2373
2012,22180,4549,5660,99835,99683,542,9.7,454,8.1,13316,4353,8963,4.4,13.4,13011,3709,9302,3.7,13.1,305,0.3,26.2,0,282,283,1809
2013,22180,4520,5647,99272,99026,459,8.2,455,8.1,11955,3563,8392,3.6,12.1,11463,3524,7939,3.6,11.6,492,0.5,23.2,0,304,306,1908
2014,22180,4477,5602,98404,98583,462,8.2,466,8.3,11768,4643,7125,4.7,11.9,12125,3060,9065,3.1,12.3,-357,-0.4,23.8,0,303,314,1713
1977,22220,3133,3410,46538,45086,714,21.6,480,14.5,9417,3714,5703,8.2,20.9,6512,2850,3662,6.3,14.4,2905,6.5,28.8,0,345,347,1778
1978,22220,3070,3349,48888,47640,577,17.1,600,17.8,9892,3259,6633,6.8,20.8,7395,3844,3551,8.1,15.5,2497,5.3,31,0,362,367,1781
1979,22220,3351,3643,54197,51576,633,18.1,365,10.4,11415,4692,6723,9.1,22.1,6173,2009,4164,3.9,12,5242,10.1,24,0,39,39,150
1980,22220,3370,3651,56335,55235,552,15.1,526,14.4,11153,3704,7449,6.7,20.2,8952,3160,5792,5.7,16.2,2201,4,32.4,0,363,363,1701
1981,22220,3289,3584,55491,54925,572,15.9,573,15.9,10035,4776,5259,8.7,18.3,8903,3146,5757,5.7,16.2,1132,2.1,32.4,0,395,396,2005
1982,22220,3314,3690,55417,55426,627,17.2,472,13,9331,5033,4298,9.1,16.8,9348,2371,6977,4.3,16.9,-17,-0.1,33.6,0,284,284,1247
1983,22220,3443,3812,54680,54908,540,14.4,436,11.6,8606,3353,5253,6.1,15.7,9062,2722,6340,5,16.5,-456,-0.8,31.4,0,303,303,1450
1984,22220,3600,3963,61623,58153,643,16.5,491,12.6,13142,3860,9282,6.6,22.6,6201,3095,3106,5.3,10.7,6941,11.9,21.4,0,354,356,1715
1985,22220,3763,4138,65626,64652,634,15.6,492,12.1,12406,4591,7815,7.1,19.2,10457,4823,5634,7.5,16.2,1949,3,32.4,0,356,356,3166
1986,22220,3858,4251,71629,68538,670,16,527,12.6,16299,8257,8042,12,23.8,10116,3713,6403,5.4,14.8,6183,9,29.6,0,378,378,2433
1987,22220,3971,4414,74893,73551,743,17.1,561,12.9,14076,4777,9299,6.5,19.1,11391,4660,6731,6.3,15.5,2685,3.6,31,0,396,398,2483
1988,22220,3996,4483,75270,73915,648,14.6,514,11.6,13363,5033,8330,6.8,18.1,10652,3639,7013,4.9,14.4,2711,3.7,28.8,0,369,369,2072
1989,22220,4127,4626,82937,79017,635,13.9,499,11,17183,6846,10337,8.7,21.7,9343,4252,5091,5.4,11.8,7840,9.9,23.6,0,358,366,2287
1990,22220,4290,4812,88985,86384,672,14.2,454,9.6,14710,5383,9327,6.2,17,9507,2183,7324,2.5,11,5203,6,22,0,341,341,1444
1991,22220,4466,5055,97525,93283,732,14.8,493,10,20135,10102,10033,10.8,21.6,11651,4108,7543,4.4,12.5,8484,9.1,25,0,342,342,2218
1992,22220,4654,5307,96788,97141,815,15.7,540,10.4,17875,6150,11725,6.3,18.4,18581,7079,11502,7.3,19.1,-706,-0.7,36.8,0,394,398,3273
1993,22220,4946,5605,103789,100212,851,15.6,523,9.6,19788,7206,12582,7.2,19.7,12634,4173,8461,4.2,12.6,7154,7.1,25.2,0,375,377,2299
1994,22220,5219,6037,110708,107154,1010,17.4,566,9.7,23306,10970,12336,10.2,21.8,16197,9336,6861,8.7,15.1,7109,6.7,30.2,0,417,419,3027
1995,22220,5477,6328,116063,113370,977,15.8,660,10.7,20035,6949,13086,6.1,17.7,14648,7504,7144,6.6,12.9,5387,4.8,25.8,0,464,464,5018
1996,22220,5651,6557,117418,116640,955,14.8,705,10.9,17916,6831,11085,5.9,15.4,16362,4553,11809,3.9,14,1554,1.4,28,0,517,518,3033
1997,22220,5809,6682,122236,117232,1017,15.3,764,11.5,26596,8685,17911,7.4,22.7,16589,6331,10258,5.4,14.2,10007,8.5,28.4,0,513,513,3433
1998,22220,5796,6883,127540,127908,967,14.3,873,12.9,20430,10366,10064,8.1,16,21165,10919,10246,8.5,16.5,-735,-0.5,32,0,615,615,3062
1999,22220,5930,7159,135592,131706,1043,14.9,768,10.9,24473,10095,14378,7.7,18.6,16700,6021,10679,4.6,12.7,7773,5.9,25.4,0,531,531,3127
2000,22220,6021,7365,144544,139256,998,13.7,788,10.9,26004,10875,15129,7.8,18.7,15428,4738,10690,3.4,11.1,10576,7.6,22.2,0,491,491,2290
2001,22220,6148,7534,146256,145636,951,12.8,842,11.3,23666,8590,15076,5.9,16.3,22426,7576,14850,5.2,15.4,1240,0.9,30.8,0,520,520,2655
2002,22220,6349,7807,157442,152045,1179,15.4,892,11.6,34767,14342,20425,9.4,22.9,23973,8136,15837,5.4,15.8,10794,7.1,31.6,0,498,499,2736
2003,22220,6662,8218,167348,161853,1176,14.7,635,8,28464,9168,19296,5.7,17.6,17473,4414,13059,2.7,10.8,10991,6.8,21.6,0,460,460,2580
2004,22220,6992,8618,171643,169013,1202,14.3,741,8.8,25681,9771,15910,5.8,15.2,20421,5890,14531,3.5,12.1,5260,3.1,24.2,0,501,501,3196
2005,22220,7383,9127,180350,175866,1372,15.5,810,9.1,29638,12170,17468,6.9,16.9,20670,8441,12229,4.8,11.8,8968,5.1,23.6,0,601,603,5493
2006,22220,7504,9390,187339,182996,1320,14.3,955,10.3,28909,10931,17978,6,15.8,20223,7316,12907,4,11.1,8686,4.7,22.2,0,731,731,4616
2007,22220,7713,9790,186660,186794,1360,14.2,951,9.9,32291,13391,18900,7.2,17.3,32558,5952,26606,3.2,17.4,-267,-0.1,34.6,0,663,666,3328
2008,22220,7664,9857,186655,186090,1130,11.5,966,9.9,26502,10091,16411,5.4,14.2,25372,5147,20225,2.8,13.6,1130,0.6,27.2,0,741,741,3616
2009,22220,7375,9594,176010,181044,997,10.3,1171,12.1,23487,9889,13598,5.5,13,33554,9222,24332,5.1,18.5,-10067,-5.5,26,0,799,799,5160
2010,22220,7338,9592,173990,174490,975,10.2,911,9.5,22657,7936,14721,4.5,13,23656,6269,17387,3.6,13.6,-999,-0.6,26,0,602,602,3906
2011,22220,7224,9542,182365,177879,1003,10.5,961,10.1,30556,10452,20104,5.9,17.2,21583,5888,15695,3.3,12.1,8973,5.1,24.2,0,638,646,3499
2012,22220,7354,9711,181503,181463,988,10.3,843,8.8,21655,7496,14159,4.1,11.9,21574,7866,13708,4.3,11.9,81,0,23.8,0,523,527,3319
2013,22220,7509,9827,182823,182085,926,9.5,830,8.5,23327,7366,15961,4,12.8,21851,9269,12582,5.1,12,1476,0.8,24,0,534,534,2933
2014,22220,7611,9968,197513,189706,960,9.7,760,7.7,32533,9731,22802,5.1,17.1,16918,3804,13114,2,8.9,15615,8.2,17.8,0,547,548,2227
1977,22380,1125,1279,12982,12193,258,20.8,174,14,3864,1776,2088,14.6,31.7,2285,894,1391,7.3,18.7,1579,13,37.4,0,131,133,693
1978,22380,1094,1243,13342,13143,192,15.2,218,17.3,3422,1033,2389,7.9,26,3024,1527,1497,11.6,23,398,3,46,0,125,129,1071
1979,22380,1212,1362,15551,14466,216,16.6,107,8.2,4339,1865,2474,12.9,30,2169,759,1410,5.2,15,2170,15,30,1,2,2,
1980,22380,1275,1434,17107,16312,258,18.5,176,12.6,4535,2358,2177,14.5,27.8,2945,890,2055,5.5,18.1,1590,9.7,36.2,0,131,131,637
1981,22380,1289,1442,16915,16960,254,17.7,233,16.2,4126,1843,2283,10.9,24.3,4216,1519,2697,9,24.9,-90,-0.6,48.6,0,144,144,764
1982,22380,1318,1490,17403,17166,262,17.9,204,13.9,3869,1918,1951,11.2,22.5,3394,1273,2121,7.4,19.8,475,2.7,39.6,0,99,99,513
1983,22380,1363,1555,17359,17433,238,15.6,181,11.9,3809,2066,1743,11.9,21.8,3956,1037,2919,5.9,22.7,-147,-0.9,43.6,0,112,112,700
1984,22380,1451,1657,18922,18124,266,16.6,166,10.3,4445,1598,2847,8.8,24.5,2848,958,1890,5.3,15.7,1597,8.8,31.4,0,89,89,385
1985,22380,1535,1744,20016,19444,293,17.2,197,11.6,4561,1952,2609,10,23.5,3416,1626,1790,8.4,17.6,1145,5.9,35.2,0,120,120,718
1986,22380,1614,1828,21737,20851,299,16.8,204,11.4,4800,2153,2647,10.3,23,3028,1349,1679,6.5,14.5,1772,8.5,29,0,126,126,663
1987,22380,1684,1917,23305,22885,318,16.9,229,12.2,5501,2617,2884,11.4,24,4660,1995,2665,8.7,20.4,841,3.6,40.8,0,132,132,1043
1988,22380,1728,1969,25095,24203,284,14.6,224,11.5,5991,2558,3433,10.6,24.8,4206,1792,2414,7.4,17.4,1785,7.4,34.8,0,147,147,738
1989,22380,1759,2014,26274,25657,289,14.5,236,11.9,5432,2179,3253,8.5,21.2,4197,1601,2596,6.2,16.4,1235,4.8,32.8,0,143,143,664
1990,22380,1840,2107,27873,27067,319,15.5,211,10.2,5470,2174,3296,8,20.2,3857,1319,2538,4.9,14.2,1613,6,28.4,0,130,130,730
1991,22380,1950,2214,27778,27826,312,14.4,208,9.6,4907,1858,3049,6.7,17.6,5002,1529,3473,5.5,18,-95,-0.4,35.2,0,123,123,635
1992,22380,2028,2282,28744,28243,314,13.9,237,10.5,5782,2804,2978,9.9,20.5,4780,1721,3059,6.1,16.9,1002,3.6,33.8,0,133,134,834
1993,22380,2144,2427,29659,29174,368,15.6,213,9,6752,2586,4166,8.9,23.1,5782,2045,3737,7,19.8,970,3.3,39.6,0,133,133,659
1994,22380,2268,2573,31243,30386,393,15.7,234,9.4,5799,2454,3345,8.1,19.1,4084,1426,2658,4.7,13.4,1715,5.7,26.8,0,154,154,658
1995,22380,2407,2717,32594,31844,402,15.2,240,9.1,6170,2543,3627,8,19.4,4669,1702,2967,5.3,14.7,1501,4.7,29.4,0,160,160,1126
1996,22380,2472,2781,35151,33853,384,14,302,11,7817,2837,4980,8.4,23.1,5221,1851,3370,5.5,15.4,2596,7.7,30.8,0,203,203,1066
1997,22380,2573,2859,35809,35453,427,15.1,360,12.7,8952,3250,5702,9.2,25.3,8240,4450,3790,12.6,23.2,712,2.1,46.4,0,197,197,1529
1998,22380,2611,2877,37534,36626,383,13.4,353,12.3,7708,2797,4911,7.6,21,5891,2078,3813,5.7,16.1,1817,4.9,32.2,0,218,218,1178
1999,22380,2649,2924,37480,37515,378,13,329,11.3,6354,2457,3897,6.5,16.9,6423,2853,3570,7.6,17.1,-69,-0.2,33.8,0,222,222,1235
2000,22380,2676,2980,38532,38081,384,13,341,11.6,7853,3620,4233,9.5,20.6,6951,2449,4502,6.4,18.3,902,2.3,36.6,0,198,198,973
2001,22380,2741,3045,38585,38601,404,13.4,363,12,6392,2426,3966,6.3,16.6,6423,2872,3551,7.4,16.6,-31,0,33.2,0,198,198,1469
2002,22380,2794,3112,38597,38630,433,14.1,366,11.9,8029,2870,5159,7.4,20.8,8094,3229,4865,8.4,21,-65,-0.2,41.6,0,189,189,1122
2003,22380,2807,3118,39395,38739,389,12.6,319,10.3,7865,3372,4493,8.7,20.3,6553,3058,3495,7.9,16.9,1312,3.4,33.8,0,208,208,932
2004,22380,2858,3211,42203,40750,419,13.3,287,9.1,7550,3406,4144,8.4,18.5,4644,1386,3258,3.4,11.4,2906,7.1,22.8,0,188,188,884
2005,22380,2911,3282,44598,43237,395,12.2,288,8.9,7886,2725,5161,6.3,18.2,5163,1653,3510,3.8,11.9,2723,6.3,23.8,0,199,199,850
2006,22380,2984,3368,46413,45461,442,13.3,330,9.9,8171,2561,5610,5.6,18,6266,2328,3938,5.1,13.8,1905,4.2,27.6,0,236,236,1787
2007,22380,3049,3472,47740,46965,433,12.7,335,9.8,8797,2986,5811,6.4,18.7,7247,2557,4690,5.4,15.4,1550,3.3,30.8,0,200,200,1373
2008,22380,2994,3394,46286,46796,383,11.2,416,12.2,6444,1973,4471,4.2,13.8,7464,2930,4534,6.3,16,-1020,-2.2,27.6,0,251,251,1108
2009,22380,2863,3234,44263,45157,282,8.5,408,12.3,5697,1846,3851,4.1,12.6,7484,2044,5440,4.5,16.6,-1787,-4,25.2,0,257,257,1165
2010,22380,2809,3182,42874,43499,266,8.3,311,9.7,4587,1772,2815,4.1,10.5,5837,1459,4378,3.4,13.4,-1250,-2.9,21,0,177,177,799
2011,22380,2769,3148,44206,43535,279,8.8,300,9.5,6288,2102,4186,4.8,14.4,4946,1772,3174,4.1,11.4,1342,3,22.8,0,199,199,1295
2012,22380,2711,3093,44049,44094,263,8.4,319,10.2,5705,1666,4039,3.8,12.9,5794,1860,3934,4.2,13.1,-89,-0.2,25.8,0,176,177,871
2013,22380,2730,3108,44492,44275,295,9.5,287,9.3,5541,1817,3724,4.1,12.5,5107,1306,3801,2.9,11.5,434,1,23,0,173,173,732
2014,22380,2737,3123,47059,45642,299,9.6,266,8.6,6847,2063,4784,4.5,15,4012,1488,2524,3.3,8.8,2835,6.2,17.6,0,179,179,1069
1977,22420,5393,6164,146949,140993,1049,17.4,786,13,24322,7142,17180,5.1,17.3,12410,5728,6682,4.1,8.8,11912,8.5,17.6,0,487,491,3402
1978,22420,5520,6291,155940,151410,845,13.6,704,11.3,19415,5443,13972,3.6,12.8,10355,4684,5671,3.1,6.8,9060,6,13.6,0,471,472,2232
1979,22420,5646,6436,170085,162922,884,13.9,702,11,26259,6769,19490,4.2,16.1,11933,4401,7532,2.7,7.3,14326,8.8,14.6,0,487,488,2593
1980,22420,5606,6412,150536,160162,818,12.7,798,12.4,13199,5806,7393,3.6,8.2,32450,5735,26715,3.6,20.3,-19251,-12.1,16.4,0,538,542,3267
1981,22420,5323,6057,146791,148383,671,10.8,962,15.4,14684,4987,9697,3.4,9.9,17867,6489,11378,4.4,12,-3183,-2.1,19.8,0,522,532,2764
1982,22420,5277,6114,133875,140341,838,13.8,710,11.7,13888,7783,6105,5.5,9.9,26819,6259,20560,4.5,19.1,-12931,-9.2,19.8,0,390,390,3807
1983,22420,5444,6275,130653,132043,715,11.5,626,10.1,12791,4766,8025,3.6,9.7,15570,6599,8971,5,11.8,-2779,-2.1,19.4,0,395,396,2223
1984,22420,5662,6497,142258,136440,816,12.8,617,9.7,22752,6644,16108,4.9,16.7,11115,5629,5486,4.1,8.1,11637,8.6,16.2,0,384,384,4071
1985,22420,5808,6637,144927,143696,878,13.4,750,11.4,22817,6755,16062,4.7,15.9,20354,4587,15767,3.2,14.2,2463,1.7,28.4,0,485,487,2605
1986,22420,5993,6851,153051,148888,949,14.1,716,10.6,28401,11920,16481,8,19.1,20075,9537,10538,6.4,13.5,8326,5.6,27,0,475,476,2628
1987,22420,6169,7138,154283,153841,1046,14.9,766,10.9,22905,8925,13980,5.8,14.9,22021,6230,15791,4,14.3,884,0.6,28.6,0,513,514,3867
1988,22420,6184,7162,141674,147761,882,12.3,824,11.5,18671,8620,10051,5.8,12.6,30845,7264,23581,4.9,20.9,-12174,-8.3,25.2,0,538,538,3814
1989,22420,6274,7365,148048,144817,945,13,733,10.1,22246,8400,13846,5.8,15.4,15783,5597,10186,3.9,10.9,6463,4.5,21.8,0,499,499,3662
1990,22420,6298,7444,150025,149070,797,10.8,683,9.2,21486,6472,15014,4.3,14.4,19576,5608,13968,3.8,13.1,1910,1.3,26.2,0,467,469,3006
1991,22420,6410,7583,143555,146875,822,10.9,693,9.2,17813,8178,9635,5.6,12.1,24453,4996,19457,3.4,16.6,-6640,-4.5,24.2,0,450,460,3393
1992,22420,6446,7648,147135,145302,833,10.9,730,9.6,22511,5522,16989,3.8,15.5,18844,6079,12765,4.2,13,3667,2.5,26,0,453,455,2399
1993,22420,6471,7664,147522,147265,768,10,739,9.7,19368,5664,13704,3.8,13.2,18853,5487,13366,3.7,12.8,515,0.4,25.6,0,490,492,2996
1994,22420,6547,7771,145025,146190,819,10.6,703,9.1,27361,15237,12124,10.4,18.7,29690,14629,15061,10,20.3,-2329,-1.6,37.4,0,480,482,3185
1995,22420,6749,7999,149611,147240,914,11.6,658,8.3,21750,8049,13701,5.5,14.8,17008,4431,12577,3,11.6,4742,3.2,23.2,0,429,429,2386
1996,22420,6853,8111,147337,148435,857,10.6,716,8.9,19244,7182,12062,4.8,13,21440,5693,15747,3.8,14.4,-2196,-1.4,26,0,490,490,3300
1997,22420,6928,8238,146123,146788,975,11.9,850,10.4,21119,8301,12818,5.7,14.4,22448,8237,14211,5.6,15.3,-1329,-0.9,28.8,0,509,509,3389
1998,22420,6858,8171,145824,145960,834,10.2,875,10.7,19227,6022,13205,4.1,13.2,19498,5715,13783,3.9,13.4,-271,-0.2,26.4,0,587,587,2961
1999,22420,6751,8088,149849,149369,756,9.3,822,10.1,23520,9913,13607,6.6,15.7,22560,7166,15394,4.8,15.1,960,0.6,30.2,0,532,532,3197
2000,22420,6779,8098,150269,150428,799,9.9,792,9.8,25577,12393,13184,8.2,17,25895,11294,14601,7.5,17.2,-318,-0.2,34,0,482,482,3063
2001,22420,6724,8095,146035,148328,777,9.6,843,10.4,19134,6664,12470,4.5,12.9,23719,8798,14921,5.9,16,-4585,-3.1,25.8,0,466,468,2691
2002,22420,6646,7986,141762,143241,893,11.1,986,12.3,23441,8426,15015,5.9,16.4,26399,10682,15717,7.5,18.4,-2958,-2,32.8,0,493,495,2404
2003,22420,6575,7894,139949,139803,800,10.1,745,9.4,19878,7726,12152,5.5,14.2,19586,4966,14620,3.6,14,292,0.2,28,0,479,482,3137
2004,22420,6606,7896,140946,140111,805,10.2,748,9.5,19562,6134,13428,4.4,14,17892,5972,11920,4.3,12.8,1670,1.2,25.6,0,477,478,2868
2005,22420,6586,7903,135388,137709,814,10.3,730,9.3,16692,6788,9904,4.9,12.1,21334,5796,15538,4.2,15.5,-4642,-3.4,24.2,0,494,499,3253
2006,22420,6458,7833,133418,134028,728,9.3,719,9.2,17154,5989,11165,4.5,12.8,18374,6200,12174,4.6,13.7,-1220,-0.9,25.6,0,505,505,3039
2007,22420,6405,7781,128277,130622,761,9.8,793,10.2,17375,7575,9800,5.8,13.3,22065,5856,16209,4.5,16.9,-4690,-3.6,26.6,0,490,495,3551
2008,22420,6215,7569,121431,123919,638,8.4,771,10.1,12474,4074,8400,3.3,10.1,17449,4447,13002,3.6,14.1,-4975,-4,20.2,0,570,573,3107
2009,22420,5895,7180,118246,119292,531,7.2,867,11.8,18126,9899,8227,8.3,15.2,20218,5902,14316,4.9,16.9,-2092,-1.7,30.4,0,528,528,3337
2010,22420,5759,7043,116436,116957,564,7.9,643,9.1,12931,4079,8852,3.5,11.1,13973,3180,10793,2.7,11.9,-1042,-0.8,22.2,0,413,413,1887
2011,22420,5670,6989,113627,114583,610,8.7,637,9.1,13136,3905,9231,3.4,11.5,15048,4567,10481,4,13.1,-1912,-1.6,23,0,440,440,2783
2012,22420,5768,7092,122779,118269,666,9.5,582,8.3,22281,5676,16605,4.8,18.8,13260,3801,9459,3.2,11.2,9021,7.6,22.4,0,313,318,1548
2013,22420,5688,7012,123173,122855,515,7.3,590,8.4,13521,4449,9072,3.6,11,12884,3698,9186,3,10.5,637,0.5,21,0,398,398,2387
2014,22420,5657,6954,122513,122503,573,8.2,566,8.1,13437,4181,9256,3.4,11,13417,5326,8091,4.3,11,20,0,22,0,397,398,3352
1977,22500,2848,3110,45013,44995,523,17.3,362,11.9,6544,3007,3537,6.7,14.5,6507,2053,4454,4.6,14.5,37,0,29,0,265,265,1683
1978,22500,2909,3179,49229,47119,458,14.6,388,12.3,8783,2883,5900,6.1,18.6,4562,1773,2789,3.8,9.7,4221,8.9,19.4,0,280,281,1274
1979,22500,2920,3197,49985,49440,410,12.9,363,11.4,7053,2417,4636,4.9,14.3,5963,2415,3548,4.9,12.1,1090,2.2,24.2,0,279,282,1891
1980,22500,2939,3231,49253,49621,412,12.8,376,11.7,6543,2624,3919,5.3,13.2,7278,3542,3736,7.1,14.7,-735,-1.5,26.4,0,273,273,1142
1981,22500,2761,3036,46780,47519,324,10.4,482,15.4,6421,2955,3466,6.2,13.5,7899,4020,3879,8.5,16.6,-1478,-3.1,27,0,289,293,1398
1982,22500,2768,3084,47827,47258,414,13.5,334,10.9,7731,3973,3758,8.4,16.4,6593,1575,5018,3.3,14,1138,2.4,28,0,206,206,945
1983,22500,2627,2947,46254,46778,314,10.4,414,13.7,6094,2683,3411,5.7,13,7142,2368,4774,5.1,15.3,-1048,-2.3,26,0,234,234,1024
1984,22500,2947,3280,52288,49335,463,14.9,200,6.4,9757,4021,5736,8.2,19.8,3851,1101,2750,2.2,7.8,5906,12,15.6,0,7,7,24
1985,22500,3025,3363,53147,53285,409,12.3,341,10.3,7347,2244,5103,4.2,13.8,7623,2541,5082,4.8,14.3,-276,-0.5,27.6,0,215,217,1049
1986,22500,3088,3403,56593,54847,411,12.2,363,10.7,10581,2717,7864,5,19.3,7088,2972,4116,5.4,12.9,3493,6.4,25.8,0,220,220,1294
1987,22500,3138,3489,58712,57859,467,13.5,367,10.6,10488,3602,6886,6.2,18.1,8782,2382,6400,4.1,15.2,1706,2.9,30.4,0,224,224,1357
1988,22500,3160,3516,59700,58423,418,12,381,10.9,9795,4264,5531,7.3,16.8,7240,2982,4258,5.1,12.4,2555,4.4,24.8,0,245,245,1535
1989,22500,3221,3619,62831,61362,429,12,319,8.9,10113,3445,6668,5.6,16.5,7174,2083,5091,3.4,11.7,2939,4.8,23.4,0,213,213,1016
1990,22500,3272,3666,65768,64209,414,11.4,326,9,9905,2918,6987,4.5,15.4,6786,2085,4701,3.2,10.6,3119,4.8,21.2,0,224,224,1082
1991,22500,3345,3774,64168,64690,458,12.3,352,9.5,8985,4389,4596,6.8,13.9,10029,2688,7341,4.2,15.5,-1044,-1.6,27.8,0,201,206,1342
1992,22500,3357,3790,63825,64000,447,11.8,403,10.6,8445,2894,5551,4.5,13.2,8795,3400,5395,5.3,13.7,-350,-0.5,26.4,0,270,272,1668
1993,22500,3370,3815,67042,65337,417,11,380,10,10208,2547,7661,3.9,15.6,6798,1779,5019,2.7,10.4,3410,5.2,20.8,0,274,275,1053
1994,22500,3438,3898,67989,67570,431,11.2,336,8.7,9828,2899,6929,4.3,14.5,8990,3793,5197,5.6,13.3,838,1.2,26.6,0,235,236,2462
1995,22500,3485,3952,70271,69192,463,11.8,408,10.4,11464,5217,6247,7.5,16.6,9306,4564,4742,6.6,13.4,2158,3.2,26.8,0,287,294,1659
1996,22500,3564,4053,72454,71434,471,11.8,363,9.1,11092,4873,6219,6.8,15.5,9052,2394,6658,3.4,12.7,2040,2.8,25.4,0,255,255,1363
1997,22500,3606,4121,74156,73348,492,12,432,10.6,11213,3687,7526,5,15.3,9596,3722,5874,5.1,13.1,1617,2.2,26.2,0,305,305,2200
1998,22500,3594,4114,74572,74387,419,10.2,416,10.1,11085,2983,8102,4,14.9,10714,5351,5363,7.2,14.4,371,0.5,28.8,0,271,271,1575
1999,22500,3632,4180,75784,75160,462,11.1,387,9.3,10243,4102,6141,5.5,13.6,8995,2234,6761,3,12,1248,1.6,24,0,238,238,1151
2000,22500,3572,4108,75504,75735,399,9.6,479,11.6,9908,2911,6997,3.8,13.1,10369,4735,5634,6.3,13.7,-461,-0.6,26.2,0,259,259,1157
2001,22500,3590,4141,76761,76413,424,10.3,426,10.3,11211,4003,7208,5.2,14.7,10515,3725,6790,4.9,13.8,696,0.9,27.6,0,273,273,2203
2002,22500,3580,4165,75560,76118,462,11.1,438,10.5,9456,3234,6222,4.2,12.4,10571,2844,7727,3.7,13.9,-1115,-1.5,24.8,0,276,276,1550
2003,22500,3577,4158,75978,75599,401,9.7,349,8.4,11127,4023,7104,5.3,14.7,10368,2808,7560,3.7,13.7,759,1,27.4,0,240,240,1289
2004,22500,3561,4142,72998,73310,385,9.3,348,8.4,9615,3347,6268,4.6,13.1,10238,3209,7029,4.4,14,-623,-0.9,26.2,0,252,252,2219
2005,22500,3568,4155,74023,73310,367,8.9,317,7.7,9912,3163,6749,4.3,13.5,8486,2301,6185,3.1,11.6,1426,1.9,23.2,0,230,231,1281
2006,22500,3548,4131,74390,73832,382,9.2,375,9.1,9411,3508,5903,4.8,12.7,8294,3249,5045,4.4,11.2,1117,1.5,22.4,0,262,266,2006
2007,22500,3575,4208,75114,74144,422,10.1,341,8.2,11902,4875,7027,6.6,16.1,9962,2920,7042,3.9,13.4,1940,2.7,26.8,0,207,210,1644
2008,22500,3546,4213,74015,74529,358,8.5,327,7.8,8110,2764,5346,3.7,10.9,9138,2329,6809,3.1,12.3,-1028,-1.4,21.8,0,236,236,1513
2009,22500,3437,4099,71037,72403,297,7.2,377,9.1,7742,2765,4977,3.8,10.7,10474,2625,7849,3.6,14.5,-2732,-3.8,21.4,0,267,270,1412
2010,22500,3346,4029,70399,70830,287,7.1,336,8.3,7873,3437,4436,4.9,11.1,8734,1784,6950,2.5,12.3,-861,-1.2,22.2,0,249,249,1302
2011,22500,3288,3952,72143,71052,293,7.4,339,8.5,10004,2979,7025,4.2,14.1,7822,2311,5511,3.3,11,2182,3.1,22,0,234,235,1592
2012,22500,3274,3951,71855,71928,311,7.9,313,7.9,7994,2015,5979,2.8,11.1,8139,2089,6050,2.9,11.3,-145,-0.2,22.2,0,201,205,1102
2013,22500,3234,3897,74353,72820,281,7.2,311,8,9030,2295,6735,3.2,12.4,5963,1823,4140,2.5,8.2,3067,4.2,16.4,0,216,217,1082
2014,22500,3206,3873,73429,73833,302,7.8,302,7.8,8106,2409,5697,3.3,11,8914,2941,5973,4,12.1,-808,-1.1,22,0,214,217,2246
1977,22520,2058,2230,30390,30026,359,16.3,285,13,5070,2189,2881,7.3,16.9,4342,1885,2457,6.3,14.5,728,2.4,29,0,199,200,1175
1978,22520,2125,2316,33078,31730,366,16.1,278,12.2,6236,2369,3867,7.5,19.7,3539,1493,2046,4.7,11.2,2697,8.5,22.4,0,196,196,800
1979,22520,2188,2398,34858,33946,364,15.4,269,11.4,6678,2871,3807,8.5,19.7,4853,2234,2619,6.6,14.3,1825,5.4,28.6,0,192,193,984
1980,22520,2162,2358,35071,34933,273,11.5,297,12.5,5607,1682,3925,4.8,16.1,5330,1498,3832,4.3,15.3,277,0.8,30.6,0,200,200,801
1981,22520,2090,2260,32553,33485,276,12,340,14.8,4766,1523,3243,4.5,14.2,6629,2126,4503,6.3,19.8,-1863,-5.6,28.4,0,204,204,748
1982,22520,2085,2284,31204,31841,333,14.6,270,11.9,4821,2088,2733,6.6,15.1,6095,1708,4387,5.4,19.1,-1274,-4,30.2,0,174,174,986
1983,22520,2121,2317,29936,30483,285,12.4,282,12.3,4956,2205,2751,7.2,16.3,6049,2594,3455,8.5,19.8,-1093,-3.5,32.6,0,192,192,1143
1984,22520,2235,2431,32521,31247,366,15.4,260,11,7018,2649,4369,8.5,22.5,4470,2129,2341,6.8,14.3,2548,8.2,28.6,0,172,172,1048
1985,22520,2283,2482,32497,32799,342,13.9,303,12.3,5395,2089,3306,6.4,16.4,5998,2060,3938,6.3,18.3,-603,-1.9,32.8,0,211,211,1136
1986,22520,2342,2558,34693,33577,389,15.4,309,12.3,7615,3548,4067,10.6,22.7,5383,1909,3474,5.7,16,2232,6.7,32,0,221,221,1335
1987,22520,2370,2607,35133,35059,349,13.5,292,11.3,5955,2234,3721,6.4,17,5806,2404,3402,6.9,16.6,149,0.4,33.2,0,179,181,957
1988,22520,2343,2587,36340,35481,326,12.6,324,12.5,6752,2399,4353,6.8,19,5034,2007,3027,5.7,14.2,1718,4.8,28.4,0,205,205,1051
1989,22520,2405,2675,39020,37675,351,13.3,269,10.2,7253,2099,5154,5.6,19.3,4562,1467,3095,3.9,12.1,2691,7.2,24.2,0,198,198,951
1990,22520,2429,2699,42375,40638,282,10.5,250,9.3,8230,1851,6379,4.6,20.3,4755,1658,3097,4.1,11.7,3475,8.6,23.4,0,178,178,1090
1991,22520,2481,2781,41931,42057,363,13.3,273,10,7897,4548,3349,10.8,18.8,8149,2120,6029,5,19.4,-252,-0.6,37.6,0,171,171,1186
1992,22520,2546,2858,42637,42631,343,12.1,256,9.1,7397,1991,5406,4.7,17.4,7385,1829,5556,4.3,17.3,12,0.1,34.6,0,178,180,1315
1993,22520,2607,2918,44096,43386,339,11.7,269,9.3,6830,2086,4744,4.8,15.7,5410,1647,3763,3.8,12.5,1420,3.2,25,0,185,185,997
1994,22520,2670,2983,43501,43601,356,12.1,277,9.4,6783,2412,4371,5.5,15.6,6983,3219,3764,7.4,16,-200,-0.4,31.2,0,197,198,2652
1995,22520,2743,3056,46357,45026,356,11.8,276,9.1,7785,2248,5537,5,17.3,5122,1689,3433,3.8,11.4,2663,5.9,22.8,0,200,200,1127
1996,22520,2764,3081,49552,47880,357,11.6,320,10.4,11794,7081,4713,14.8,24.6,8450,4290,4160,9,17.6,3344,7,35.2,0,216,216,1286
1997,22520,2800,3148,47674,48647,388,12.4,321,10.3,7879,3014,4865,6.2,16.2,9824,2417,7407,5,20.2,-1945,-4,32.4,0,210,210,1438
1998,22520,2778,3127,46420,47023,313,10,326,10.4,8184,4187,3997,8.9,17.4,9389,3333,6056,7.1,20,-1205,-2.6,34.8,0,228,228,1275
1999,22520,2761,3120,48367,47663,326,10.4,331,10.6,8581,2897,5684,6.1,18,7172,2925,4247,6.1,15,1409,3,30,0,236,236,1283
2000,22520,2697,3066,49387,48885,276,8.9,340,11,6477,2008,4469,4.1,13.2,5473,1701,3772,3.5,11.2,1004,2,22.4,0,215,215,1083
2001,22520,2691,3079,48200,48879,312,10.1,319,10.4,6030,2184,3846,4.5,12.3,7388,2094,5294,4.3,15.1,-1358,-2.8,24.6,0,191,191,946
2002,22520,2665,3055,43371,45744,324,10.6,343,11.2,5769,2513,3256,5.5,12.6,10515,2680,7835,5.9,23,-4746,-10.4,25.2,0,197,197,893
2003,22520,2651,3052,43466,43200,303,10,255,8.4,6269,2093,4176,4.8,14.5,5737,1216,4521,2.8,13.3,532,1.2,26.6,0,187,187,810
2004,22520,2683,3067,44550,43976,300,9.8,259,8.5,7655,2029,5626,4.6,17.4,6506,1799,4707,4.1,14.8,1149,2.6,29.6,0,169,169,740
2005,22520,2709,3090,47172,45706,324,10.6,254,8.3,8638,3455,5183,7.6,18.9,5706,1938,3768,4.2,12.5,2932,6.4,25,0,196,196,1521
2006,22520,2688,3083,48731,47774,284,9.2,259,8.4,7339,2244,5095,4.7,15.4,5425,1911,3514,4,11.4,1914,4,22.8,0,192,192,1126
2007,22520,2705,3136,48057,48370,307,9.9,266,8.5,8158,3151,5007,6.5,16.9,8783,3822,4961,7.9,18.2,-625,-1.3,33.8,0,185,187,1618
2008,22520,2687,3138,47856,47845,256,8.2,238,7.6,5985,1719,4266,3.6,12.5,5964,1188,4776,2.5,12.5,21,0,25,0,165,165,907
2009,22520,2635,3079,45515,46554,238,7.7,268,8.6,5181,1489,3692,3.2,11.1,7260,1652,5608,3.5,15.6,-2079,-4.5,22.2,0,182,182,838
2010,22520,2610,3066,45141,45279,232,7.6,235,7.7,5059,1694,3365,3.7,11.2,5334,1100,4234,2.4,11.8,-275,-0.6,22.4,0,171,171,811
2011,22520,2577,3018,44430,44613,205,6.8,235,7.7,4429,1240,3189,2.8,9.9,4795,1309,3486,2.9,10.7,-366,-0.8,19.8,0,157,157,731
2012,22520,2576,3029,43505,43943,221,7.3,215,7.1,5480,1427,4053,3.2,12.5,6355,2974,3381,6.8,14.5,-875,-2,25,0,143,144,849
2013,22520,2536,2994,45320,44311,190,6.3,224,7.5,6220,1533,4687,3.5,14,4202,1584,2618,3.6,9.5,2018,4.5,19,0,161,161,1228
2014,22520,2532,2995,47428,46147,218,7.3,198,6.6,7239,2659,4580,5.8,15.7,4677,1299,3378,2.8,10.1,2562,5.6,20.2,0,140,141,787
1977,22540,1552,1645,27008,26301,232,14.3,190,11.7,4373,1766,2607,6.7,16.6,2958,1457,1501,5.5,11.2,1415,5.4,22.4,0,124,124,1092
1978,22540,1601,1702,27972,27491,226,13.5,170,10.2,3848,1058,2790,3.8,14,2885,947,1938,3.4,10.5,963,3.5,21,0,116,116,624
1979,22540,1637,1740,28614,28191,200,11.6,157,9.1,4031,1549,2482,5.5,14.3,3184,901,2283,3.2,11.3,847,3,22.6,0,106,107,569
1980,22540,1640,1745,28496,28554,177,10.2,172,9.9,3238,1069,2169,3.7,11.3,3354,1018,2336,3.6,11.7,-116,-0.4,22.6,0,131,132,744
1981,22540,1576,1676,27293,27696,161,9.4,217,12.7,3266,1456,1810,5.3,11.8,4072,1579,2493,5.7,14.7,-806,-2.9,23.6,0,126,126,680
1982,22540,1561,1680,28858,28038,191,11.4,150,8.9,4729,1672,3057,6,16.9,3089,938,2151,3.3,11,1640,5.9,22,0,83,84,559
1983,22540,1585,1697,27183,28062,149,8.8,154,9.1,2864,815,2049,2.9,10.2,4621,1123,3498,4,16.5,-1757,-6.3,20.4,0,93,93,457
1984,22540,1632,1755,28451,27789,198,11.5,139,8.1,4295,1312,2983,4.7,15.5,2971,983,1988,3.5,10.7,1324,4.8,21.4,0,92,92,305
1985,22540,1668,1792,29766,29102,187,10.5,147,8.3,3703,1233,2470,4.2,12.7,2374,792,1582,2.7,8.2,1329,4.5,16.4,0,92,93,489
1986,22540,1604,1730,28149,28831,152,8.6,189,10.7,2857,961,1896,3.3,9.9,4220,1723,2497,6,14.6,-1363,-4.7,19.8,0,96,96,448
1987,22540,1701,1832,30159,29200,218,12.2,119,6.7,4246,1326,2920,4.5,14.5,2328,908,1420,3.1,8,1918,6.5,16,0,35,35,286
1988,22540,1709,1844,31019,30633,151,8.2,144,7.8,3908,1409,2499,4.6,12.8,3135,1182,1953,3.9,10.2,773,2.6,20.4,0,104,104,745
1989,22540,1728,1864,32270,31637,163,8.8,146,7.9,4351,1191,3160,3.8,13.8,3085,924,2161,2.9,9.8,1266,4,19.6,0,102,102,524
1990,22540,1750,1895,33352,32764,176,9.4,140,7.5,4978,1820,3158,5.6,15.2,3801,1297,2504,4,11.6,1177,3.6,23.2,0,101,101,1093
1991,22540,1768,1925,32758,32928,180,9.4,152,8,3915,1255,2660,3.8,11.9,4255,1270,2985,3.9,12.9,-340,-1,23.8,0,111,111,1057
1992,22540,1811,1977,33873,33333,193,9.9,141,7.2,4092,1203,2889,3.6,12.3,3012,788,2224,2.4,9,1080,3.3,18,0,109,109,486
1993,22540,1840,2006,35089,34477,181,9.1,147,7.4,4335,1476,2859,4.3,12.6,3110,924,2186,2.7,9,1225,3.6,18,0,97,97,567
1994,22540,1853,2030,37588,36324,176,8.7,145,7.2,5895,2719,3176,7.5,16.2,3366,1300,2066,3.6,9.3,2529,6.9,18.6,0,97,97,870
1995,22540,1902,2074,38658,38081,193,9.4,133,6.5,4413,1294,3119,3.4,11.6,3259,784,2475,2.1,8.6,1154,3,17.2,0,88,90,494
1996,22540,1936,2112,37681,38366,189,9,152,7.3,4083,1289,2794,3.4,10.6,5453,2435,3018,6.3,14.2,-1370,-3.6,21.2,0,107,108,720
1997,22540,1979,2166,37432,37513,229,10.7,176,8.2,4273,1704,2569,4.5,11.4,4435,1499,2936,4,11.8,-162,-0.4,22.8,0,104,104,628
1998,22540,2026,2222,41803,40244,211,9.6,156,7.1,5990,3023,2967,7.5,14.9,2871,970,1901,2.4,7.1,3119,7.8,14.2,0,98,98,549
1999,22540,2040,2243,43013,42408,193,8.6,165,7.4,5528,1896,3632,4.5,13,4317,1228,3089,2.9,10.2,1211,2.8,20.4,0,107,107,483
2000,22540,2054,2260,43760,43223,200,8.9,181,8,5321,1462,3859,3.4,12.3,4246,1338,2908,3.1,9.8,1075,2.5,19.6,0,128,128,1013
2001,22540,2048,2262,43880,44415,203,9,220,9.7,4069,1427,2642,3.2,9.2,5139,1451,3688,3.3,11.6,-1070,-2.4,18.4,0,148,148,758
2002,22540,2056,2273,43226,43700,226,10,216,9.5,5152,2111,3041,4.8,11.8,6099,1281,4818,2.9,14,-947,-2.2,23.6,0,117,118,564
2003,22540,2019,2236,41864,42033,183,8.1,187,8.3,4128,843,3285,2,9.8,4466,1449,3017,3.4,10.6,-338,-0.8,19.6,0,122,122,788
2004,22540,2039,2287,43343,42632,204,9,151,6.7,5410,1864,3546,4.4,12.7,3988,883,3105,2.1,9.4,1422,3.3,18.8,0,93,93,577
2005,22540,2058,2314,44224,43770,197,8.6,159,6.9,5592,2142,3450,4.9,12.8,4683,1047,3636,2.4,10.7,909,2.1,21.4,0,103,103,593
2006,22540,2000,2268,44833,44408,189,8.3,204,8.9,5414,1530,3884,3.4,12.2,4563,2031,2532,4.6,10.3,851,1.9,20.6,0,124,124,1496
2007,22540,2007,2291,44571,44669,203,8.9,185,8.1,6094,2620,3474,5.9,13.6,6289,2104,4185,4.7,14.1,-195,-0.5,27.2,0,104,104,641
2008,22540,1973,2267,44919,44671,157,6.9,168,7.4,4607,1689,2918,3.8,10.3,4110,1120,2990,2.5,9.2,497,1.1,18.4,0,113,116,588
2009,22540,1948,2248,41945,43392,155,6.9,171,7.6,2969,1082,1887,2.5,6.8,5862,1001,4861,2.3,13.5,-2893,-6.7,13.6,0,108,108,659
2010,22540,1957,2251,40309,41012,148,6.6,127,5.7,3361,1014,2347,2.5,8.2,4766,773,3993,1.9,11.6,-1405,-3.4,16.4,0,80,80,490
2011,22540,1895,2187,39925,40100,125,5.6,170,7.7,3728,751,2977,1.9,9.3,4077,1477,2600,3.7,10.2,-349,-0.9,18.6,0,112,112,398
2012,22540,1890,2177,42115,41000,142,6.5,156,7.2,6328,1038,5290,2.5,15.4,4098,1500,2598,3.7,10,2230,5.4,20,0,88,89,565
2013,22540,1867,2147,43048,42578,132,6.1,160,7.4,4310,871,3439,2,10.1,3370,1321,2049,3.1,7.9,940,2.2,15.8,0,98,98,999
2014,22540,1844,2121,43902,43386,135,6.4,143,6.7,4355,1188,3167,2.7,10,3322,1122,2200,2.6,7.7,1033,2.3,15.4,0,98,98,729
1977,22660,2704,2873,30841,28867,715,26.4,379,14,8099,4451,3648,15.4,28.1,4151,1934,2217,6.7,14.4,3948,13.7,28.8,0,268,268,1387
1978,22660,2736,2928,35768,33240,650,22.4,563,19.4,9855,3575,6280,10.8,29.6,4798,2872,1926,8.6,14.4,5057,15.2,28.8,0,361,362,1575
1979,22660,3145,3338,39144,37508,715,22.8,326,10.4,9648,4435,5213,11.8,25.7,6375,2613,3762,7,17,3273,8.7,34,1,3,3,
1980,22660,3321,3516,43246,41129,721,21.1,516,15.1,10962,4825,6137,11.7,26.7,6728,2988,3740,7.3,16.4,4234,10.3,32.8,0,382,383,1951
1981,22660,3160,3360,41722,42150,578,16.9,684,19.9,10346,6481,3865,15.4,24.5,11201,6191,5010,14.7,26.6,-855,-2.1,49,0,442,442,2200
1982,22660,3245,3483,42142,41906,714,20.8,530,15.5,8667,4653,4014,11.1,20.7,8195,3197,4998,7.6,19.6,472,1.1,39.2,0,296,296,1636
1983,22660,3404,3635,42281,42049,599,16.8,477,13.4,8579,3548,5031,8.4,20.4,8114,3141,4973,7.5,19.3,465,1.1,38.6,0,317,318,1620
1984,22660,3669,3917,45497,43979,752,19.9,478,12.7,9759,4027,5732,9.2,22.2,6722,2697,4025,6.1,15.3,3037,6.9,30.6,0,334,335,1496
1985,22660,3845,4089,47796,46835,746,18.6,578,14.4,9042,4062,4980,8.7,19.3,7120,3367,3753,7.2,15.2,1922,4.1,30.4,0,412,413,2292
1986,22660,3945,4197,49372,48500,732,17.7,604,14.6,10066,5264,4802,10.9,20.8,8321,3540,4781,7.3,17.2,1745,3.6,34.4,0,437,437,2348
1987,22660,4080,4357,50747,50149,814,19,635,14.8,11214,5011,6203,10,22.4,10017,4289,5728,8.6,20,1197,2.4,40,0,442,442,2172
1988,22660,4068,4376,49195,49724,699,16,643,14.7,9103,3813,5290,7.7,18.3,10160,5105,5055,10.3,20.4,-1057,-2.1,36.6,0,470,470,3113
1989,22660,4065,4381,52019,50770,628,14.3,625,14.3,10428,3780,6648,7.4,20.5,7930,3491,4439,6.9,15.6,2498,4.9,31.2,0,446,446,2217
1990,22660,4188,4518,55335,53646,660,14.8,491,11,10462,4470,5992,8.3,19.5,7084,3030,4054,5.6,13.2,3378,6.3,26.4,0,347,347,2008
1991,22660,4316,4657,59543,57411,672,14.7,519,11.3,11915,4426,7489,7.7,20.8,7651,2823,4828,4.9,13.3,4264,7.5,26.6,0,349,350,2041
1992,22660,4472,4861,61543,60520,728,15.3,495,10.4,11442,4267,7175,7.1,18.9,9396,4036,5360,6.7,15.5,2046,3.4,31,0,351,352,1902
1993,22660,4694,5077,65970,63710,716,14.4,485,9.8,13510,4838,8672,7.6,21.2,8989,2552,6437,4,14.1,4521,7.1,28.2,0,316,317,1468
1994,22660,5013,5440,68016,66850,899,17.1,508,9.7,12790,4649,8141,7,19.1,10458,3716,6742,5.6,15.6,2332,3.5,31.2,0,347,347,1859
1995,22660,5349,5810,75661,72639,936,16.6,552,9.8,15431,6596,8835,9.1,21.2,9386,3035,6351,4.2,12.9,6045,8.3,25.8,0,392,392,1884
1996,22660,5615,6092,80300,77906,921,15.5,615,10.3,15506,6986,8520,9,19.9,10718,3265,7453,4.2,13.8,4788,6.1,27.6,0,434,434,2091
1997,22660,5819,6326,84229,82393,996,16,762,12.3,16372,7001,9371,8.5,19.9,12699,5078,7621,6.2,15.4,3673,4.5,30.8,0,469,469,2337
1998,22660,5981,6507,88120,86148,929,14.5,732,11.4,16488,7109,9379,8.3,19.1,12544,3994,8550,4.6,14.6,3944,4.5,29.2,0,503,503,2722
1999,22660,6121,6703,90785,89387,938,14.2,715,10.8,16748,6745,10003,7.5,18.7,13952,5526,8426,6.2,15.6,2796,3.1,31.2,0,486,486,2465
2000,22660,6235,6851,93264,92085,953,14.1,808,11.9,17948,6717,11231,7.3,19.5,15590,6507,9083,7.1,16.9,2358,2.6,33.8,0,524,524,2961
2001,22660,6439,7111,96619,95194,982,14,801,11.4,17532,6520,11012,6.8,18.4,14682,5017,9665,5.3,15.4,2850,3,30.8,0,493,493,2639
2002,22660,6576,7265,96389,96338,1059,14.8,883,12.3,18737,8095,10642,8.4,19.4,18635,6971,11664,7.2,19.3,102,0.1,38.6,0,493,493,2834
2003,22660,6692,7420,96399,96019,1068,14.6,799,10.9,15953,7177,8776,7.5,16.6,15193,5290,9903,5.5,15.8,760,0.8,31.6,0,550,550,3062
2004,22660,6832,7551,98995,97365,993,13.3,785,10.5,14682,4801,9881,4.9,15.1,11422,3372,8050,3.5,11.7,3260,3.4,23.4,0,511,514,2141
2005,22660,7040,7836,103399,101011,1140,14.8,787,10.2,21202,9452,11750,9.4,21,16426,6942,9484,6.9,16.3,4776,4.7,32.6,0,539,539,5455
2006,22660,7191,8048,106506,104423,1149,14.5,856,10.8,17931,8068,9863,7.7,17.2,13765,5288,8477,5.1,13.2,4166,4,26.4,0,578,578,3435
2007,22660,7354,8280,107374,106559,1147,14.1,921,11.3,19040,6951,12089,6.5,17.9,17409,5135,12274,4.8,16.3,1631,1.6,32.6,0,595,600,2998
2008,22660,7364,8317,106668,106521,1079,13.1,961,11.6,16164,5943,10221,5.6,15.2,15870,4922,10948,4.6,14.9,294,0.3,29.8,0,642,642,3531
2009,22660,7156,8067,103833,105486,829,10.2,993,12.2,14403,6111,8292,5.8,13.7,17708,5630,12078,5.3,16.8,-3305,-3.1,27.4,0,633,633,3410
2010,22660,7076,8000,100752,102181,840,10.5,871,10.9,12381,4771,7610,4.7,12.1,15239,4309,10930,4.2,14.9,-2858,-2.8,24.2,0,548,548,2559
2011,22660,7093,8046,103699,102019,933,11.7,828,10.3,16207,5960,10247,5.8,15.9,12847,5648,7199,5.5,12.6,3360,3.3,25.2,0,526,526,3658
2012,22660,7287,8257,106900,105115,994,12.2,794,9.8,16264,5940,10324,5.7,15.5,12693,3904,8789,3.7,12.1,3571,3.4,24.2,0,466,467,2057
2013,22660,7415,8407,110726,108506,941,11.3,777,9.4,15321,5189,10132,4.8,14.1,10880,4056,6824,3.7,10,4441,4.1,20,0,512,512,2273
2014,22660,7564,8541,113919,112043,950,11.3,752,8.9,16990,5768,11222,5.1,15.2,13237,4129,9108,3.7,11.8,3753,3.4,23.6,0,503,503,2597
1977,22900,3465,3759,67214,59879,666,18.2,466,12.7,22360,4745,17615,7.9,37.3,7689,3814,3875,6.4,12.8,14671,24.5,25.6,0,329,329,1671
1978,22900,3288,3585,58950,62988,489,13.3,624,17,10111,3436,6675,5.5,16.1,18187,8317,9870,13.2,28.9,-8076,-12.8,32.2,0,356,356,1481
1979,22900,3585,3874,62385,60721,570,15.3,311,8.3,11073,3314,7759,5.5,18.2,7745,1865,5880,3.1,12.8,3328,5.4,25.6,0,5,6,175
1980,22900,3586,3862,62608,62491,521,13.5,513,13.3,9787,4312,5475,6.9,15.7,9553,3261,6292,5.2,15.3,234,0.4,30.6,0,367,371,1625
1981,22900,3539,3826,60866,60097,566,14.8,520,13.6,10121,4311,5810,7.2,16.8,8583,3460,5123,5.8,14.3,1538,2.5,28.6,0,355,355,1808
1982,22900,3596,3936,58647,59723,642,16.5,491,12.6,9681,4670,5011,7.8,16.2,11833,3959,7874,6.6,19.8,-2152,-3.6,32.4,0,292,292,1583
1983,22900,3710,4054,58276,58248,573,14.3,479,12,9352,3886,5466,6.7,16.1,9296,3189,6107,5.5,16,56,0.1,32,0,356,356,1882
1984,22900,3872,4228,65179,61762,668,16.1,491,11.9,13826,4681,9145,7.6,22.4,6992,2577,4415,4.2,11.3,6834,11.1,22.6,0,354,354,1574
1985,22900,4001,4368,69455,68828,626,14.5,532,12.3,11133,3946,7187,5.7,16.2,9879,3162,6717,4.6,14.4,1254,1.8,28.8,0,381,384,1707
1986,22900,4120,4487,73118,71217,656,14.8,522,11.8,13140,5998,7142,8.4,18.5,9338,3664,5674,5.1,13.1,3802,5.4,26.2,0,353,353,2509
1987,22900,4120,4534,76282,74719,653,14.5,574,12.7,14169,4860,9309,6.5,19,11043,4621,6422,6.2,14.8,3126,4.2,29.6,0,404,409,3205
1988,22900,3995,4418,75970,74521,566,12.7,612,13.7,13521,4457,9064,6,18.1,10622,4722,5900,6.3,14.3,2899,3.8,28.6,0,414,414,2788
1989,22900,4112,4557,77861,76971,617,13.8,486,10.8,12930,5046,7884,6.6,16.8,11149,3853,7296,5,14.5,1781,2.3,29,0,333,333,2545
1990,22900,4187,4644,77222,77481,614,13.3,500,10.9,11168,4762,6406,6.1,14.4,11685,3634,8051,4.7,15.1,-517,-0.7,28.8,0,365,366,2236
1991,22900,4275,4751,78091,77656,616,13.1,516,11,11974,4722,7252,6.1,15.4,11103,3970,7133,5.1,14.3,871,1.1,28.6,0,349,350,2582
1992,22900,4293,4798,83454,80777,634,13.3,571,11.9,15336,4489,10847,5.6,19,9982,4055,5927,5,12.4,5354,6.6,24.8,0,405,413,2571
1993,22900,4415,4932,87004,85128,622,12.8,473,9.7,14844,5393,9451,6.3,17.4,11092,4375,6717,5.1,13,3752,4.4,26,0,353,353,2329
1994,22900,4500,5041,89746,88326,611,12.3,482,9.7,13822,3625,10197,4.1,15.6,10981,3456,7525,3.9,12.4,2841,3.2,24.8,0,355,357,2385
1995,22900,4580,5156,92540,91118,644,12.6,501,9.8,14414,4638,9776,5.1,15.8,11570,5477,6093,6,12.7,2844,3.1,25.4,0,348,348,3517
1996,22900,4641,5239,92564,92529,633,12.2,536,10.3,12596,4624,7972,5,13.6,12526,4241,8285,4.6,13.5,70,0.1,27,0,370,370,2004
1997,22900,4719,5378,96988,94706,726,13.7,573,10.8,18032,8213,9819,8.7,19,13467,5118,8349,5.4,14.2,4565,4.8,28.4,0,396,396,2651
1998,22900,4714,5394,98736,98042,638,11.8,614,11.4,14634,5606,9028,5.7,14.9,13245,4504,8741,4.6,13.5,1389,1.4,27,0,412,412,2351
1999,22900,4628,5318,100600,99739,587,11,664,12.4,15755,5341,10414,5.4,15.8,14033,5389,8644,5.4,14.1,1722,1.7,28.2,0,435,435,2343
2000,22900,4557,5232,106352,103434,543,10.3,627,11.9,17473,4751,12722,4.6,16.9,11637,4999,6638,4.8,11.3,5836,5.6,22.6,0,394,394,2152
2001,22900,4521,5242,105353,105979,578,11,602,11.5,13951,4803,9148,4.5,13.2,15203,5862,9341,5.5,14.3,-1252,-1.1,26.4,0,387,387,2459
2002,22900,4582,5327,103009,104125,709,13.4,621,11.8,14637,6834,7803,6.6,14.1,16868,6168,10700,5.9,16.2,-2231,-2.1,28.2,0,335,336,2810
2003,22900,4613,5475,102657,102238,688,12.8,452,8.4,12980,4360,8620,4.3,12.7,12142,3081,9061,3,11.9,838,0.8,23.8,0,343,344,2239
2004,22900,4593,5453,101603,101899,543,10,510,9.4,13132,3708,9424,3.6,12.9,13723,4328,9395,4.2,13.5,-591,-0.6,25.8,0,346,346,1903
2005,22900,4624,5546,102652,102012,580,10.6,435,7.9,12828,4175,8653,4.1,12.6,11548,3126,8422,3.1,11.3,1280,1.3,22.6,0,329,329,1634
2006,22900,4659,5656,109704,106142,640,11.4,491,8.8,18544,5949,12595,5.6,17.5,11420,3592,7828,3.4,10.8,7124,6.7,21.6,0,353,353,2603
2007,22900,4771,5760,109924,109450,651,11.5,522,9.2,15761,4921,10840,4.5,14.4,14813,4480,10333,4.1,13.5,948,0.9,27,0,312,316,2175
2008,22900,4801,5787,108727,109114,547,9.5,470,8.2,12563,3433,9130,3.1,11.5,13337,2551,10786,2.3,12.2,-774,-0.7,23,0,342,342,2037
2009,22900,4757,5753,103786,105999,477,8.3,448,7.8,10011,4303,5708,4.1,9.4,14437,2973,11464,2.8,13.6,-4426,-4.2,18.8,0,334,334,1984
2010,22900,4750,5741,103729,103338,467,8.1,474,8.3,11953,3916,8037,3.8,11.6,11170,3098,8072,3,10.8,783,0.8,21.6,0,312,312,1800
2011,22900,4691,5673,101064,102259,511,9,528,9.3,10031,2690,7341,2.6,9.8,12420,3712,8708,3.6,12.1,-2389,-2.3,19.6,0,314,314,1407
2012,22900,4740,5765,101423,101289,513,9,445,7.8,11407,2963,8444,2.9,11.3,11139,2821,8318,2.8,11,268,0.3,22,0,295,295,1584
2013,22900,4713,5755,100482,100616,449,7.8,454,7.9,9763,3471,6292,3.4,9.7,10030,3191,6839,3.2,10,-267,-0.3,19.4,0,325,325,1209
2014,22900,4659,5645,99722,99904,413,7.3,474,8.4,9100,2730,6370,2.7,9.1,9463,2411,7052,2.4,9.5,-363,-0.4,18.2,0,316,317,1505
1977,23060,5540,6387,137090,133051,959,15.3,720,11.5,23033,8093,14940,6.1,17.3,14955,7355,7600,5.5,11.2,8078,6.1,22.4,0,470,474,4643
1978,23060,5677,6550,142014,139563,831,12.8,663,10.2,19716,5672,14044,4.1,14.1,14813,4547,10266,3.3,10.6,4903,3.5,21.2,0,417,422,2173
1979,23060,5841,6743,150629,146153,841,12.7,625,9.4,23487,5859,17628,4,16.1,14534,4881,9653,3.3,9.9,8953,6.2,19.8,0,425,430,2447
1980,23060,5861,6763,144641,147582,765,11.3,718,10.6,22831,4971,17860,3.4,15.5,28712,5681,23031,3.8,19.5,-5881,-4,31,0,493,496,2585
1981,23060,5731,6591,135109,138706,763,11.5,860,12.9,23999,7901,16098,5.7,17.3,31192,7132,24060,5.1,22.5,-7193,-5.2,34.6,0,441,442,2376
1982,23060,5742,6704,136106,135662,862,13,690,10.4,22003,8501,13502,6.3,16.2,21114,6371,14743,4.7,15.6,889,0.6,31.2,0,413,414,2282
1983,23060,5524,6490,127157,131519,702,10.6,858,13,15328,5412,9916,4.1,11.7,24052,6592,17460,5,18.3,-8724,-6.6,23.4,0,435,437,2836
1984,23060,5958,6930,134575,131054,786,11.7,452,6.7,23944,7698,16246,5.9,18.3,16901,7000,9901,5.3,12.9,7043,5.4,25.8,0,13,14,96
1985,23060,6166,7130,144843,140623,891,12.7,701,10,24394,6904,17490,4.9,17.3,15954,7208,8746,5.1,11.3,8440,6,22.6,0,414,414,2438
1986,23060,6438,7403,154293,149551,984,13.5,692,9.5,25263,9053,16210,6.1,16.9,15778,6572,9206,4.4,10.6,9485,6.3,21.2,0,459,459,3266
1987,23060,6766,7806,162779,159090,1146,15.1,750,9.9,29304,12480,16824,7.8,18.4,21925,8851,13074,5.6,13.8,7379,4.6,27.6,0,463,466,3494
1988,23060,6836,7905,169582,165445,939,12,791,10.1,27182,9536,17646,5.8,16.4,18908,6343,12565,3.8,11.4,8274,5,22.8,0,511,511,2755
1989,23060,6919,8021,176566,173069,873,11,750,9.4,26988,7669,19319,4.4,15.6,19993,6434,13559,3.7,11.6,6995,4,23.2,0,509,514,4051
1990,23060,7079,8230,181897,179114,913,11.2,667,8.2,25831,8089,17742,4.5,14.4,20264,4916,15348,2.7,11.3,5567,3.1,22.6,0,460,460,2857
1991,23060,7142,8394,168713,174545,951,11.4,782,9.4,21625,9949,11676,5.7,12.4,33288,7560,25728,4.3,19.1,-11663,-6.7,24.8,0,500,503,3478
1992,23060,7186,8494,172374,170580,907,10.7,796,9.4,25356,7893,17463,4.6,14.9,21768,6417,15351,3.8,12.8,3588,2.1,25.6,0,512,516,4068
1993,23060,7294,8561,175857,174043,813,9.5,718,8.4,25604,6607,18997,3.8,14.7,21975,5982,15993,3.4,12.6,3629,2.1,25.2,0,446,448,3097
1994,23060,7438,8719,181033,178430,919,10.6,757,8.8,26115,10890,15225,6.1,14.6,20909,7525,13384,4.2,11.7,5206,2.9,23.4,0,483,484,2571
1995,23060,7547,8856,187066,183786,928,10.6,755,8.6,27854,9795,18059,5.3,15.2,21293,5657,15636,3.1,11.6,6561,3.6,23.2,0,490,490,2725
1996,23060,7665,8887,186368,186729,945,10.7,900,10.1,27368,8708,18660,4.7,14.7,28089,10020,18069,5.4,15,-721,-0.3,29.4,0,550,550,3654
1997,23060,7731,9049,190039,188258,1001,11.1,835,9.3,27821,8007,19814,4.3,14.8,24259,7827,16432,4.2,12.9,3562,1.9,25.8,0,519,519,3101
1998,23060,7789,9102,196400,193111,898,9.9,832,9.2,28629,10295,18334,5.3,14.8,22051,7149,14902,3.7,11.4,6578,3.4,22.8,0,523,523,2827
1999,23060,7817,9169,201769,199102,929,10.2,854,9.3,29889,10761,19128,5.4,15,24555,8549,16006,4.3,12.3,5334,2.7,24.6,0,544,544,4157
2000,23060,7772,9150,201540,201684,888,9.7,917,10,31369,12643,18726,6.3,15.6,31659,15421,16238,7.6,15.7,-290,-0.1,31.2,0,518,518,8330
2001,23060,7870,9345,194905,198512,989,10.7,856,9.2,25219,11035,14184,5.6,12.7,32433,9899,22534,5,16.3,-7214,-3.6,25.4,0,456,458,4640
2002,23060,7872,9405,188561,191548,1111,11.9,1042,11.1,28811,13677,15134,7.1,15,34785,11528,23257,6,18.2,-5974,-3.2,30,0,473,474,3084
2003,23060,7902,9470,191064,188686,975,10.4,751,8,29639,9744,19895,5.2,15.7,24885,8534,16351,4.5,13.2,4754,2.5,26.4,0,478,483,2757
2004,23060,7942,9562,190045,189748,977,10.3,777,8.2,25133,8420,16713,4.4,13.2,24539,9288,15251,4.9,12.9,594,0.3,25.8,0,488,488,3627
2005,23060,8049,9745,191258,190302,1008,10.5,745,7.7,25610,11403,14207,6,13.5,23697,5444,18253,2.9,12.5,1913,1,25,0,483,483,3598
2006,23060,8112,9835,195065,192648,999,10.2,810,8.3,24677,9548,15129,5,12.8,19843,6649,13194,3.5,10.3,4834,2.5,20.6,0,500,500,3980
2007,23060,8238,10044,198839,196517,1115,11.2,883,8.9,32561,10553,22008,5.4,16.6,27916,9061,18855,4.6,14.2,4645,2.4,28.4,0,504,511,3520
2008,23060,8149,9927,196554,196988,828,8.3,817,8.2,25623,8603,17020,4.4,13,26490,7673,18817,3.9,13.4,-867,-0.4,26,0,582,582,4709
2009,23060,7888,9621,186241,191179,699,7.2,927,9.5,21383,5590,15793,2.9,11.2,31258,8825,22433,4.6,16.4,-9875,-5.2,22.4,0,565,567,3818
2010,23060,7740,9470,178814,181651,703,7.4,772,8.1,18542,6959,11583,3.8,10.2,24215,6724,17491,3.7,13.3,-5673,-3.1,20.4,0,472,472,3843
2011,23060,7624,9339,181628,179950,703,7.5,748,8,21737,5266,16471,2.9,12.1,18380,6242,12138,3.5,10.2,3357,1.9,20.4,0,506,510,4053
2012,23060,7692,9439,181817,181554,807,8.6,730,7.8,23468,6463,17005,3.6,12.9,22941,6398,16543,3.5,12.6,527,0.3,25.2,0,423,429,3186
2013,23060,7646,9350,184023,182716,649,6.9,701,7.5,20534,5089,15445,2.8,11.2,17919,4695,13224,2.6,9.8,2615,1.4,19.6,0,430,430,2826
2014,23060,7689,9403,188361,185762,776,8.3,635,6.8,20588,5566,15022,3,11.1,15389,4013,11376,2.2,8.3,5199,2.8,16.6,0,422,422,2523
1977,23420,8981,9996,118709,114265,1844,19,1204,12.4,28302,12349,15953,10.8,24.8,19414,8673,10741,7.6,17,8888,7.8,34,0,775,776,5223
1978,23420,9237,10294,127674,123131,1797,17.7,1486,14.6,30718,11640,19078,9.5,24.9,21631,11141,10490,9,17.6,9087,7.3,35.2,0,895,898,5804
1979,23420,9788,10913,140989,134113,2031,19.2,1333,12.6,36262,14689,21573,11,27,22510,9240,13270,6.9,16.8,13752,10.2,33.6,0,912,912,5483
1980,23420,10105,11298,145301,143022,1833,16.5,1404,12.6,30886,11885,19001,8.3,21.6,26327,9062,17265,6.3,18.4,4559,3.2,36.8,0,958,961,5352
1981,23420,9827,10975,139355,141815,1557,14,1726,15.5,27491,13449,14042,9.5,19.4,32410,13494,18916,9.5,22.9,-4919,-3.5,38.8,0,1063,1066,5938
1982,23420,9742,11079,138464,138620,1701,15.4,1445,13.1,28450,14302,14148,10.3,20.5,28762,9518,19244,6.9,20.7,-312,-0.2,41,0,803,804,4794
1983,23420,9857,11191,135690,136914,1333,12,1297,11.7,25109,10051,15058,7.3,18.3,27557,9206,18351,6.7,20.1,-2448,-1.8,36.6,0,759,759,4555
1984,23420,10188,11546,144328,140019,1629,14.3,1277,11.2,30244,11775,18469,8.4,21.6,21626,7897,13729,5.6,15.4,8618,6.2,30.8,0,797,800,4316
1985,23420,10572,11960,149017,146841,1610,13.7,1239,10.5,28525,10110,18415,6.9,19.4,24172,9099,15073,6.2,16.5,4353,2.9,33,0,753,756,4331
1986,23420,10795,12203,151936,150315,1683,13.9,1374,11.4,30324,12288,18036,8.2,20.2,27081,10298,16783,6.9,18,3243,2.2,36,0,852,854,5500
1987,23420,11008,12494,162444,157494,1855,15,1434,11.6,36224,13563,22661,8.6,23,26325,10597,15728,6.7,16.7,9899,6.3,33.4,0,872,877,4947
1988,23420,11026,12533,170857,166350,1584,12.7,1455,11.6,37781,14976,22805,9,22.7,28766,11936,16830,7.2,17.3,9015,5.4,34.6,0,935,935,6416
1989,23420,10380,11900,169543,170109,1478,12.1,2118,17.3,33484,13600,19884,8,19.7,34615,17335,17280,10.2,20.3,-1131,-0.6,39.4,0,878,885,4440
1990,23420,11364,12921,185904,176847,2242,18.1,1134,9.1,43173,20188,22985,11.4,24.4,25058,8978,16080,5.1,14.2,18115,10.2,28.4,0,769,772,5524
1991,23420,11666,13345,213131,198577,1673,12.7,1266,9.6,58968,13431,45537,6.8,29.7,29859,8234,21625,4.1,15,29109,14.7,30,0,787,790,4760
1992,23420,11674,13391,192148,189422,1543,11.5,1411,10.5,38497,19123,19374,10.1,20.3,33044,10701,22343,5.6,17.4,5453,2.9,34.8,0,906,916,6055
1993,23420,11713,13401,186302,186561,1491,11.1,1404,10.5,31321,11145,20176,6,16.8,31839,9462,22377,5.1,17.1,-518,-0.3,33.6,0,891,903,4850
1994,23420,11659,13363,186077,185818,1464,10.9,1432,10.7,31935,11694,20241,6.3,17.2,31416,10785,20631,5.8,16.9,519,0.3,33.8,0,907,907,4570
1995,23420,11634,13366,188385,186998,1532,11.5,1447,10.8,29684,10648,19036,5.7,15.9,26910,8267,18643,4.4,14.4,2774,1.5,28.8,0,967,973,4567
1996,23420,11635,13369,191594,189898,1455,10.9,1392,10.4,30978,10252,20726,5.4,16.3,27586,8328,19258,4.4,14.5,3392,1.8,29,0,916,916,4347
1997,23420,11652,13431,195116,193548,1534,11.4,1488,11.1,35146,13198,21948,6.8,18.2,32010,12799,19211,6.6,16.5,3136,1.7,33,0,886,886,5017
1998,23420,11544,13393,199525,196999,1512,11.3,1484,11.1,36267,12907,23360,6.6,18.4,31215,11885,19330,6,15.8,5052,2.6,31.6,0,961,961,5963
1999,23420,11561,13459,215078,207531,1493,11.1,1404,10.5,46153,12063,34090,5.8,22.2,31059,12442,18617,6,15,15094,7.2,30,0,862,862,4805
2000,23420,11610,13523,209181,206489,1401,10.4,1344,10,36026,13473,22553,6.5,17.4,30642,12814,17828,6.2,14.8,5384,2.6,29.6,0,802,802,5176
2001,23420,11756,13751,216351,213708,1523,11.1,1479,10.8,36050,12569,23481,5.9,16.9,30763,10506,20257,4.9,14.4,5287,2.5,28.8,0,838,838,4667
2002,23420,11931,13956,218615,216488,1811,13.1,1576,11.4,42273,16814,25459,7.8,19.5,38018,14488,23530,6.7,17.6,4255,1.9,35.2,0,845,856,6087
2003,23420,11978,14057,227495,221870,1617,11.6,1252,9,40312,11535,28777,5.2,18.2,29061,9862,19199,4.4,13.1,11251,5.1,26.2,0,865,890,5730
2004,23420,11990,14085,233695,229975,1531,10.9,1367,9.7,39379,13406,25973,5.8,17.1,31938,9642,22296,4.2,13.9,7441,3.2,27.8,0,877,879,5478
2005,23420,12091,14273,238964,235553,1626,11.5,1306,9.2,35622,13013,22609,5.5,15.1,28799,9661,19138,4.1,12.2,6823,2.9,24.4,0,952,954,6913
2006,23420,12351,14606,255360,246751,1815,12.6,1365,9.5,45066,16533,28533,6.7,18.3,27848,9340,18508,3.8,11.3,17218,7,22.6,0,975,975,6287
2007,23420,12585,14911,251026,252652,1839,12.5,1459,9.9,40126,14541,25585,5.8,15.9,43378,13696,29682,5.4,17.2,-3252,-1.3,31.8,0,948,956,7088
2008,23420,12563,14930,246353,248395,1605,10.8,1415,9.5,33495,12226,21269,4.9,13.5,37578,11023,26555,4.4,15.1,-4083,-1.6,27,0,1022,1022,6911
2009,23420,12181,14526,236978,240766,1312,8.9,1574,10.7,30141,12785,17356,5.3,12.5,37717,8976,28741,3.7,15.7,-7576,-3.2,25,0,1094,1094,5681
2010,23420,11997,14377,222959,227855,1297,9,1337,9.3,24855,9963,14892,4.4,10.9,34647,8662,25985,3.8,15.2,-9792,-4.3,21.8,0,904,906,6159
2011,23420,11799,14207,226205,224161,1255,8.8,1314,9.2,28069,8869,19200,4,12.5,23980,8317,15663,3.7,10.7,4089,1.8,21.4,0,888,888,5629
2012,23420,11976,14375,234474,230031,1375,9.6,1231,8.6,33490,9417,24073,4.1,14.6,24603,8789,15814,3.8,10.7,8887,3.9,21.4,0,780,786,5591
2013,23420,12023,14443,242209,238104,1269,8.8,1232,8.6,31763,9844,21919,4.1,13.3,23552,7658,15894,3.2,9.9,8211,3.4,19.8,0,763,768,4625
2014,23420,12127,14576,245708,243541,1433,9.9,1207,8.3,32575,10150,22425,4.2,13.4,28241,7244,20997,3,11.6,4334,1.8,23.2,0,874,876,4416
1977,23460,1543,1668,25946,25594,247,15,214,13,4192,1813,2379,7.1,16.4,3488,1524,1964,6,13.6,704,2.8,27.2,0,156,156,967
1978,23460,1552,1676,28312,27129,218,13,203,12.1,4824,1743,3081,6.4,17.8,2458,955,1503,3.5,9.1,2366,8.7,18.2,0,141,141,604
1979,23460,1574,1700,30320,29296,239,14.2,198,11.7,5044,1546,3498,5.3,17.2,2995,1035,1960,3.5,10.2,2049,7,20.4,0,137,137,658
1980,23460,1542,1664,29636,29972,200,11.9,228,13.6,3638,1063,2575,3.5,12.1,4310,1867,2443,6.2,14.4,-672,-2.3,24.2,0,152,152,1235
1981,23460,1498,1612,28836,29028,200,12.3,237,14.5,3731,1984,1747,6.8,12.9,4114,1261,2853,4.3,14.2,-383,-1.3,25.8,0,157,158,733
1982,23460,1432,1571,27029,27932,192,12.1,212,13.3,3347,1259,2088,4.5,12,5152,1732,3420,6.2,18.4,-1805,-6.4,24,0,130,130,910
1983,23460,1447,1567,25291,26037,184,11.7,206,13.1,3274,1737,1537,6.7,12.6,4765,1209,3556,4.6,18.3,-1491,-5.7,25.2,0,126,126,773
1984,23460,1530,1662,27604,26469,252,15.6,161,10,4494,1331,3163,5,17,2224,963,1261,3.6,8.4,2270,8.6,16.8,0,96,96,508
1985,23460,1530,1673,28879,28390,208,12.4,199,11.9,4255,1429,2826,5,15,3279,1171,2108,4.1,11.5,976,3.5,23,0,137,137,748
1986,23460,1548,1694,27847,28308,224,13.3,188,11.2,3953,1264,2689,4.5,14,4876,1232,3644,4.4,17.2,-923,-3.2,28,0,121,121,668
1987,23460,1557,1708,29395,28773,226,13.2,213,12.5,5285,1478,3807,5.1,18.4,4042,1735,2307,6,14,1243,4.4,28,0,128,129,688
1988,23460,1590,1749,29959,29557,225,13.1,175,10.2,4525,1323,3202,4.5,15.3,3720,1139,2581,3.9,12.6,805,2.7,25.2,0,114,114,523
1989,23460,1648,1821,30326,30155,207,11.6,144,8.1,4018,1305,2713,4.3,13.3,3676,703,2973,2.3,12.2,342,1.1,24.4,0,98,98,370
1990,23460,1650,1822,30415,30365,195,10.7,185,10.2,4253,1683,2570,5.5,14,4152,1341,2811,4.4,13.7,101,0.3,27.4,0,128,128,841
1991,23460,1638,1824,30782,30533,182,10,183,10,4777,2032,2745,6.7,15.6,4279,1432,2847,4.7,14,498,1.6,28,0,113,113,879
1992,23460,1640,1831,30210,30449,206,11.3,178,9.7,4776,1846,2930,6.1,15.7,5253,2009,3244,6.6,17.3,-477,-1.6,31.4,0,116,116,1660
1993,23460,1669,1853,31708,30932,173,9.4,145,7.9,4895,780,4115,2.5,15.8,3342,890,2452,2.9,10.8,1553,5,21.6,0,93,93,393
1994,23460,1746,1934,32791,32224,232,12.3,141,7.4,4640,1569,3071,4.9,14.4,3505,720,2785,2.2,10.9,1135,3.5,21.8,0,98,98,335
1995,23460,1768,1959,32457,32665,207,10.6,185,9.5,4069,1364,2705,4.2,12.5,4485,1121,3364,3.4,13.7,-416,-1.2,25,0,143,143,632
1996,23460,1782,1969,32000,32181,193,9.8,181,9.2,3651,1134,2517,3.5,11.3,4012,1380,2632,4.3,12.5,-361,-1.2,22.6,0,123,123,719
1997,23460,1798,1997,31892,32017,212,10.7,193,9.7,4068,1388,2680,4.3,12.7,4317,1170,3147,3.7,13.5,-249,-0.8,25.4,0,130,130,543
1998,23460,1784,1982,32634,32252,196,9.9,204,10.3,4467,1494,2973,4.6,13.9,3702,1200,2502,3.7,11.5,765,2.4,23,0,143,143,635
1999,23460,1783,1996,32300,32461,206,10.4,191,9.6,4936,1747,3189,5.4,15.2,5258,1647,3611,5.1,16.2,-322,-1,30.4,0,137,137,1236
2000,23460,1754,1964,33823,33068,176,8.9,207,10.5,5324,1058,4266,3.2,16.1,3813,1326,2487,4,11.5,1511,4.6,23,0,133,133,659
2001,23460,1745,1960,32383,33126,206,10.5,222,11.3,4525,1678,2847,5.1,13.7,6011,2750,3261,8.3,18.1,-1486,-4.4,27.4,0,132,132,704
2002,23460,1763,1978,32358,32376,222,11.3,200,10.2,4756,1450,3306,4.5,14.7,4792,1333,3459,4.1,14.8,-36,-0.1,29.4,0,105,105,428
2003,23460,1767,1997,31511,31784,224,11.3,174,8.8,4325,1885,2440,5.9,13.6,4870,1124,3746,3.5,15.3,-545,-1.7,27.2,0,136,136,792
2004,23460,1736,1956,31099,31226,168,8.5,189,9.6,4384,1259,3125,4,14,4638,1267,3371,4.1,14.9,-254,-0.9,28,0,126,126,613
2005,23460,1763,1994,32283,31601,208,10.6,153,7.8,5041,1519,3522,4.8,16,3676,1308,2368,4.1,11.6,1365,4.4,23.2,0,109,109,715
2006,23460,1756,2002,34156,33124,201,10.1,176,8.8,5883,1367,4516,4.1,17.8,3819,875,2944,2.6,11.5,2064,6.3,23,0,133,134,634
2007,23460,1785,2036,36111,35116,199,9.9,155,7.7,6574,3326,3248,9.5,18.7,4583,865,3718,2.5,13.1,1991,5.6,26.2,0,97,97,405
2008,23460,1792,2029,34127,34993,165,8.2,153,7.6,4710,1763,2947,5,13.5,6442,3819,2623,10.9,18.4,-1732,-4.9,27,0,108,108,1036
2009,23460,1727,1954,31606,32786,124,6.2,183,9.2,2721,817,1904,2.5,8.3,5081,1191,3890,3.6,15.5,-2360,-7.2,16.6,0,127,127,792
2010,23460,1687,1926,31509,31526,145,7.5,165,8.5,3849,1572,2277,5,12.2,3883,848,3035,2.7,12.3,-34,-0.1,24.4,0,134,134,739
2011,23460,1659,1882,28466,29626,127,6.7,149,7.9,2842,1115,1727,3.8,9.6,5162,3058,2104,10.3,17.4,-2320,-7.8,19.2,0,100,100,1180
2012,23460,1637,1872,29301,28847,140,7.5,147,7.8,3528,948,2580,3.3,12.2,2620,969,1651,3.4,9.1,908,3.1,18.2,0,96,97,372
2013,23460,1627,1860,28963,29075,107,5.7,128,6.9,2878,883,1995,3,9.9,3101,726,2375,2.5,10.7,-223,-0.8,19.8,0,75,75,415
2014,23460,1636,1862,28523,28562,134,7.3,105,5.7,2753,1066,1687,3.7,9.6,2830,681,2149,2.4,9.9,-77,-0.3,19.2,0,73,73,406
1977,23540,2360,2572,28221,27707,501,19.9,380,15.1,6537,3758,2779,13.6,23.6,5508,2470,3038,8.9,19.9,1029,3.7,39.8,0,279,282,1842
1978,23540,2471,2697,32106,30149,530,20.1,394,15,8962,3843,5119,12.7,29.7,5047,2698,2349,8.9,16.7,3915,13,33.4,0,282,283,1450
1979,23540,2591,2842,34617,33307,507,18.3,336,12.1,8203,4091,4112,12.3,24.6,5582,2565,3017,7.7,16.8,2621,7.8,33.6,0,233,233,1448
1980,23540,2684,2949,36432,35522,483,16.7,365,12.6,7849,3573,4276,10.1,22.1,6028,2570,3458,7.2,17,1821,5.1,34,0,275,275,1836
1981,23540,2704,2972,39433,38752,519,17.5,465,15.7,7598,3654,3944,9.4,19.6,6236,3365,2871,8.7,16.1,1362,3.5,32.2,0,322,323,1868
1982,23540,2799,3108,42591,40930,571,18.8,419,13.8,9929,4455,5474,10.9,24.3,6607,2823,3784,6.9,16.1,3322,8.2,32.2,0,251,251,1416
1983,23540,2948,3285,44015,43157,551,17.2,397,12.4,9684,5664,4020,13.1,22.4,7967,2145,5822,5,18.5,1717,3.9,37,0,245,245,1239
1984,23540,3122,3459,48999,46326,564,16.7,392,11.6,11992,3899,8093,8.4,25.9,6646,3195,3451,6.9,14.3,5346,11.6,28.6,0,263,263,1799
1985,23540,3228,3577,49560,49298,560,15.9,444,12.6,9395,3773,5622,7.7,19.1,8870,2592,6278,5.3,18,525,1.1,36,0,292,292,1699
1986,23540,3333,3696,53175,51275,570,15.7,423,11.6,10959,5437,5522,10.6,21.4,7159,2659,4500,5.2,14,3800,7.4,28,0,273,273,1614
1987,23540,3470,3886,57159,55949,646,17,423,11.1,11464,5338,6126,9.5,20.5,9045,3743,5302,6.7,16.2,2419,4.3,32.4,0,296,299,2699
1988,23540,3507,3938,59144,57969,547,14,468,12,11633,3928,7705,6.8,20.1,9282,4292,4990,7.4,16,2351,4.1,32,0,315,315,1752
1989,23540,3595,4036,60246,59854,500,12.5,418,10.5,9763,3563,6200,6,16.3,8978,2533,6445,4.2,15,785,1.3,30,0,286,286,1502
1990,23540,3684,4134,60158,60123,499,12.2,376,9.2,10141,4555,5586,7.6,16.9,10071,2813,7258,4.7,16.8,70,0.1,33.6,0,262,262,1603
1991,23540,3785,4274,59908,60142,579,13.8,439,10.4,9644,4019,5625,6.7,16,10112,3245,6867,5.4,16.8,-468,-0.8,32,0,283,290,1809
1992,23540,3848,4351,61034,60404,572,13.2,482,11.2,10340,4381,5959,7.3,17.1,9079,3089,5990,5.1,15,1261,2.1,30,0,330,340,2125
1993,23540,3897,4392,61150,61012,507,11.6,456,10.4,9625,3434,6191,5.6,15.8,9349,3737,5612,6.1,15.3,276,0.5,30.6,0,312,312,2046
1994,23540,3998,4497,65216,63108,573,12.9,453,10.2,11825,4640,7185,7.4,18.7,7609,2912,4697,4.6,12.1,4216,6.6,24.2,0,289,289,1396
1995,23540,4034,4557,70449,67912,551,12.2,481,10.6,12926,5345,7581,7.9,19,7852,2671,5181,3.9,11.6,5074,7.4,23.2,0,337,338,1748
1996,23540,4085,4615,74398,72408,565,12.3,494,10.8,14189,5589,8600,7.7,19.6,10209,3570,6639,4.9,14.1,3980,5.5,28.2,0,323,323,1569
1997,23540,4119,4661,69112,71764,598,12.9,545,11.7,12171,4739,7432,6.6,17,17475,6914,10561,9.6,24.4,-5304,-7.4,34,0,330,330,2715
1998,23540,4110,4642,74681,71895,530,11.4,531,11.4,13969,5362,8607,7.5,19.4,8397,3420,4977,4.8,11.7,5572,7.7,23.4,0,345,345,1612
1999,23540,4080,4635,77113,75858,530,11.4,529,11.4,11902,3773,8129,5,15.7,9392,4163,5229,5.5,12.4,2510,3.3,24.8,0,353,353,2505
2000,23540,4097,4675,79575,78356,531,11.4,497,10.7,12082,5105,6977,6.5,15.4,9645,3741,5904,4.8,12.3,2437,3.1,24.6,0,287,287,1379
2001,23540,4129,4719,84553,82939,577,12.3,563,12,14083,5006,9077,6,17,10855,4395,6460,5.3,13.1,3228,3.9,26.2,0,312,312,1837
2002,23540,4209,4805,82897,83685,668,14,575,12.1,13119,5912,7207,7.1,15.7,14695,7433,7262,8.9,17.6,-1576,-1.9,31.4,0,306,306,4020
2003,23540,4324,4918,83309,82799,657,13.6,448,9.3,11489,4600,6889,5.6,13.9,10468,2727,7741,3.3,12.6,1021,1.3,25.2,0,302,302,1594
2004,23540,4505,5117,84077,83469,688,13.7,453,9,12854,4667,8187,5.6,15.4,11637,3090,8547,3.7,13.9,1217,1.5,27.8,0,320,320,1731
2005,23540,4623,5282,87102,85390,677,13,466,9,12655,5214,7441,6.1,14.8,9230,2353,6877,2.8,10.8,3425,4,21.6,0,328,334,1544
2006,23540,4681,5355,87907,86458,631,11.9,499,9.4,12033,4913,7120,5.7,13.9,9135,3504,5631,4.1,10.6,2898,3.3,21.2,0,335,335,1802
2007,23540,4815,5545,89466,88421,724,13.3,544,10,14299,6228,8071,7,16.2,12209,4170,8039,4.7,13.8,2090,2.4,27.6,0,354,354,2204
2008,23540,4778,5517,87431,88215,595,10.8,555,10.1,10467,3304,7163,3.7,11.9,12035,3408,8627,3.9,13.6,-1568,-1.7,23.8,0,414,414,2175
2009,23540,4667,5405,85219,86205,461,8.5,546,10,10200,3167,7033,3.7,11.8,12172,2710,9462,3.1,14.1,-1972,-2.3,23.6,0,363,364,1694
2010,23540,4635,5357,83101,84171,509,9.5,558,10.4,10169,4713,5456,5.6,12.1,12308,4777,7531,5.7,14.6,-2139,-2.5,24.2,0,356,357,3083
2011,23540,4587,5327,82942,82973,549,10.3,548,10.3,9710,4075,5635,4.9,11.7,9771,3542,6229,4.3,11.8,-61,-0.1,23.4,0,353,353,1866
2012,23540,4662,5398,83551,82975,549,10.3,477,8.9,10366,3135,7231,3.8,12.5,9214,3133,6081,3.8,11.1,1152,1.4,22.2,0,307,307,1754
2013,23540,4693,5432,85164,84299,556,10.3,520,9.6,10479,4588,5891,5.4,12.4,8749,3085,5664,3.7,10.4,1730,2,20.8,0,324,325,2074
2014,23540,4751,5502,86106,85431,601,11,493,9,9606,3416,6190,4,11.2,8256,3180,5076,3.7,9.7,1350,1.5,19.4,0,343,344,1837
1977,23580,1339,1421,26962,23600,235,17,167,12.1,9013,2107,6906,8.9,38.2,2289,838,1451,3.6,9.7,6724,28.5,19.4,0,119,121,518
1978,23580,1354,1439,24613,25783,197,13.8,175,12.2,4820,1483,3337,5.8,18.7,7159,5755,1404,22.3,27.8,-2339,-9.1,37.4,0,132,133,5164
1979,23580,1395,1491,26702,25648,236,16.1,177,12.1,4941,1884,3057,7.3,19.3,2832,1010,1822,3.9,11,2109,8.3,22,0,138,138,710
1980,23580,1441,1541,26778,26728,234,15.4,172,11.3,4219,1736,2483,6.5,15.8,4118,1410,2708,5.3,15.4,101,0.4,30.8,0,124,124,724
1981,23580,1443,1538,26348,26372,207,13.5,187,12.2,3951,1553,2398,5.9,15,3998,1521,2477,5.8,15.2,-47,-0.2,30,0,115,115,588
1982,23580,1482,1587,27154,26777,217,13.9,157,10,4526,2237,2289,8.4,16.9,3771,1476,2295,5.5,14.1,755,2.8,28.2,0,90,90,846
1983,23580,1528,1627,27131,26916,191,11.9,161,10,4490,1400,3090,5.2,16.7,4060,1193,2867,4.4,15.1,430,1.6,30.2,0,107,107,582
1984,23580,1680,1781,29160,28154,317,18.6,167,9.8,6411,2614,3797,9.3,22.8,4399,1760,2639,6.3,15.6,2012,7.2,31.2,0,106,106,562
1985,23580,1781,1879,31339,30379,287,15.7,191,10.4,5938,2047,3891,6.7,19.5,4018,1676,2342,5.5,13.2,1920,6.3,26.4,0,128,128,936
1986,23580,1889,1993,32458,31742,317,16.4,197,10.2,5963,2638,3325,8.3,18.8,4531,1219,3312,3.8,14.3,1432,4.5,28.6,0,150,150,881
1987,23580,1958,2097,35363,33932,322,15.7,218,10.6,7778,2426,5352,7.1,22.9,4915,2160,2755,6.4,14.5,2863,8.4,29,0,147,147,1194
1988,23580,1991,2145,39192,37096,300,14.2,245,11.6,8692,2734,5958,7.4,23.4,4500,1679,2821,4.5,12.1,4192,11.3,24.2,0,180,180,798
1989,23580,2020,2181,39182,39195,275,12.7,243,11.2,5724,1784,3940,4.6,14.6,5749,1372,4377,3.5,14.7,-25,-0.1,29.2,0,178,178,832
1990,23580,2016,2187,39379,39243,236,10.8,216,9.9,6059,1739,4320,4.4,15.4,5787,2150,3637,5.5,14.7,272,0.7,29.4,0,148,148,768
1991,23580,2058,2253,41391,40413,286,12.9,226,10.2,7884,2700,5184,6.7,19.5,5927,1625,4302,4,14.7,1957,4.8,29.4,0,162,164,1074
1992,23580,2093,2292,42146,41724,293,12.9,241,10.6,5556,1884,3672,4.5,13.3,4712,1605,3107,3.8,11.3,844,2,22.6,0,168,169,1024
1993,23580,2151,2353,42161,42160,275,11.8,211,9.1,5745,1654,4091,3.9,13.6,5743,1452,4291,3.4,13.6,2,0,27.2,0,150,151,825
1994,23580,2239,2454,44893,43484,338,14.1,241,10,7605,3154,4451,7.3,17.5,4787,1511,3276,3.5,11,2818,6.5,22,0,189,189,851
1995,23580,2333,2548,47582,46209,323,12.9,216,8.6,7786,2003,5783,4.3,16.8,5039,1918,3121,4.2,10.9,2747,5.9,21.8,0,149,149,827
1996,23580,2405,2638,47500,47469,347,13.4,246,9.5,6094,2103,3991,4.4,12.8,6031,1805,4226,3.8,12.7,63,0.1,25.4,0,174,174,779
1997,23580,2468,2711,49579,48444,376,14,291,10.9,8469,3671,4798,7.6,17.5,6199,2074,4125,4.3,12.8,2270,4.7,25.6,0,178,178,957
1998,23580,2595,2826,51653,50659,402,14.5,288,10.4,8421,3187,5234,6.3,16.6,6432,2966,3466,5.9,12.7,1989,3.9,25.4,0,176,176,737
1999,23580,2684,2913,54400,53014,399,13.9,309,10.8,8730,2628,6102,5,16.5,5958,2333,3625,4.4,11.2,2772,5.3,22.4,0,197,197,1369
2000,23580,2738,2987,56814,55578,404,13.7,329,11.2,9665,3407,6258,6.1,17.4,7193,3155,4038,5.7,12.9,2472,4.5,25.8,0,213,213,1691
2001,23580,2758,3016,57051,57101,348,11.6,349,11.6,7502,2638,4864,4.6,13.1,7601,1894,5707,3.3,13.3,-99,-0.2,26.2,0,218,218,973
2002,23580,2840,3105,55690,56332,445,14.6,350,11.4,8203,3053,5150,5.4,14.6,9487,3443,6044,6.1,16.8,-1284,-2.2,29.2,0,181,181,968
2003,23580,2912,3168,56329,55522,443,14.2,314,10.1,8183,2491,5692,4.5,14.7,6568,2435,4133,4.4,11.8,1615,2.9,23.6,0,209,209,1348
2004,23580,3089,3360,59635,57709,474,14.6,260,8,9638,3634,6004,6.3,16.7,5785,1888,3897,3.3,10,3853,6.7,20,0,174,174,843
2005,23580,3219,3523,60164,59721,509,14.8,321,9.3,9685,4679,5006,7.8,16.2,8798,1733,7065,2.9,14.7,887,1.5,29.4,0,230,230,1137
2006,23580,3329,3645,62087,60926,490,13.7,340,9.5,9862,3758,6104,6.2,16.2,7539,2723,4816,4.5,12.4,2323,3.8,24.8,0,231,231,1420
2007,23580,3423,3749,63238,62560,487,13.2,386,10.5,8918,2944,5974,4.7,14.3,7562,2289,5273,3.7,12.1,1356,2.2,24.2,0,274,277,1582
2008,23580,3377,3732,64563,63743,426,11.4,418,11.2,9877,4314,5563,6.8,15.5,8237,2412,5825,3.8,12.9,1640,2.6,25.8,0,323,323,1896
2009,23580,3152,3509,60595,62329,325,9,496,13.7,7661,2942,4719,4.7,12.3,11128,2553,8575,4.1,17.9,-3467,-5.6,24.6,0,358,358,1858
2010,23580,3078,3427,56716,58372,334,9.7,370,10.7,5927,2017,3910,3.5,10.2,9239,3027,6212,5.2,15.8,-3312,-5.6,20.4,0,245,246,2089
2011,23580,3029,3374,59704,58064,328,9.7,353,10.4,8286,2187,6099,3.8,14.3,5005,1879,3126,3.2,8.6,3281,5.7,17.2,0,251,251,1422
2012,23580,3073,3412,60283,59964,366,10.8,320,9.5,7362,2223,5139,3.7,12.3,6723,2196,4527,3.7,11.2,639,1.1,22.4,0,192,192,1196
2013,23580,3108,3454,62488,61345,352,10.3,309,9,7306,1749,5557,2.9,11.9,5019,1773,3246,2.9,8.2,2287,3.7,16.4,0,209,209,1303
2014,23580,3148,3512,63710,63033,376,10.8,298,8.6,9266,2980,6286,4.7,14.7,7911,3110,4801,4.9,12.6,1355,2.1,25.2,0,200,201,974
1977,24020,1785,1941,26626,25745,272,14.1,236,12.3,5670,3245,2425,12.6,22,3908,1735,2173,6.7,15.2,1762,6.8,30.4,0,140,140,753
1978,24020,1837,1998,28963,27796,269,13.7,214,10.9,4918,1942,2976,7,17.7,2584,1190,1394,4.3,9.3,2334,8.4,18.6,0,138,139,485
1979,24020,1898,2069,29044,28982,279,13.7,196,9.6,4308,1685,2623,5.8,14.9,4183,1953,2230,6.7,14.4,125,0.5,28.8,0,125,126,591
1980,24020,1948,2126,30615,29884,279,13.3,215,10.3,4695,1401,3294,4.7,15.7,3233,1157,2076,3.9,10.8,1462,4.9,21.6,0,140,140,462
1981,24020,1846,2039,27834,28702,227,10.9,293,14.1,3739,1804,1935,6.3,13,5474,3104,2370,10.8,19.1,-1735,-6.1,26,0,178,179,1793
1982,24020,1871,2081,28513,28185,262,12.7,202,9.8,4281,2036,2245,7.2,15.2,3624,1163,2461,4.1,12.9,657,2.3,25.8,0,104,104,608
1983,24020,1941,2145,28146,28277,236,11.2,190,9,3475,1107,2368,3.9,12.3,3736,1009,2727,3.6,13.2,-261,-0.9,24.6,0,118,118,426
1984,24020,2042,2242,37389,32772,283,12.9,187,8.5,12166,2194,9972,6.7,37.1,2932,1006,1926,3.1,8.9,9234,28.2,17.8,0,117,117,414
1985,24020,2120,2331,32173,35313,286,12.5,213,9.3,4260,1395,2865,4,12.1,10540,1185,9355,3.4,29.8,-6280,-17.7,24.2,0,131,132,457
1986,24020,2219,2440,33974,33068,334,14,218,9.1,5722,2186,3536,6.6,17.3,3909,930,2979,2.8,11.8,1813,5.5,23.6,0,126,126,482
1987,24020,2344,2590,36450,35227,380,15.1,227,9,5927,1677,4250,4.8,16.8,3481,1371,2110,3.9,9.9,2446,6.9,19.8,0,146,147,746
1988,24020,2404,2651,36215,35741,378,14.5,297,11.4,6091,2386,3705,6.7,17,5143,1765,3378,4.9,14.4,948,2.6,28.8,0,197,197,809
1989,24020,2476,2740,38654,37447,364,13.5,273,10.1,7231,2447,4784,6.5,19.3,4816,1892,2924,5.1,12.9,2415,6.4,25.8,0,172,176,888
1990,24020,2484,2755,39201,38793,351,12.8,307,11.2,6053,1994,4059,5.1,15.6,5237,1549,3688,4,13.5,816,2.1,27,0,214,214,896
1991,24020,2516,2819,38756,39051,326,11.7,263,9.4,5750,2494,3256,6.4,14.7,6339,2041,4298,5.2,16.2,-589,-1.5,29.4,0,175,175,1016
1992,24020,2424,2727,37939,38267,279,10.1,340,12.3,4971,1782,3189,4.7,13,5627,2051,3576,5.4,14.7,-656,-1.7,26,0,225,225,1271
1993,24020,2369,2673,41200,39522,243,9,276,10.2,8239,1673,6566,4.2,20.8,4882,1379,3503,3.5,12.4,3357,8.4,24.8,0,181,181,672
1994,24020,2352,2667,40006,40498,256,9.6,265,9.9,5971,2100,3871,5.2,14.7,6955,2375,4580,5.9,17.2,-984,-2.5,29.4,0,178,178,812
1995,24020,2360,2680,41162,40511,266,10,229,8.6,6983,1921,5062,4.7,17.2,5680,1469,4211,3.6,14,1303,3.2,28,0,145,145,572
1996,24020,2354,2676,42424,41661,269,10.1,258,9.6,6633,1997,4636,4.8,15.9,5106,1640,3466,3.9,12.3,1527,3.6,24.6,0,157,157,543
1997,24020,2362,2701,41015,41852,289,10.7,277,10.3,5136,1808,3328,4.3,12.3,6810,2413,4397,5.8,16.3,-1674,-4,24.6,0,166,166,718
1998,24020,2389,2736,41849,41446,263,9.7,242,8.9,6706,1723,4983,4.2,16.2,5899,1593,4306,3.8,14.2,807,2,28.4,0,152,152,643
1999,24020,2408,2777,42517,42151,280,10.2,226,8.2,5071,1367,3704,3.2,12,4339,1079,3260,2.6,10.3,732,1.7,20.6,0,150,150,658
2000,24020,2411,2784,44103,43302,261,9.4,252,9.1,5932,2660,3272,6.1,13.7,4330,1459,2871,3.4,10,1602,3.7,20,0,168,168,797
2001,24020,2476,2858,44503,44368,274,9.7,238,8.4,9153,3218,5935,7.3,20.6,8882,6237,2645,14.1,20,271,0.6,40,0,144,144,778
2002,24020,2495,2887,45363,44900,348,12.1,322,11.2,7453,3657,3796,8.1,16.6,6526,2830,3696,6.3,14.5,927,2.1,29,0,149,149,795
2003,24020,2476,2865,45296,43901,302,10.6,271,9.5,7908,3167,4741,7.2,18,5118,2141,2977,4.9,11.7,2790,6.3,23.4,0,189,189,1399
2004,24020,2513,2909,43564,44149,328,11.4,256,8.9,5887,1764,4123,4,13.3,7057,1709,5348,3.9,16,-1170,-2.7,26.6,0,157,157,855
2005,24020,2543,2945,43487,43443,294,10.1,241,8.2,5196,2160,3036,5,12,5107,1347,3760,3.1,11.8,89,0.2,23.6,0,169,169,909
2006,24020,2540,2953,42950,42887,296,10.1,255,8.7,5298,2097,3201,4.9,12.4,5172,1829,3343,4.3,12.1,126,0.3,24.2,0,177,177,1049
2007,24020,2556,2994,43355,43118,325,11,264,8.9,5446,1547,3899,3.6,12.6,4971,1590,3381,3.7,11.5,475,1.1,23,0,168,168,764
2008,24020,2558,3002,43797,43503,296,9.9,268,9,4852,1733,3119,4,11.2,4264,1015,3249,2.3,9.8,588,1.4,19.6,0,184,184,767
2009,24020,2501,2933,41572,42670,220,7.4,279,9.4,3232,1048,2184,2.5,7.6,5427,1363,4064,3.2,12.7,-2195,-5.1,15.2,0,157,157,878
2010,24020,2507,2942,41275,41351,244,8.3,231,7.9,4215,1407,2808,3.4,10.2,4366,890,3476,2.2,10.6,-151,-0.4,20.4,0,151,151,654
2011,24020,2467,2897,41629,41205,247,8.5,268,9.2,4845,1212,3633,2.9,11.8,3996,1317,2679,3.2,9.7,849,2.1,19.4,0,153,153,574
2012,24020,2485,2927,41926,41783,268,9.2,249,8.6,4828,1749,3079,4.2,11.6,4542,1014,3528,2.4,10.9,286,0.7,21.8,0,149,149,560
2013,24020,2447,2879,41269,41561,216,7.5,265,9.1,3872,1153,2719,2.8,9.3,4455,1287,3168,3.1,10.7,-583,-1.4,18.6,0,147,148,745
2014,24020,2443,2875,42029,41576,245,8.5,231,8.1,4439,1224,3215,2.9,10.7,3532,1117,2415,2.7,8.5,907,2.2,17,0,165,165,938
1977,24140,1497,1598,21087,20218,270,17.4,168,10.8,4274,1750,2524,8.7,21.1,2536,861,1675,4.3,12.5,1738,8.6,25,0,124,124,451
1978,24140,1498,1605,22535,21810,202,12.6,193,12.1,3929,1324,2605,6.1,18,2478,915,1563,4.2,11.4,1451,6.6,22.8,0,139,139,483
1979,24140,1545,1655,23402,22959,215,13.2,157,9.6,3645,1346,2299,5.9,15.9,2758,1128,1630,4.9,12,887,3.9,24,0,108,108,686
1980,24140,1558,1664,22821,23097,188,11.3,174,10.5,2953,1239,1714,5.4,12.8,3505,945,2560,4.1,15.2,-552,-2.4,25.6,0,120,120,412
1981,24140,1521,1624,21993,22410,183,11.1,220,13.4,2765,936,1829,4.2,12.3,3599,1635,1964,7.3,16.1,-834,-3.8,24.6,0,136,137,709
1982,24140,1512,1632,21776,21886,211,13,187,11.5,3103,1819,1284,8.3,14.2,3323,993,2330,4.5,15.2,-220,-1,28.4,0,118,118,473
1983,24140,1429,1549,21127,21355,149,9.4,211,13.3,3116,1201,1915,5.6,14.6,3572,1256,2316,5.9,16.7,-456,-2.1,29.2,0,113,113,424
1984,24140,1590,1724,23739,22493,238,14.5,102,6.2,4274,1723,2551,7.7,19,1781,512,1269,2.3,7.9,2493,11.1,15.8,0,4,4,49
1985,24140,1663,1801,24649,24197,252,14.3,177,10,3763,1403,2360,5.8,15.6,2858,1196,1662,4.9,11.8,905,3.8,23.6,0,103,103,508
1986,24140,1690,1825,25799,25086,232,12.8,201,11.1,4927,2876,2051,11.5,19.6,3501,1382,2119,5.5,14,1426,5.6,28,0,127,127,536
1987,24140,1731,1893,29321,28267,268,14.4,187,10,5287,1618,3669,5.7,18.7,3179,1220,1959,4.3,11.2,2108,7.5,22.4,0,124,124,536
1988,24140,1673,1844,30267,29756,185,9.9,213,11.4,4411,1285,3126,4.3,14.8,3389,1389,2000,4.7,11.4,1022,3.4,22.8,0,133,133,600
1989,24140,1693,1875,32166,31315,202,10.9,172,9.3,5008,1933,3075,6.2,16,3305,1002,2303,3.2,10.6,1703,5.4,21.2,0,124,124,587
1990,24140,1704,1890,32800,32427,193,10.3,171,9.1,4281,1305,2976,4,13.2,3535,1074,2461,3.3,10.9,746,2.3,21.8,0,120,120,697
1991,24140,1713,1898,30746,31392,196,10.3,189,10,3601,1285,2316,4.1,11.5,4893,1272,3621,4.1,15.6,-1292,-4.1,23,0,113,113,776
1992,24140,1731,1916,30649,30717,177,9.3,160,8.4,3412,835,2577,2.7,11.1,3547,861,2686,2.8,11.5,-135,-0.4,22.2,0,108,108,577
1993,24140,1769,1955,32534,31686,195,10.1,153,7.9,4467,1579,2888,5,14.1,2770,655,2115,2.1,8.7,1697,5.4,17.4,0,110,110,413
1994,24140,1786,1973,33084,32780,188,9.6,165,8.4,4471,1492,2979,4.6,13.6,3862,1796,2066,5.5,11.8,609,1.8,23.6,0,112,112,1004
1995,24140,1818,2007,34807,33928,223,11.2,174,8.8,4744,1689,3055,5,14,2985,1058,1927,3.1,8.8,1759,5.2,17.6,0,126,126,577
1996,24140,1843,2045,35569,35194,205,10.1,165,8.1,4510,1682,2828,4.8,12.8,3759,1127,2632,3.2,10.7,751,2.1,21.4,0,118,118,782
1997,24140,1876,2084,36320,35945,227,11,192,9.3,5188,1796,3392,5,14.4,4437,2004,2433,5.6,12.3,751,2.1,24.6,0,119,119,844
1998,24140,1928,2141,36639,36496,240,11.4,185,8.8,4327,1737,2590,4.8,11.9,4040,1533,2507,4.2,11.1,287,0.8,22.2,0,124,124,602
1999,24140,1940,2173,37603,37133,230,10.7,190,8.8,5695,1973,3722,5.3,15.3,4754,1548,3206,4.2,12.8,941,2.5,25.6,0,138,138,650
2000,24140,1910,2137,37835,37727,192,8.9,228,10.6,4867,1663,3204,4.4,12.9,4650,2059,2591,5.5,12.3,217,0.6,24.6,0,133,133,695
2001,24140,1915,2150,38621,38359,203,9.5,203,9.5,5130,2076,3054,5.4,13.4,4606,1449,3157,3.8,12,524,1.4,24,0,121,121,870
2002,24140,1885,2113,37498,38023,202,9.5,236,11.1,4771,2012,2759,5.3,12.5,5820,1851,3969,4.9,15.3,-1049,-2.8,25,0,122,122,702
2003,24140,1886,2094,38182,37745,201,9.6,188,9,4937,1349,3588,3.6,13.1,4063,1116,2947,3,10.8,874,2.3,21.6,0,125,125,707
2004,24140,1864,2073,38998,38497,188,9,187,9,5008,961,4047,2.5,13,4006,1552,2454,4,10.4,1002,2.6,20.8,0,132,132,571
2005,24140,1882,2095,38398,38568,207,10,164,7.9,4862,1961,2901,5.1,12.6,5202,1111,4091,2.9,13.5,-340,-0.9,25.2,0,124,124,659
2006,24140,1900,2125,38223,38135,220,10.4,177,8.4,5382,2113,3269,5.5,14.1,5205,1703,3502,4.5,13.6,177,0.5,27.2,0,135,135,1157
2007,24140,1920,2174,38614,38535,233,10.8,191,8.9,5257,1677,3580,4.4,13.6,5099,1352,3747,3.5,13.2,158,0.4,26.4,0,125,125,657
2008,24140,1871,2128,38155,38259,181,8.4,198,9.2,4641,1992,2649,5.2,12.1,4848,1244,3604,3.3,12.7,-207,-0.6,24.2,0,155,155,1001
2009,24140,1801,2052,36459,37075,148,7.1,204,9.8,3347,1027,2320,2.8,9,4579,1349,3230,3.6,12.4,-1232,-3.4,18,0,154,154,925
2010,24140,1780,2043,35888,36177,166,8.1,164,8,3461,1730,1731,4.8,9.6,4039,1088,2951,3,11.2,-578,-1.6,19.2,0,108,108,618
2011,24140,1750,2003,36158,35970,126,6.2,149,7.4,3382,1002,2380,2.8,9.4,3006,862,2144,2.4,8.4,376,1,16.8,0,103,103,575
2012,24140,1740,1994,35170,35676,140,7,159,8,3097,844,2253,2.4,8.7,4109,1105,3004,3.1,11.5,-1012,-2.8,17.4,0,104,104,725
2013,24140,1730,1981,35502,35330,135,6.8,151,7.6,3425,793,2632,2.2,9.7,3080,752,2328,2.1,8.7,345,1,17.4,0,91,91,405
2014,24140,1718,1966,36105,35665,146,7.4,145,7.4,3709,969,2740,2.7,10.4,2829,834,1995,2.3,7.9,880,2.5,15.8,0,104,104,580
1977,24220,1905,2046,22848,22075,353,17.8,228,11.5,4823,2548,2275,11.5,21.8,3276,1352,1924,6.1,14.8,1547,7,29.6,0,147,150,888
1978,24220,1925,2070,25448,24155,266,12.9,241,11.7,5775,1517,4258,6.3,23.9,3189,1605,1584,6.6,13.2,2586,10.7,26.4,0,168,168,836
1979,24220,1960,2110,26473,25932,296,14.2,238,11.4,4771,2284,2487,8.8,18.4,3689,1299,2390,5,14.2,1082,4.2,28.4,0,158,158,716
1980,24220,1928,2075,26124,26279,216,10.3,249,11.9,3827,1264,2563,4.8,14.6,4136,1494,2642,5.7,15.7,-309,-1.1,29.2,0,169,169,873
1981,24220,1858,1998,24583,24951,201,9.9,241,11.9,3215,1287,1928,5.2,12.9,3950,1458,2492,5.8,15.8,-735,-2.9,25.8,0,141,141,657
1982,24220,1868,2029,25033,24775,231,11.5,172,8.5,3950,1972,1978,8,15.9,3434,940,2494,3.8,13.9,516,2,27.8,0,97,97,476
1983,24220,1906,2063,24720,24859,216,10.6,200,9.8,3528,1504,2024,6.1,14.2,3806,1087,2719,4.4,15.3,-278,-1.1,28.4,0,130,130,680
1984,24220,1939,2099,24583,24609,246,11.8,215,10.3,3594,1138,2456,4.6,14.6,3645,1462,2183,5.9,14.8,-51,-0.2,29.2,0,123,123,494
1985,24220,2004,2160,27528,26464,258,12.1,217,10.1,5387,2200,3187,8.3,20.4,3258,1217,2041,4.6,12.3,2129,8.1,24.6,0,144,144,753
1986,24220,1996,2156,27029,27268,220,10.2,217,10.1,4224,1667,2557,6.1,15.5,4702,1413,3289,5.2,17.2,-478,-1.7,31,0,124,124,831
1987,24220,2020,2194,28990,28008,251,11.5,209,9.6,5199,1832,3367,6.5,18.6,3235,1033,2202,3.7,11.6,1964,7,23.2,0,137,137,758
1988,24220,1983,2165,28753,28492,218,10,218,10,3937,1344,2593,4.7,13.8,3415,1120,2295,3.9,12,522,1.8,24,0,124,124,568
1989,24220,2023,2213,29510,29130,230,10.5,183,8.4,4062,1375,2687,4.7,13.9,3302,1052,2250,3.6,11.3,760,2.6,22.6,0,130,131,650
1990,24220,2023,2232,30706,30086,215,9.7,187,8.4,4208,1431,2777,4.8,14,2967,1172,1795,3.9,9.9,1241,4.1,19.8,0,137,137,848
1991,24220,2050,2258,31293,31003,239,10.7,205,9.1,4490,2082,2408,6.7,14.5,3909,1257,2652,4.1,12.6,581,1.9,25.2,0,130,130,725
1992,24220,2070,2302,31467,31374,252,11,210,9.2,4726,2013,2713,6.4,15.1,4540,1990,2550,6.3,14.5,186,0.6,29,0,139,141,907
1993,24220,2096,2327,32848,32159,191,8.3,164,7.1,4514,1239,3275,3.9,14,3135,1061,2074,3.3,9.7,1379,4.3,19.4,0,116,118,594
1994,24220,2122,2351,33601,33210,194,8.3,168,7.2,4287,1125,3162,3.4,12.9,3504,786,2718,2.4,10.6,783,2.3,21.2,0,116,116,508
1995,24220,2110,2341,34543,34033,184,7.8,184,7.8,4801,1237,3564,3.6,14.1,3780,1115,2665,3.3,11.1,1021,3,22.2,0,117,120,666
1996,24220,2144,2381,35770,35173,212,9,167,7.1,5183,2273,2910,6.5,14.7,3988,968,3020,2.8,11.3,1195,3.4,22.6,0,114,114,724
1997,24220,2104,2354,36645,36141,204,8.6,226,9.5,5471,1130,4341,3.1,15.1,4462,1734,2728,4.8,12.3,1009,2.8,24.6,0,128,128,699
1998,24220,2098,2336,36477,36540,225,9.6,236,10.1,6469,1689,4780,4.6,17.7,6594,3569,3025,9.8,18,-125,-0.3,35.4,0,151,151,1945
1999,24220,2069,2326,36255,36396,191,8.2,199,8.5,4668,1517,3151,4.2,12.8,4949,1261,3688,3.5,13.6,-281,-0.8,25.6,0,119,119,525
2000,24220,2052,2313,36329,36261,210,9.1,228,9.8,5024,1680,3344,4.6,13.9,4887,1563,3324,4.3,13.5,137,0.4,27,0,144,144,1052
2001,24220,2080,2356,37284,36952,226,9.7,198,8.5,5341,2566,2775,6.9,14.5,4676,1170,3506,3.2,12.7,665,1.8,25.4,0,105,105,523
2002,24220,2064,2345,35494,36359,225,9.6,233,9.9,4955,2028,2927,5.6,13.6,6685,1662,5023,4.6,18.4,-1730,-4.8,27.2,0,115,115,837
2003,24220,2039,2323,36134,35686,191,8.2,174,7.5,4653,1156,3497,3.2,13,3756,1035,2721,2.9,10.5,897,2.5,21,0,119,119,735
2004,24220,2049,2334,36924,36417,180,7.7,155,6.7,4366,762,3604,2.1,12,3351,1037,2314,2.8,9.2,1015,2.8,18.4,0,99,99,544
2005,24220,2076,2372,39257,38010,217,9.2,168,7.2,5556,1885,3671,5,14.6,3061,877,2184,2.3,8.1,2495,6.5,16.2,0,116,116,685
2006,24220,2077,2380,40228,39592,196,8.3,163,6.9,5103,1842,3261,4.7,12.9,3830,969,2861,2.4,9.7,1273,3.2,19.4,0,93,93,572
2007,24220,2105,2372,42455,41372,211,8.9,213,9,6971,2568,4403,6.2,16.8,4805,1933,2872,4.7,11.6,2166,5.2,23.2,0,98,98,1216
2008,24220,2085,2374,41423,41789,175,7.4,145,6.1,4767,1550,3217,3.7,11.4,5499,1269,4230,3,13.2,-732,-1.8,22.8,0,113,113,1109
2009,24220,2061,2343,40510,40928,163,6.9,186,7.9,4556,1074,3482,2.6,11.1,5391,1242,4149,3,13.2,-835,-2.1,22.2,0,113,113,602
2010,24220,2072,2351,40878,40674,157,6.7,145,6.2,4278,1014,3264,2.5,10.5,3869,734,3135,1.8,9.5,409,1,19,0,85,85,469
2011,24220,2056,2345,40161,40421,158,6.7,148,6.3,3902,883,3019,2.2,9.7,4422,869,3553,2.1,10.9,-520,-1.2,19.4,0,93,93,558
2012,24220,2097,2384,41623,40836,202,8.6,157,6.7,5286,1855,3431,4.5,12.9,3711,960,2751,2.4,9.1,1575,3.8,18.2,0,87,88,441
2013,24220,2092,2385,42327,41995,176,7.4,184,7.7,4926,1505,3421,3.6,11.7,4262,1108,3154,2.6,10.1,664,1.6,20.2,0,118,118,852
2014,24220,2109,2407,42501,42313,195,8.2,159,6.7,4669,1475,3194,3.5,11,4293,1605,2688,3.8,10.1,376,0.9,20.2,0,100,101,830
1977,24300,1728,1813,18213,17655,440,25.6,246,14.3,5104,2712,2392,15.4,28.9,3987,1984,2003,11.2,22.6,1117,6.3,45.2,0,176,177,1148
1978,24300,1711,1807,21877,19994,358,19.8,344,19,6973,2971,4002,14.9,34.9,3206,1962,1244,9.8,16,3767,18.9,32,0,223,223,1134
1979,24300,1968,2065,25643,23794,438,22.6,186,9.6,7204,2599,4605,10.9,30.3,3506,1147,2359,4.8,14.7,3698,15.6,29.4,0,4,4,14
1980,24300,2038,2147,26676,26187,393,18.7,305,14.5,6695,2631,4064,10,25.6,5716,1951,3765,7.5,21.8,979,3.8,43.6,0,236,236,1415
1981,24300,2120,2235,27808,27108,493,22.6,383,17.5,7331,3852,3479,14.2,27,5931,2327,3604,8.6,21.9,1400,5.1,43.8,0,241,243,1483
1982,24300,2373,2530,31008,29302,663,27.8,339,14.2,9157,4998,4159,17.1,31.3,5744,2756,2988,9.4,19.6,3413,11.7,39.2,0,219,219,1242
1983,24300,2319,2473,27711,29154,414,16.6,473,18.9,6158,2919,3239,10,21.1,9043,3086,5957,10.6,31,-2885,-9.9,42.2,0,335,335,1949
1984,24300,2242,2384,25638,26684,383,15.8,475,19.6,5190,2155,3035,8.1,19.4,7282,2657,4625,10,27.3,-2092,-7.9,38.8,0,318,318,1394
1985,24300,2106,2238,25238,25432,323,14,453,19.6,5832,2020,3812,7.9,22.9,6220,2877,3343,11.3,24.5,-388,-1.6,45.8,0,306,306,1494
1986,24300,2017,2150,22616,23926,303,13.8,385,17.5,4846,2247,2599,9.4,20.3,7466,2623,4843,11,31.2,-2620,-10.9,40.6,0,272,272,1571
1987,24300,2035,2163,22648,22674,366,17,338,15.7,5525,2909,2616,12.8,24.4,5576,2490,3086,11,24.6,-51,-0.2,48.8,0,216,223,1529
1988,24300,1964,2096,22854,22639,266,12.5,316,14.9,4337,1793,2544,7.9,19.2,3907,1859,2048,8.2,17.3,430,1.9,34.6,0,216,216,950
1989,24300,2012,2149,25934,24579,274,12.9,227,10.7,5429,2141,3288,8.7,22.1,2718,976,1742,4,11.1,2711,11,22.2,0,164,164,732
1990,24300,2065,2209,27147,26504,301,13.8,232,10.6,4884,1689,3195,6.4,18.4,3598,1442,2156,5.4,13.6,1286,4.8,27.2,0,166,166,820
1991,24300,2134,2297,28266,27732,323,14.3,239,10.6,5413,2268,3145,8.2,19.5,4345,2294,2051,8.3,15.7,1068,3.8,31.4,0,156,156,1615
1992,24300,2177,2359,29083,28654,352,15.1,277,11.9,5437,2343,3094,8.2,19,4579,1528,3051,5.3,16,858,3,32,0,194,194,1045
1993,24300,2224,2405,30972,30019,298,12.5,249,10.5,5658,1672,3986,5.6,18.8,3751,1157,2594,3.9,12.5,1907,6.3,25,0,174,174,640
1994,24300,2364,2561,31600,31295,373,15,218,8.8,5003,1911,3092,6.1,16,4392,1539,2853,4.9,14,611,2,28,0,150,150,972
1995,24300,2510,2704,34238,32922,404,15.4,248,9.4,6332,2782,3550,8.5,19.2,3700,1468,2232,4.5,11.2,2632,8,22.4,0,173,174,1106
1996,24300,2644,2844,36218,35167,443,16,292,10.5,6896,2960,3936,8.4,19.6,4793,1924,2869,5.5,13.6,2103,6,27.2,0,212,212,1220
1997,24300,2745,2967,36483,36357,443,15.2,314,10.8,6314,2213,4101,6.1,17.4,6062,2256,3806,6.2,16.7,252,0.7,33.4,0,210,210,988
1998,24300,2843,3068,39081,37751,429,14.2,321,10.6,7172,3389,3783,9,19,4512,2020,2492,5.4,12,2660,7,24,0,225,225,1187
1999,24300,2910,3152,39898,39470,437,14,347,11.2,6423,2714,3709,6.9,16.3,5566,2061,3505,5.2,14.1,857,2.2,28.2,0,237,237,1015
2000,24300,2998,3263,44130,42033,440,13.7,330,10.3,9704,3851,5853,9.2,23.1,5510,2060,3450,4.9,13.1,4194,10,26.2,0,220,220,1182
2001,24300,3077,3375,43232,43786,453,13.6,372,11.2,6289,2351,3938,5.4,14.4,7396,2170,5226,5,16.9,-1107,-2.5,28.8,0,210,210,1053
2002,24300,3141,3430,43953,43527,473,13.9,416,12.2,7775,3661,4114,8.4,17.9,6922,2443,4479,5.6,15.9,853,2,31.8,0,228,228,1076
2003,24300,3307,3597,45694,44562,509,14.5,287,8.2,7592,3183,4409,7.1,17,5327,1522,3805,3.4,12,2265,5,24,0,193,193,813
2004,24300,3422,3717,46422,45695,486,13.3,320,8.8,6925,2953,3972,6.5,15.2,5471,1442,4029,3.2,12,1454,3.2,24,0,215,215,1000
2005,24300,3584,3899,48484,47304,572,15,358,9.4,8057,3179,4878,6.7,17,5697,2181,3516,4.6,12,2360,5,24,0,274,274,1621
2006,24300,3762,4089,51751,50024,583,14.6,348,8.7,10093,3618,6475,7.2,20.2,6639,2547,4092,5.1,13.3,3454,6.9,26.6,0,249,250,1964
2007,24300,3963,4311,56199,53889,631,15,403,9.6,11828,4419,7409,8.2,21.9,7207,2694,4513,5,13.4,4621,8.5,26.8,0,281,281,1601
2008,24300,4124,4489,64385,60147,619,14.1,420,9.6,16325,3237,13088,5.4,27.1,7849,2033,5816,3.4,13,8476,14.1,26,0,315,315,1431
2009,24300,3956,4323,76109,70083,440,10,547,12.4,21608,2914,18694,4.2,30.8,9556,3157,6399,4.5,13.6,12052,17.2,27.2,0,403,403,1604
2010,24300,3694,4063,67626,71826,342,8.2,581,13.9,6185,2174,4011,3,8.6,14584,3100,11484,4.3,20.3,-8399,-11.7,17.2,0,390,390,2215
2011,24300,3638,4001,71551,69369,417,10.4,440,11,11075,2725,8350,3.9,16,6711,1943,4768,2.8,9.7,4364,6.3,19.4,0,300,300,1311
2012,24300,3629,3999,74099,72726,428,10.7,430,10.8,10152,2835,7317,3.9,14,7406,2698,4708,3.7,10.2,2746,3.8,20.4,0,262,263,1705
2013,24300,3597,3961,76172,74934,338,8.5,363,9.2,8686,1609,7077,2.1,11.6,6209,1699,4510,2.3,8.3,2477,3.3,16.6,0,257,257,1258
2014,24300,3580,3942,78190,77104,370,9.4,363,9.2,8530,2115,6415,2.7,11.1,6357,1518,4839,2,8.2,2173,2.9,16.4,0,257,257,1043
1977,24340,8909,10047,182077,176591,1530,15.5,1162,11.8,33339,12323,21016,7,18.9,22367,9580,12787,5.4,12.7,10972,6.2,25.4,0,717,720,5459
1978,24340,9155,10328,197406,189749,1383,13.6,1106,10.9,36303,10294,26009,5.4,19.1,20988,10153,10835,5.4,11.1,15315,8,22.2,0,737,741,4219
1979,24340,9353,10565,213197,205176,1312,12.6,1031,9.9,37307,11613,25694,5.7,18.2,21265,7571,13694,3.7,10.4,16042,7.8,20.8,0,736,742,4942
1980,24340,9358,10590,208369,210646,1220,11.5,1155,10.9,26626,9021,17605,4.3,12.6,31180,10831,20349,5.1,14.8,-4554,-2.2,25.2,0,788,790,5649
1981,24340,9112,10271,206181,207115,1148,11,1373,13.2,27449,10800,16649,5.2,13.3,29316,10664,18652,5.1,14.2,-1867,-0.9,26.6,0,784,787,4926
1982,24340,9288,10621,202113,203986,1416,13.5,988,9.5,27236,12482,14754,6.1,13.4,30982,7459,23523,3.7,15.2,-3746,-1.8,26.8,0,558,558,3612
1983,24340,9598,10973,200435,201756,1237,11.5,995,9.2,27348,8499,18849,4.2,13.6,29990,8191,21799,4.1,14.9,-2642,-1.3,27.2,0,656,658,4381
1984,24340,10037,11410,219257,209503,1417,12.7,1005,9,39207,12384,26823,5.9,18.7,19699,8067,11632,3.9,9.4,19508,9.3,18.8,0,654,655,3606
1985,24340,10372,11794,233695,226294,1471,12.7,1080,9.3,35517,10878,24639,4.8,15.7,20714,8562,12152,3.8,9.2,14803,6.5,18.4,0,734,739,4840
1986,24340,10595,12060,245168,239423,1515,12.7,1219,10.2,37710,12084,25626,5,15.8,26220,9924,16296,4.1,11,11490,4.8,22,0,819,819,5452
1987,24340,11035,12658,260529,253326,1808,14.6,1177,9.5,46456,16827,29629,6.6,18.3,32050,11087,20963,4.4,12.7,14406,5.6,25.4,0,750,753,4810
1988,24340,11217,12898,268694,264570,1551,12.1,1278,10,44791,15563,29228,5.9,16.9,36542,13888,22654,5.2,13.8,8249,3.1,27.6,0,810,810,5012
1989,24340,11493,13288,287495,278184,1523,11.6,1163,8.9,51507,18268,33239,6.6,18.5,32885,10122,22763,3.6,11.8,18622,6.7,23.6,0,800,806,5573
1990,24340,11751,13626,287704,287420,1537,11.4,1125,8.4,39190,13209,25981,4.6,13.6,38623,9966,28657,3.5,13.4,567,0.2,26.8,0,774,774,5193
1991,24340,11940,13870,281529,284185,1537,11.2,1284,9.3,35733,12974,22759,4.6,12.6,41046,12420,28626,4.4,14.4,-5313,-1.8,25.2,0,792,806,7134
1992,24340,12181,14214,284048,282946,1629,11.6,1243,8.8,39271,12640,26631,4.5,13.9,37067,10414,26653,3.7,13.1,2204,0.8,26.2,0,736,744,5325
1993,24340,12384,14438,293095,288505,1436,10,1175,8.2,41545,11140,30405,3.9,14.4,32364,9317,23047,3.2,11.2,9181,3.2,22.4,0,793,794,4842
1994,24340,12772,14862,307818,300365,1625,11.1,1160,7.9,44938,13278,31660,4.4,15,30031,10415,19616,3.5,10,14907,5,20,0,771,779,5929
1995,24340,13098,15264,321399,314345,1714,11.4,1252,8.3,46897,16278,30619,5.2,14.9,32789,9872,22917,3.1,10.4,14108,4.5,20.8,0,862,864,6153
1996,24340,13469,15710,329167,325633,1693,10.9,1250,8.1,44499,14384,30115,4.4,13.7,37431,10053,27378,3.1,11.5,7068,2.2,23,0,811,811,5046
1997,24340,13617,15952,336642,332594,1748,11,1496,9.4,48620,15002,33618,4.5,14.6,40524,13900,26624,4.2,12.2,8096,2.4,24.4,0,938,938,5557
1998,24340,13676,16050,347717,342073,1627,10.2,1505,9.4,52804,17848,34956,5.2,15.4,41516,15773,25743,4.6,12.1,11288,3.3,24.2,0,962,962,6111
1999,24340,13627,16140,353884,350958,1553,9.6,1429,8.9,49959,16850,33109,4.8,14.2,44107,13896,30211,4,12.6,5852,1.6,25.2,0,926,926,6999
2000,24340,13676,16328,364299,359131,1712,10.5,1525,9.4,56898,21169,35729,5.9,15.8,46561,17779,28782,5,13,10337,2.8,26,0,889,889,7063
2001,24340,13671,16481,358021,362057,1693,10.3,1646,10,49658,19675,29983,5.4,13.7,57729,17046,40683,4.7,15.9,-8071,-2.2,27.4,0,909,911,6662
2002,24340,13833,16630,356385,358243,1992,12,1823,11,58557,27108,31449,7.6,16.3,62272,20418,41854,5.7,17.4,-3715,-1.1,32.6,0,853,853,6240
2003,24340,13913,16751,354935,353734,1805,10.9,1448,8.7,54849,21585,33264,6.1,15.5,52446,15100,37346,4.3,14.8,2403,0.7,29.6,0,931,937,7539
2004,24340,14044,16852,352381,352039,1771,10.6,1511,9,51221,21143,30078,6,14.5,50537,17848,32689,5.1,14.4,684,0.1,28.8,0,934,941,8873
2005,24340,14288,17194,355548,353283,1841,10.8,1370,8.1,51962,22613,29349,6.4,14.7,47431,11227,36204,3.2,13.4,4531,1.3,26.8,0,911,913,7026
2006,24340,14225,17272,360380,356755,1829,10.6,1603,9.3,51126,16578,34548,4.6,14.3,43875,14526,29349,4.1,12.3,7251,2,24.6,0,1051,1052,8321
2007,24340,14172,17246,361571,360858,1650,9.6,1654,9.6,51863,19612,32251,5.4,14.4,50436,14583,35853,4,14,1427,0.4,28,0,978,1006,6706
2008,24340,13916,17029,372325,365843,1529,9,1576,9.2,62658,13955,48703,3.8,17.1,49693,17337,32356,4.7,13.6,12965,3.5,27.2,0,1106,1108,12764
2009,24340,13459,16517,349750,359842,1307,7.8,1697,10.1,41262,14733,26529,4.1,11.5,61445,16026,45419,4.5,17.1,-20183,-5.6,23,0,1111,1111,11127
2010,24340,13184,16254,341500,344604,1198,7.3,1316,8.1,37249,11374,25875,3.3,10.8,43457,10172,33285,3,12.6,-6208,-1.8,21.6,0,840,840,5765
2011,24340,13159,16246,347583,343788,1330,8.2,1207,7.5,50383,12558,37825,3.7,14.7,42792,11597,31195,3.4,12.4,7591,2.3,24.8,0,723,724,6715
2012,24340,13259,16432,366161,356716,1450,8.9,1297,7.9,57784,15765,42019,4.4,16.2,38894,15582,23312,4.4,10.9,18890,5.3,21.8,0,732,738,8219
2013,24340,13295,16443,370210,367858,1244,7.6,1214,7.4,39605,10215,29390,2.8,10.8,34901,11211,23690,3,9.5,4704,1.3,19,0,735,736,6497
2014,24340,13309,16457,382410,375391,1321,8.1,1162,7.1,49135,10497,38638,2.8,13.1,35096,14196,20900,3.8,9.3,14039,3.8,18.6,0,797,797,5243
1977,24500,1722,1888,28245,23758,361,19.9,213,11.7,12046,2944,9102,12.4,50.7,3071,1324,1747,5.6,12.9,8975,37.8,25.8,0,149,149,842
1978,24500,1683,1848,23677,25927,268,14.3,291,15.6,5422,1587,3835,6.1,20.9,9921,1663,8258,6.4,38.3,-4499,-17.4,41.8,0,164,164,746
1979,24500,1810,1983,24948,24319,274,14.3,146,7.6,4885,1681,3204,6.9,20.1,3626,956,2670,3.9,14.9,1259,5.2,29.8,1,2,2,
1980,24500,1790,1954,23450,24176,232,11.8,247,12.6,3551,1414,2137,5.8,14.7,5002,1770,3232,7.3,20.7,-1451,-6,29.4,0,167,168,1158
1981,24500,1704,1864,22053,22661,214,11.2,280,14.7,3331,1191,2140,5.3,14.7,4547,2010,2537,8.9,20.1,-1216,-5.4,29.4,0,175,175,786
1982,24500,1721,1894,22156,22070,253,13.5,200,10.6,3959,1830,2129,8.3,17.9,3787,1424,2363,6.5,17.2,172,0.7,34.4,0,117,117,790
1983,24500,1765,1934,22308,22156,228,11.9,210,11,4187,1717,2470,7.7,18.9,3883,1234,2649,5.6,17.5,304,1.4,35,0,140,143,749
1984,24500,1832,2013,22741,22528,270,13.7,193,9.8,4189,1672,2517,7.4,18.6,3763,1244,2519,5.5,16.7,426,1.9,33.4,0,128,128,695
1985,24500,1844,2008,22342,22608,215,10.7,224,11.1,3194,1113,2081,4.9,14.1,3726,1303,2423,5.8,16.5,-532,-2.4,28.2,0,144,144,532
1986,24500,1841,2006,21851,22084,265,13.2,259,12.9,3643,1541,2102,7,16.5,4108,1560,2548,7.1,18.6,-465,-2.1,33,0,161,162,913
1987,24500,1840,2008,22937,22437,259,12.9,245,12.2,4705,2437,2268,10.9,21,3704,1410,2294,6.3,16.5,1001,4.5,33,0,154,154,791
1988,24500,1808,1983,21786,22267,229,11.5,243,12.2,3502,1161,2341,5.2,15.7,4463,1790,2673,8,20,-961,-4.3,31.4,0,164,164,652
1989,24500,1864,2039,22884,22310,251,12.5,187,9.3,4305,1536,2769,6.9,19.3,3157,1158,1999,5.2,14.2,1148,5.1,28.4,0,116,116,535
1990,24500,1881,2065,23637,23245,217,10.6,183,8.9,3643,1117,2526,4.8,15.7,2858,849,2009,3.7,12.3,785,3.4,24.6,0,113,113,446
1991,24500,1909,2099,23996,23771,230,11.1,185,8.9,3702,1566,2136,6.6,15.6,3252,1113,2139,4.7,13.7,450,1.9,27.4,0,128,128,763
1992,24500,1926,2128,25446,24742,223,10.5,196,9.3,4584,1681,2903,6.8,18.5,3175,1335,1840,5.4,12.8,1409,5.7,25.6,0,126,126,855
1993,24500,1900,2093,24468,24928,184,8.7,209,9.9,3356,1032,2324,4.1,13.5,4276,1207,3069,4.8,17.2,-920,-3.7,27,0,141,141,763
1994,24500,1950,2146,24436,24448,220,10.4,161,7.6,3101,979,2122,4,12.7,3124,961,2163,3.9,12.8,-23,-0.1,25.4,0,116,116,756
1995,24500,1987,2190,25311,24834,238,11,181,8.3,3944,1771,2173,7.1,15.9,2989,1028,1961,4.1,12,955,3.9,24,0,122,122,629
1996,24500,2003,2189,26096,25690,223,10.2,214,9.8,3637,1409,2228,5.5,14.2,2825,948,1877,3.7,11,812,3.2,22,0,139,139,522
1997,24500,2059,2261,25817,26000,262,11.8,199,8.9,4703,1557,3146,6,18.1,5069,1996,3073,7.7,19.5,-366,-1.4,36.2,0,129,129,676
1998,24500,2044,2239,26048,25947,261,11.6,281,12.5,4381,1584,2797,6.1,16.9,4179,2098,2081,8.1,16.1,202,0.8,32.2,0,185,185,740
1999,24500,2066,2271,26660,26353,255,11.3,218,9.7,4098,1545,2553,5.9,15.6,3484,1287,2197,4.9,13.2,614,2.4,26.4,0,145,145,562
2000,24500,2046,2263,27728,27198,209,9.2,218,9.6,4405,1530,2875,5.6,16.2,3345,1102,2243,4.1,12.3,1060,3.9,24.6,0,129,129,520
2001,24500,2028,2252,27645,27725,209,9.2,237,10.5,3894,1521,2373,5.5,14,4054,1463,2591,5.3,14.6,-160,-0.6,28,0,131,131,721
2002,24500,1996,2215,27549,27542,230,10.3,261,11.7,4187,1841,2346,6.7,15.2,4173,1311,2862,4.8,15.2,14,0,30.4,0,140,140,582
2003,24500,2015,2230,27692,27527,225,10.2,182,8.2,3670,1361,2309,4.9,13.3,3340,849,2491,3.1,12.1,330,1.2,24.2,0,119,119,491
2004,24500,2033,2239,28625,28106,201,9,168,7.5,4119,1084,3035,3.9,14.7,3081,1297,1784,4.6,11,1038,3.7,22,0,99,99,723
2005,24500,2058,2275,28150,28375,212,9.4,168,7.5,3569,1450,2119,5.1,12.6,4018,846,3172,3,14.2,-449,-1.6,25.2,0,112,112,605
2006,24500,2103,2317,29116,28544,271,11.8,199,8.7,4525,1704,2821,6,15.9,3381,1240,2141,4.3,11.8,1144,4.1,23.6,0,123,123,630
2007,24500,2117,2340,29714,29368,227,9.8,195,8.4,4527,1481,3046,5,15.4,3835,1124,2711,3.8,13.1,692,2.3,26.2,0,127,128,591
2008,24500,2088,2306,30490,30020,181,7.8,195,8.4,4419,1286,3133,4.3,14.7,3479,1254,2225,4.2,11.6,940,3.1,23.2,0,130,130,765
2009,24500,2015,2230,30026,30187,171,7.6,221,9.8,3729,1068,2661,3.5,12.4,4050,1009,3041,3.3,13.4,-321,-1,24.8,0,125,125,528
2010,24500,2003,2222,29828,29870,167,7.5,176,7.9,3953,1380,2573,4.6,13.2,4037,908,3129,3,13.5,-84,-0.3,26.4,0,112,112,663
2011,24500,1952,2169,28568,30050,155,7.1,184,8.4,3091,870,2221,2.9,10.3,6055,3159,2896,10.5,20.1,-2964,-9.8,20.6,0,107,107,2820
2012,24500,1944,2167,28778,28673,193,8.9,200,9.2,3904,1069,2835,3.7,13.6,3693,1635,2058,5.7,12.9,211,0.7,25.8,0,127,128,739
2013,24500,1964,2186,29238,28908,184,8.5,158,7.3,3933,1593,2340,5.5,13.6,3272,1078,2194,3.7,11.3,661,2.3,22.6,0,92,93,681
2014,24500,1948,2172,29015,29086,178,8.2,182,8.4,3850,1136,2714,3.9,13.2,3991,1844,2147,6.3,13.7,-141,-0.5,26.4,0,120,121,702
1977,24540,1939,2057,35785,30741,404,20.1,303,15.1,14440,2499,11941,8.1,47,4351,1936,2415,6.3,14.2,10089,32.8,28.4,0,207,210,1256
1978,24540,1845,1974,27516,31633,324,16.1,391,19.4,5693,1844,3849,5.8,18,13927,2532,11395,8,44,-8234,-26,36,0,237,237,1237
1979,24540,2092,2227,30569,29074,430,20.5,196,9.3,6598,2592,4006,8.9,22.7,3608,1151,2457,4,12.4,2990,10.3,24.8,0,3,4,25
1980,24540,2154,2293,31428,30972,382,16.9,302,13.4,5566,2597,2969,8.4,18,4654,1799,2855,5.8,15,912,3,30,0,221,221,1199
1981,24540,2083,2219,28860,29178,355,15.8,370,16.5,4969,1917,3052,6.6,17,5605,2040,3565,7,19.2,-636,-2.2,34,0,241,241,1089
1982,24540,2121,2275,29448,29072,380,16.9,301,13.4,6381,2776,3605,9.5,21.9,5629,1801,3828,6.2,19.4,752,2.5,38.8,0,162,162,958
1983,24540,2150,2302,31561,30418,299,13.1,281,12.3,6982,2747,4235,9,23,4697,1619,3078,5.3,15.4,2285,7.6,30.8,0,194,195,985
1984,24540,2264,2421,32297,31928,381,16.1,267,11.3,6094,2168,3926,6.8,19.1,5355,2137,3218,6.7,16.8,739,2.3,33.6,0,193,193,1283
1985,24540,2303,2454,32454,32368,368,15.1,340,13.9,5943,2371,3572,7.3,18.4,5770,3176,2594,9.8,17.8,173,0.6,35.6,0,232,232,1046
1986,24540,2345,2499,33431,32927,381,15.4,321,13,6342,3850,2492,11.7,19.3,5333,1891,3442,5.7,16.2,1009,3.1,32.4,0,233,233,1358
1987,24540,2315,2496,33814,33574,384,15.4,357,14.3,7465,2640,4825,7.9,22.2,6985,3700,3285,11,20.8,480,1.4,41.6,0,234,236,1242
1988,24540,2297,2491,35581,34703,335,13.5,330,13.3,6621,2418,4203,7,19.1,4865,2228,2637,6.4,14,1756,5.1,28,0,230,230,1415
1989,24540,2305,2504,36488,36030,288,11.5,280,11.2,5400,1838,3562,5.1,15,4484,2206,2278,6.1,12.4,916,2.6,24.8,0,201,201,1418
1990,24540,2318,2519,37559,36988,281,11.2,256,10.2,5465,2120,3345,5.7,14.8,4323,1866,2457,5,11.7,1142,3.1,23.4,0,176,176,754
1991,24540,2366,2569,39396,38449,301,11.8,255,10,6350,2770,3580,7.2,16.5,4456,1331,3125,3.5,11.6,1894,4.9,23.2,0,169,169,769
1992,24540,2418,2627,39258,38426,326,12.5,253,9.7,5977,2512,3465,6.5,15.6,4312,1492,2820,3.9,11.2,1665,4.4,22.4,0,165,166,810
1993,24540,2538,2739,42032,40689,335,12.5,225,8.4,6672,2598,4074,6.4,16.4,3985,1489,2496,3.7,9.8,2687,6.6,19.6,0,140,140,573
1994,24540,2665,2872,43437,42717,391,13.9,250,8.9,6576,2464,4112,5.8,15.4,5136,1727,3409,4,12,1440,3.4,24,0,175,175,797
1995,24540,2796,3007,46853,45133,412,14,274,9.3,8938,3583,5355,7.9,19.8,5497,1987,3510,4.4,12.2,3441,7.6,24.4,0,189,189,1245
1996,24540,2836,3058,49112,48638,391,12.9,327,10.8,7735,2919,4816,6,15.9,6787,2459,4328,5.1,14,948,1.9,28,0,231,231,1131
1997,24540,2916,3149,49422,49250,476,15.3,372,12,7890,2774,5116,5.6,16,7546,2931,4615,6,15.3,344,0.7,30.6,0,253,253,1582
1998,24540,2996,3230,51191,50292,439,13.8,356,11.2,8084,2779,5305,5.5,16.1,6285,2946,3339,5.9,12.5,1799,3.6,25,0,257,257,1626
1999,24540,3129,3364,53443,52300,489,14.8,350,10.6,9141,4339,4802,8.3,17.5,6855,2453,4402,4.7,13.1,2286,4.4,26.2,0,237,237,1145
2000,24540,3220,3484,55593,54484,494,14.4,361,10.5,9018,3832,5186,7,16.6,6799,2348,4451,4.3,12.5,2219,4.1,25,0,234,234,973
2001,24540,3409,3705,56653,56238,563,15.6,385,10.7,8552,3069,5483,5.5,15.2,7721,2586,5135,4.6,13.7,831,1.5,27.4,0,246,246,1144
2002,24540,3547,3865,58829,57635,615,16.3,438,11.6,10678,5041,5637,8.7,18.5,8289,3020,5269,5.2,14.4,2389,4.1,28.8,0,274,274,1623
2003,24540,3631,3945,59746,58980,577,14.8,430,11.1,9457,3788,5669,6.4,16,7924,3002,4922,5.1,13.4,1533,2.6,26.8,0,291,291,1570
2004,24540,3754,4081,60411,59498,609,15.2,426,10.6,9660,3684,5976,6.2,16.2,7834,2674,5160,4.5,13.2,1826,3,26.4,0,291,291,1706
2005,24540,3939,4294,61937,61071,656,15.7,420,10,9959,4500,5459,7.4,16.3,8227,2912,5315,4.8,13.5,1732,2.8,27,0,294,294,1652
2006,24540,4015,4403,63610,62379,634,14.6,487,11.2,10496,4315,6181,6.9,16.8,8034,2812,5222,4.5,12.9,2462,3.9,25.8,0,351,351,1912
2007,24540,4134,4549,65949,64725,674,15.1,505,11.3,11148,4178,6970,6.5,17.2,8699,2855,5844,4.4,13.4,2449,3.8,26.8,0,333,333,1630
2008,24540,4171,4597,67189,66247,583,12.8,494,10.8,11886,4972,6914,7.5,17.9,10001,3020,6981,4.6,15.1,1885,2.8,30.2,0,348,348,1688
2009,24540,4087,4513,65062,65831,514,11.3,576,12.7,8491,3477,5014,5.3,12.9,10028,3168,6860,4.8,15.2,-1537,-2.3,25.8,0,409,409,2157
2010,24540,4049,4468,62436,63627,476,10.6,501,11.2,7530,3114,4416,4.9,11.8,9912,2941,6971,4.6,15.6,-2382,-3.8,23.6,0,332,332,1954
2011,24540,4009,4449,64252,63200,486,10.9,476,10.7,10208,4321,5887,6.8,16.2,8103,2888,5215,4.6,12.8,2105,3.4,25.6,0,338,338,1977
2012,24540,4085,4532,66988,65523,509,11.3,436,9.7,10356,3069,7287,4.7,15.8,7426,2019,5407,3.1,11.3,2930,4.5,22.6,0,274,274,1247
2013,24540,4189,4634,71023,68576,533,11.7,432,9.5,12153,3453,8700,5,17.7,7259,2665,4594,3.9,10.6,4894,7.1,21.2,0,277,277,1559
2014,24540,4372,4842,75508,73154,652,13.8,417,8.8,13231,5247,7984,7.2,18.1,8523,2846,5677,3.9,11.7,4708,6.4,23.4,0,285,285,1715
1977,24580,3822,4138,68061,66225,632,15.7,418,10.4,11843,4899,6944,7.4,17.9,8170,4068,4102,6.1,12.3,3673,5.6,24.6,0,277,278,2582
1978,24580,3998,4331,75969,72010,604,14.3,408,9.6,14534,5162,9372,7.2,20.2,6616,3065,3551,4.3,9.2,7918,11,18.4,0,284,285,1410
1979,24580,4069,4402,78798,77321,528,12.1,437,10,11917,3975,7942,5.1,15.4,8962,3765,5197,4.9,11.6,2955,3.8,23.2,0,283,283,1575
1980,24580,4114,4455,78168,78422,499,11.3,425,9.6,9191,3129,6062,4,11.7,9698,2940,6758,3.7,12.4,-507,-0.7,23.4,0,303,303,1550
1981,24580,4061,4402,77006,76861,490,11.1,493,11.2,9350,4337,5013,5.6,12.2,9060,2923,6137,3.8,11.8,290,0.4,23.6,0,266,267,1164
1982,24580,4084,4505,77586,77235,584,13.1,434,9.7,10418,4628,5790,6,13.5,9715,2907,6808,3.8,12.6,703,0.9,25.2,0,263,263,1401
1983,24580,4180,4626,76201,76985,480,10.5,400,8.8,10740,4539,6201,5.9,14,12307,3973,8334,5.2,16,-1567,-2,28,0,257,257,1978
1984,24580,4300,4760,82256,79253,600,12.8,458,9.8,14253,5144,9109,6.5,18,8247,3602,4645,4.5,10.4,6006,7.6,20.8,0,280,280,1295
1985,24580,4419,4877,86504,84287,592,12.3,456,9.5,13431,5188,8243,6.2,15.9,8997,3809,5188,4.5,10.7,4434,5.2,21.4,0,306,307,2507
1986,24580,4270,4724,91836,88937,538,11.2,633,13.2,17014,4831,12183,5.4,19.1,11215,5811,5404,6.5,12.6,5799,6.5,25.2,0,329,338,2175
1987,24580,4674,5197,97644,95230,775,15.6,354,7.1,16558,7997,8561,8.4,17.4,11729,3339,8390,3.5,12.3,4829,5.1,24.6,0,91,92,1019
1988,24580,4699,5242,96376,96852,610,11.7,556,10.7,15417,6341,9076,6.5,15.9,16369,5600,10769,5.8,16.9,-952,-1,31.8,0,400,400,2515
1989,24580,4721,5298,99823,98445,576,10.9,510,9.7,14036,4984,9052,5.1,14.3,11279,5929,5350,6,11.5,2757,2.8,23,0,331,335,2317
1990,24580,4821,5432,103930,101819,574,10.7,409,7.6,14093,4185,9908,4.1,13.8,9870,3120,6750,3.1,9.7,4223,4.1,19.4,0,283,283,1524
1991,24580,4980,5643,106379,105514,637,11.5,429,7.8,14110,4876,9234,4.6,13.4,12379,3407,8972,3.2,11.7,1731,1.7,23.4,0,296,296,1688
1992,24580,5045,5714,108637,107449,600,10.6,516,9.1,14323,3716,10607,3.5,13.3,11946,4171,7775,3.9,11.1,2377,2.2,22.2,0,334,335,2075
1993,24580,5201,5861,112255,110425,614,10.6,463,8,15056,3701,11355,3.4,13.6,11398,3771,7627,3.4,10.3,3658,3.3,20.6,0,323,327,2545
1994,24580,5274,5955,115848,114011,632,10.7,512,8.7,14367,4206,10161,3.7,12.6,10693,3158,7535,2.8,9.4,3674,3.2,18.8,0,352,352,1847
1995,24580,5454,6142,118474,117107,676,11.2,466,7.7,15516,5082,10434,4.3,13.2,12781,3099,9682,2.6,10.9,2735,2.3,21.8,0,310,310,1723
1996,24580,5547,6214,122016,120330,605,9.8,537,8.7,16005,5294,10711,4.4,13.3,12633,4965,7668,4.1,10.5,3372,2.8,21,0,318,318,1801
1997,24580,5728,6475,130052,126014,843,13.3,600,9.4,24017,12365,11652,9.8,19.1,15940,4939,11001,3.9,12.6,8077,6.5,25.2,0,354,354,1847
1998,24580,5797,6526,132832,131461,648,10,573,8.8,18347,6234,12113,4.7,14,15604,5241,10363,4,11.9,2743,2.1,23.8,0,364,364,2345
1999,24580,5898,6631,137981,135357,676,10.3,569,8.6,22445,8045,14400,5.9,16.6,17196,8198,8998,6.1,12.7,5249,3.9,25.4,0,383,383,3287
2000,24580,5933,6732,142486,140263,715,10.7,608,9.1,20786,7094,13692,5.1,14.8,16340,5086,11254,3.6,11.6,4446,3.2,23.2,0,400,400,2318
2001,24580,6058,6902,143946,143458,735,10.8,617,9,20739,7852,12887,5.5,14.5,19762,6640,13122,4.6,13.8,977,0.7,27.6,0,352,352,2707
2002,24580,6069,6945,139653,141592,832,12,781,11.3,21578,10429,11149,7.4,15.2,25455,7885,17570,5.6,18,-3877,-2.8,30.4,0,419,419,3424
2003,24580,6073,6986,143928,141324,734,10.6,582,8.4,21893,8683,13210,6.1,15.5,16685,5052,11633,3.6,11.8,5208,3.7,23.6,0,393,393,2475
2004,24580,6190,7112,147074,145069,736,10.5,560,8,22356,6471,15885,4.5,15.4,18346,8892,9454,6.1,12.6,4010,2.8,25.2,0,364,372,3134
2005,24580,6317,7225,150627,148284,739,10.3,566,7.9,20922,8111,12811,5.5,14.1,16235,4750,11485,3.2,10.9,4687,3.2,21.8,0,388,391,2484
2006,24580,6315,7259,150418,150012,739,10.2,644,8.9,19424,6452,12972,4.3,12.9,18612,7346,11266,4.9,12.4,812,0.5,24.8,0,433,433,4387
2007,24580,6294,7264,152108,151296,686,9.5,677,9.3,19358,6019,13339,4,12.8,17733,5557,12176,3.7,11.7,1625,1.1,23.4,0,419,422,2145
2008,24580,6188,7179,151327,151410,577,8,613,8.5,16497,6772,9725,4.5,10.9,16662,4806,11856,3.2,11,-165,-0.1,21.8,0,406,413,2620
2009,24580,6041,7046,143970,147396,533,7.5,612,8.6,13376,4401,8975,3,9.1,20227,4063,16164,2.8,13.7,-6851,-4.6,18.2,0,398,398,2633
2010,24580,5930,6974,142266,142785,510,7.3,545,7.8,15447,6391,9056,4.5,10.8,16484,5820,10664,4.1,11.5,-1037,-0.7,21.6,0,365,365,3082
2011,24580,5818,6868,143645,142870,483,7,549,8,15352,3990,11362,2.8,10.7,13802,3841,9961,2.7,9.7,1550,1,19.4,0,335,337,2666
2012,24580,5798,6855,145835,144665,535,7.8,545,8,15795,3638,12157,2.5,10.9,13454,3557,9897,2.5,9.3,2341,1.6,18.6,0,340,344,1914
2013,24580,5818,6883,146657,145963,500,7.3,467,6.8,13630,4073,9557,2.8,9.3,12242,3257,8985,2.2,8.4,1388,0.9,16.8,0,289,289,1964
2014,24580,5803,6898,151200,148621,501,7.3,443,6.4,15480,4235,11245,2.8,10.4,10322,2722,7600,1.8,6.9,5158,3.5,13.8,0,315,315,1915
1977,24660,8593,9980,195215,195438,1499,15.3,1164,11.9,33155,13492,19663,6.9,17,33600,8965,24635,4.6,17.2,-445,-0.2,34,0,725,728,4520
1978,24660,8962,10371,205515,200358,1446,14.2,1049,10.3,33793,10518,23275,5.2,16.9,23478,9190,14288,4.6,11.7,10315,5.2,23.4,0,742,747,3467
1979,24660,9211,10671,228948,217152,1387,13.2,1030,9.8,47163,10389,36774,4.8,21.7,23570,8999,14571,4.1,10.9,23593,10.8,21.8,0,729,730,4616
1980,24660,9261,10696,221071,227062,1236,11.6,1167,10.9,29715,9198,20517,4.1,13.1,41696,8444,33252,3.7,18.4,-11981,-5.3,26.2,0,806,810,4812
1981,24660,9032,10469,216727,218465,1236,11.7,1396,13.2,30164,11842,18322,5.4,13.8,33639,14426,19213,6.6,15.4,-3475,-1.6,27.6,0,848,849,4778
1982,24660,9238,10844,217878,216944,1535,14.4,1051,9.9,30889,14394,16495,6.6,14.2,29021,9612,19409,4.4,13.4,1868,0.8,26.8,0,618,618,3883
1983,24660,8893,10481,213979,215108,1126,10.6,1380,12.9,28733,9563,19170,4.4,13.4,30991,11498,19493,5.3,14.4,-2258,-1,26.8,0,730,746,4615
1984,24660,9926,11577,231244,220681,1510,13.7,607,5.5,40277,12782,27495,5.8,18.3,19150,5362,13788,2.4,8.7,21127,9.6,17.4,0,24,24,164
1985,24660,10289,11968,251338,243769,1556,13.2,1171,9.9,45614,13760,31854,5.6,18.7,30475,12328,18147,5.1,12.5,15139,6.2,25,0,715,716,4597
1986,24660,10728,12445,254805,252700,1689,13.8,1164,9.5,43493,18795,24698,7.4,17.2,39283,10130,29153,4,15.5,4210,1.7,31,0,726,727,3877
1987,24660,11052,12911,257322,256358,1845,14.5,1343,10.6,44291,17825,26466,7,17.3,42363,15423,26940,6,16.5,1928,0.8,33,0,808,812,4820
1988,24660,11314,13306,264103,258809,1849,14.1,1411,10.8,46901,17893,29008,6.9,18.1,36313,14962,21351,5.8,14,10588,4.1,28,0,899,899,5986
1989,24660,11572,13655,270733,267530,1659,12.3,1324,9.8,47355,17127,30228,6.4,17.7,40948,12735,28213,4.8,15.3,6407,2.4,30.6,0,843,847,5740
1990,24660,11763,13878,281431,275847,1594,11.6,1287,9.4,48259,16838,31421,6.1,17.5,37090,14069,23021,5.1,13.4,11169,4.1,26.8,0,837,840,6882
1991,24660,11989,14193,271368,276203,1683,12,1353,9.6,41586,15852,25734,5.7,15.1,51256,19250,32006,7,18.6,-9670,-3.5,30.2,0,849,851,10649
1992,24660,12043,14307,272991,271995,1656,11.6,1473,10.3,43290,15356,27934,5.6,15.9,41298,12481,28817,4.6,15.2,1992,0.7,30.4,0,914,927,5487
1993,24660,12219,14464,283479,278347,1461,10.2,1273,8.9,44343,12307,32036,4.4,15.9,34079,10383,23696,3.7,12.2,10264,3.7,24.4,0,834,842,5126
1994,24660,12485,14757,289497,286447,1590,10.9,1246,8.5,42841,14494,28347,5.1,15,36740,13282,23458,4.6,12.8,6101,2.2,25.6,0,834,839,8237
1995,24660,12851,15172,306472,297881,1740,11.6,1296,8.7,48732,17435,31297,5.9,16.4,31550,10433,21117,3.5,10.6,17182,5.8,21.2,0,858,860,4402
1996,24660,13123,15460,311545,309058,1791,11.7,1462,9.6,47890,18401,29489,6,15.5,42916,15742,27174,5.1,13.9,4974,1.6,27.8,0,921,921,6329
1997,24660,13444,15920,321406,316557,2010,12.8,1548,9.9,51623,19328,32295,6.1,16.3,41925,15278,26647,4.8,13.2,9698,3.1,26.4,0,903,903,6322
1998,24660,13567,16083,327582,324401,1830,11.4,1618,10.1,51201,17624,33577,5.4,15.8,44839,18427,26412,5.7,13.8,6362,2,27.6,0,1003,1003,6877
1999,24660,13682,16308,338407,332940,1828,11.3,1586,9.8,56807,21414,35393,6.4,17.1,45873,16119,29754,4.8,13.8,10934,3.3,27.6,0,1002,1002,6821
2000,24660,13655,16382,339235,338831,1736,10.6,1659,10.2,49453,17029,32424,5,14.6,48644,16563,32081,4.9,14.4,809,0.2,28.8,0,1000,1000,6402
2001,24660,13774,16533,331369,335758,1693,10.3,1663,10.1,42450,14775,27675,4.4,12.6,51230,18143,33087,5.4,15.3,-8780,-2.7,25.2,0,958,958,6557
2002,24660,13731,16449,319500,324817,1889,11.5,1942,11.8,47266,20782,26484,6.4,14.6,57900,20042,37858,6.2,17.8,-10634,-3.2,29.2,0,1003,1009,6428
2003,24660,13777,16507,319423,317616,1747,10.7,1373,8.4,51793,21640,30153,6.8,16.3,48179,14409,33770,4.5,15.2,3614,1.1,30.4,0,940,941,6598
2004,24660,13922,16642,322820,320163,1654,10,1352,8.2,44376,12635,31741,3.9,13.9,39062,13407,25655,4.2,12.2,5314,1.7,24.4,0,935,938,7183
2005,24660,14010,16789,325783,323174,1717,10.3,1432,8.6,47680,17055,30625,5.3,14.8,42462,10521,31941,3.3,13.1,5218,1.7,26.2,0,1007,1007,7039
2006,24660,13958,16830,333981,330613,1760,10.5,1560,9.3,50182,17489,32693,5.3,15.2,43446,16335,27111,4.9,13.1,6736,2.1,26.2,0,1051,1053,7438
2007,24660,14026,16970,332720,332600,1837,10.9,1630,9.7,47337,16131,31206,4.8,14.2,47097,15445,31652,4.6,14.2,240,0,28.4,0,964,976,7300
2008,24660,13889,16884,328351,328877,1621,9.6,1471,8.7,41991,15184,26807,4.6,12.8,43043,14936,28107,4.5,13.1,-1052,-0.3,25.6,0,1046,1046,8262
2009,24660,13354,16344,302638,314115,1297,7.8,1659,10,29547,11003,18544,3.5,9.4,52500,12834,39666,4.1,16.7,-22953,-7.3,18.8,0,1109,1114,6996
2010,24660,13112,16010,296689,299139,1290,8,1515,9.4,34389,12211,22178,4.1,11.5,39288,8902,30386,3,13.1,-4899,-1.6,23,0,983,990,5563
2011,24660,12974,15882,304086,299434,1327,8.3,1339,8.4,38928,10009,28919,3.3,13,29623,7938,21685,2.7,9.9,9305,3.1,19.8,0,913,922,4965
2012,24660,13007,15967,307866,305608,1433,9,1363,8.6,40003,11361,28642,3.7,13.1,35486,12114,23372,4,11.6,4517,1.5,23.2,0,841,845,5935
2013,24660,12962,15964,311550,308276,1359,8.5,1338,8.4,41748,9842,31906,3.2,13.5,35199,10903,24296,3.5,11.4,6549,2.1,22.8,0,844,844,5547
2014,24660,12875,15924,313671,312049,1342,8.4,1265,8,37621,10375,27246,3.3,12.1,34376,10878,23498,3.5,11,3245,1.1,22,0,870,873,6504
1977,24780,1566,1722,20592,20320,336,20.5,178,10.8,3928,1487,2441,7.3,19.3,3383,1184,2199,5.8,16.6,545,2.7,33.2,0,120,120,639
1978,24780,1634,1796,22149,21363,281,16,200,11.4,4339,1661,2678,7.8,20.3,2766,1215,1551,5.7,12.9,1573,7.4,25.8,0,129,129,523
1979,24780,1679,1845,23787,22957,262,14.4,203,11.2,5202,1972,3230,8.6,22.7,3541,1905,1636,8.3,15.4,1661,7.3,30.8,0,140,140,614
1980,24780,1695,1882,24410,24100,266,14.3,229,12.3,4352,1801,2551,7.5,18.1,3732,1531,2201,6.4,15.5,620,2.6,31,0,163,163,1010
1981,24780,1652,1823,24320,24180,262,14.2,295,16,3743,1581,2162,6.5,15.5,3462,1532,1930,6.3,14.3,281,1.2,28.6,0,191,191,826
1982,24780,1622,1813,24853,24590,248,13.6,240,13.2,4294,1979,2315,8,17.5,3768,1438,2330,5.8,15.3,526,2.2,30.6,0,146,146,633
1983,24780,1578,1772,25246,25015,218,12.2,235,13.1,3797,1537,2260,6.1,15.2,3334,1275,2059,5.1,13.3,463,1.9,26.6,0,127,127,462
1984,24780,1797,1998,26701,24839,281,14.9,99,5.3,5818,2310,3508,9.3,23.4,2094,692,1402,2.8,8.4,3724,15,16.8,1,2,2,
1985,24780,1852,2047,29972,29585,264,13,228,11.3,4314,1564,2750,5.3,14.6,3540,1234,2306,4.2,12,774,2.6,24,0,147,147,660
1986,24780,1918,2116,31909,30924,301,14.5,222,10.7,5431,2579,2852,8.3,17.6,3461,1343,2118,4.3,11.2,1970,6.4,22.4,0,155,155,928
1987,24780,1995,2212,34447,33169,331,15.3,228,10.5,6540,2789,3751,8.4,19.7,3984,1677,2307,5.1,12,2556,7.7,24,0,146,147,842
1988,24780,1998,2236,35789,34963,277,12.5,235,10.6,6181,1802,4379,5.2,17.7,4528,1697,2831,4.9,13,1653,4.7,26,0,150,150,972
1989,24780,2070,2322,37908,36736,310,13.6,221,9.7,7006,3263,3743,8.9,19.1,4661,2185,2476,5.9,12.7,2345,6.4,25.4,0,149,149,1206
1990,24780,2108,2372,40151,39064,281,12,213,9.1,6872,2560,4312,6.6,17.6,4697,1460,3237,3.7,12,2175,5.6,24,0,150,150,805
1991,24780,2116,2395,38051,38885,290,12.2,268,11.3,6203,2879,3324,7.4,16,7870,3431,4439,8.8,20.2,-1667,-4.2,32,0,173,173,1297
1992,24780,2178,2468,40114,39079,320,13.1,239,9.8,7089,3070,4019,7.9,18.1,5019,1642,3377,4.2,12.8,2070,5.3,25.6,0,161,161,1021
1993,24780,2203,2484,41421,40759,297,12,273,11,7369,2064,5305,5.1,18.1,6044,2222,3822,5.5,14.8,1325,3.3,29.6,0,175,175,878
1994,24780,2310,2610,44209,42804,345,13.6,213,8.4,7892,2472,5420,5.8,18.4,5081,1752,3329,4.1,11.9,2811,6.5,23.8,0,150,151,710
1995,24780,2392,2690,46638,45354,343,13,256,9.7,8194,2624,5570,5.8,18.1,5625,2260,3365,5,12.4,2569,5.7,24.8,0,169,169,1246
1996,24780,2447,2760,47235,47111,364,13.4,279,10.2,6404,2490,3914,5.3,13.6,6156,2108,4048,4.5,13.1,248,0.5,26.2,0,174,174,1174
1997,24780,2517,2837,49382,48338,383,13.7,302,10.8,8443,3524,4919,7.3,17.5,6354,2435,3919,5,13.1,2089,4.4,26.2,0,173,173,1286
1998,24780,2577,2915,51393,50385,369,12.8,292,10.2,8098,3253,4845,6.5,16.1,6081,2660,3421,5.3,12.1,2017,4,24.2,0,182,182,1658
1999,24780,2625,2974,52569,51949,370,12.6,305,10.4,8573,3505,5068,6.7,16.5,7333,2751,4582,5.3,14.1,1240,2.4,28.2,0,201,201,828
2000,24780,2663,3026,55870,54205,346,11.5,296,9.9,10265,4166,6099,7.7,18.9,6935,2899,4036,5.3,12.8,3330,6.1,25.6,0,186,186,1430
2001,24780,2724,3099,57151,56623,380,12.4,336,10.9,8314,3045,5269,5.4,14.7,7258,2423,4835,4.3,12.8,1056,1.9,25.6,0,182,184,1090
2002,24780,2757,3135,53601,55370,388,12.5,348,11.2,7141,3115,4026,5.6,12.9,10679,3520,7159,6.4,19.3,-3538,-6.4,25.8,0,202,202,1065
2003,24780,2789,3178,56588,54869,380,12.1,273,8.7,10349,2836,7513,5.2,18.9,6911,1931,4980,3.5,12.6,3438,6.3,25.2,0,191,191,915
2004,24780,2832,3223,57536,57077,346,10.8,273,8.6,8120,2838,5282,5,14.2,7201,2723,4478,4.8,12.6,919,1.6,25.2,0,187,187,2115
2005,24780,2934,3344,57101,56957,394,12,249,7.6,9435,3826,5609,6.7,16.6,9147,3474,5673,6.1,16.1,288,0.5,32.2,0,180,180,2977
2006,24780,2963,3409,58534,57720,403,12,304,9,9140,3205,5935,5.6,15.8,7512,2744,4768,4.8,13,1628,2.8,26,0,217,217,1788
2007,24780,3038,3474,59699,58715,396,11.5,326,9.5,9976,3623,6353,6.2,17,8008,2882,5126,4.9,13.6,1968,3.4,27.2,0,196,196,1248
2008,24780,3049,3502,62040,60667,345,9.9,281,8.1,9019,2987,6032,4.9,14.9,6273,1499,4774,2.5,10.3,2746,4.6,20.6,0,212,212,974
2009,24780,2975,3437,58587,60053,302,8.7,322,9.3,7521,3635,3886,6.1,12.5,10453,2449,8004,4.1,17.4,-2932,-4.9,25,0,219,219,1352
2010,24780,2988,3467,57237,57773,334,9.7,287,8.3,6825,2549,4276,4.4,11.8,7896,2178,5718,3.8,13.7,-1071,-1.9,23.6,0,190,190,1252
2011,24780,2960,3435,56947,57089,310,9,315,9.2,6647,1989,4658,3.5,11.6,6930,1842,5088,3.2,12.1,-283,-0.5,23.2,0,225,225,1183
2012,24780,2986,3471,59107,57993,319,9.3,286,8.3,8400,1844,6556,3.2,14.5,6171,1689,4482,2.9,10.6,2229,3.9,21.2,0,175,175,826
2013,24780,2963,3461,58935,58939,302,8.7,308,8.9,6575,2349,4226,4,11.2,6583,2064,4519,3.5,11.2,-8,0,22.4,0,211,211,1417
2014,24780,2934,3420,59658,59190,262,7.6,277,8.1,7695,3503,4192,5.9,13,6758,2823,3935,4.8,11.4,937,1.6,22.8,0,201,201,1044
1977,24860,6550,7508,175821,174062,1211,16.4,927,12.6,27424,12589,14835,7.2,15.8,23905,8918,14987,5.1,13.7,3519,2.1,27.4,0,634,637,3835
1978,24860,6782,7797,190457,183130,1135,14.8,843,11,35822,14821,21001,8.1,19.6,21168,7030,14138,3.8,11.6,14654,8,23.2,0,587,587,2509
1979,24860,6882,7935,209255,199783,1092,13.9,910,11.6,36258,8968,27290,4.5,18.1,17314,5094,12220,2.5,8.7,18944,9.4,17.4,0,654,656,2461
1980,24860,7030,8080,211613,210352,1048,13.1,872,10.9,28186,9917,18269,4.7,13.4,25664,7830,17834,3.7,12.2,2522,1.2,24.4,0,615,619,3534
1981,24860,6878,7949,205078,207545,1073,13.4,1133,14.2,25551,9233,16318,4.4,12.3,30485,11538,18947,5.6,14.7,-4934,-2.4,24.6,0,659,662,4252
1982,24860,6999,8199,180574,177709,1277,15.8,953,11.8,33686,15726,17960,8.8,19,27956,9591,18365,5.4,15.7,5730,3.3,31.4,0,560,560,4772
1983,24860,6794,7982,171856,175506,901,11.1,1037,12.8,22654,8033,14621,4.6,12.9,29954,7172,22782,4.1,17.1,-7300,-4.2,25.8,0,588,588,2999
1984,24860,7547,8771,183386,177854,1185,14.1,550,6.6,29394,9631,19763,5.4,16.5,18329,4971,13358,2.8,10.3,11065,6.2,20.6,0,14,14,68
1985,24860,7892,9137,193752,189330,1276,14.2,943,10.5,34629,9796,24833,5.2,18.3,25785,8856,16929,4.7,13.6,8844,4.7,27.2,0,606,607,3678
1986,24860,8162,9433,194074,193789,1231,13.3,892,9.6,32518,13421,19097,6.9,16.8,31947,6848,25099,3.5,16.5,571,0.3,33,0,574,575,3136
1987,24860,8396,9802,206383,200616,1445,15,1043,10.8,45867,12499,33368,6.2,22.9,34334,14784,19550,7.4,17.1,11533,5.8,34.2,0,629,632,3791
1988,24860,8570,10009,228021,211924,1313,13.3,1040,10.5,59492,28246,31246,13.3,28.1,27299,10237,17062,4.8,12.9,32193,15.2,25.8,0,680,680,4387
1989,24860,8721,10211,235938,232236,1254,12.4,1047,10.4,44003,15097,28906,6.5,18.9,36599,15468,21131,6.7,15.8,7404,3.1,31.6,0,680,680,4527
1990,24860,8862,10377,243336,240378,1187,11.5,952,9.2,38683,13009,25674,5.4,16.1,32768,11390,21378,4.7,13.6,5915,2.5,27.2,0,649,651,5152
1991,24860,9116,10689,239182,241579,1309,12.4,1013,9.6,31713,13743,17970,5.7,13.1,36508,11938,24570,4.9,15.1,-4795,-2,26.2,0,597,599,5900
1992,24860,9293,10897,237993,238655,1301,12,1037,9.6,30792,9899,20893,4.1,12.9,32116,9394,22722,3.9,13.5,-1324,-0.6,25.8,0,663,673,4757
1993,24860,9541,11191,240696,239134,1336,12.1,1015,9.2,34322,11809,22513,4.9,14.4,31198,9122,22076,3.8,13,3124,1.4,26,0,669,671,3507
1994,24860,9850,11525,250947,245448,1448,12.7,1075,9.5,40492,13943,26549,5.7,16.5,29494,8596,20898,3.5,12,10998,4.5,24,0,699,699,3806
1995,24860,10205,11966,261430,255949,1557,13.3,1073,9.1,41202,14967,26235,5.8,16.1,30239,10326,19913,4,11.8,10963,4.3,23.6,0,716,720,5108
1996,24860,10462,12336,266158,264186,1580,13,1195,9.8,40429,14906,25523,5.6,15.3,36485,12604,23881,4.8,13.8,3944,1.5,27.6,0,795,795,6151
1997,24860,10751,12721,272272,269284,1723,13.7,1316,10.5,46024,20486,25538,7.6,17.1,40047,11717,28330,4.4,14.9,5977,2.2,29.8,0,800,800,5032
1998,24860,10882,12895,286450,279357,1573,12.3,1395,10.9,50100,16086,34014,5.8,17.9,35914,15378,20536,5.5,12.9,14186,5,25.8,0,887,887,6940
1999,24860,11165,13204,284313,285241,1675,12.8,1350,10.3,42333,15281,27052,5.4,14.8,44189,13484,30705,4.7,15.5,-1856,-0.7,29.6,0,830,830,5687
2000,24860,11166,13252,283659,284227,1437,10.9,1396,10.6,41202,14557,26645,5.1,14.5,42338,14792,27546,5.2,14.9,-1136,-0.4,29,0,835,835,5843
2001,24860,11110,13200,283577,284026,1414,10.7,1551,11.7,38846,14058,24788,4.9,13.7,39744,12946,26798,4.6,14,-898,-0.3,27.4,0,918,919,5258
2002,24860,11083,13206,272847,278033,1562,11.8,1538,11.7,42690,16998,25692,6.1,15.4,53064,18407,34657,6.6,19.1,-10374,-3.7,30.8,0,811,813,6323
2003,24860,11174,13289,272557,270436,1565,11.9,1201,9.1,42622,17517,25105,6.5,15.8,38380,8591,29789,3.2,14.2,4242,1.6,28.4,0,854,855,5259
2004,24860,11312,13447,262977,266462,1458,10.9,1147,8.6,35833,10781,25052,4,13.4,42803,11606,31197,4.4,16.1,-6970,-2.7,26.8,0,760,760,5405
2005,24860,11575,13790,271874,266485,1690,12.5,1209,8.9,43637,16826,26811,6.3,16.4,32859,10593,22266,4,12.3,10778,4.1,24.6,0,851,852,5476
2006,24860,11689,13976,279415,274702,1621,11.7,1300,9.4,43994,13782,30212,5,16,34570,12749,21821,4.6,12.6,9424,3.4,25.2,0,864,864,7733
2007,24860,11901,14307,280275,279274,1651,11.7,1314,9.3,47308,16547,30761,5.9,16.9,45307,13523,31784,4.8,16.2,2001,0.7,32.4,0,862,863,6349
2008,24860,11975,14392,283645,280933,1434,10,1223,8.6,42918,11575,31343,4.1,15.3,37493,10853,26640,3.9,13.3,5425,2,26.6,0,852,852,6695
2009,24860,11529,13896,268428,274871,1191,8.4,1535,10.9,27586,9516,18070,3.5,10,40472,10362,30110,3.8,14.7,-12886,-4.7,20,0,1047,1056,6032
2010,24860,11329,13685,252850,256238,1191,8.7,1316,9.6,30140,11850,18290,4.6,11.8,36917,10924,25993,4.3,14.4,-6777,-2.6,23.6,0,899,907,7861
2011,24860,11144,13541,253033,252513,1180,8.7,1229,9.1,32852,9017,23835,3.6,13,31812,9120,22692,3.6,12.6,1040,0.4,25.2,0,823,823,6881
2012,24860,11270,13702,260910,256762,1270,9.3,1104,8.1,37042,11649,25393,4.5,14.4,28745,8514,20231,3.3,11.2,8297,3.2,22.4,0,667,669,3609
2013,24860,11445,13868,263765,261730,1236,9,1047,7.6,36405,10968,25437,4.2,13.9,32334,6193,26141,2.4,12.4,4071,1.5,24.8,0,692,695,4436
2014,24860,11408,13826,269377,265842,1210,8.8,1146,8.3,32387,8542,23845,3.2,12.2,25316,8337,16979,3.1,9.5,7071,2.7,19,0,795,802,4936
1977,25060,2814,3154,36759,35057,565,18.1,470,15.1,10395,5419,4976,15.5,29.7,6990,3895,3095,11.1,19.9,3405,9.8,39.8,0,329,333,2142
1978,25060,2861,3195,39344,38040,494,15.6,450,14.2,9588,3733,5855,9.8,25.2,6980,3353,3627,8.8,18.3,2608,6.9,36.6,0,306,306,2092
1979,25060,3009,3352,44093,41668,569,17.4,390,11.9,12503,4184,8319,10,30,7652,2786,4866,6.7,18.4,4851,11.6,36.8,0,293,293,1687
1980,25060,3065,3420,48276,46166,534,15.8,449,13.3,13356,3741,9615,8.1,28.9,9135,3011,6124,6.5,19.8,4221,9.1,39.6,0,330,332,1809
1981,25060,2958,3334,42817,44059,451,13.4,488,14.5,9158,4241,4917,9.6,20.8,11642,2529,9113,5.7,26.4,-2484,-5.6,41.6,0,323,323,1377
1982,25060,3039,3458,43014,42805,559,16.5,393,11.6,8360,4455,3905,10.4,19.5,7942,2868,5074,6.7,18.6,418,0.9,37.2,0,235,235,1255
1983,25060,3137,3549,43140,42340,472,13.5,401,11.4,9381,4079,5302,9.6,22.2,7781,2404,5377,5.7,18.4,1600,3.8,36.8,0,280,280,1355
1984,25060,3242,3665,45386,44353,522,14.5,416,11.5,9275,3418,5857,7.7,20.9,7209,2338,4871,5.3,16.3,2066,4.6,32.6,0,294,294,1275
1985,25060,3336,3759,48636,48323,541,14.5,452,12.1,8863,3554,5309,7.4,18.3,8236,4148,4088,8.6,17,627,1.3,34,0,288,290,2407
1986,25060,3368,3808,51347,49990,524,13.9,461,12.2,10300,3830,6470,7.7,20.6,7585,3323,4262,6.6,15.2,2715,5.4,30.4,0,310,311,1624
1987,25060,3500,3982,55675,55310,640,16.4,461,11.8,9785,4520,5265,8.2,17.7,9054,3148,5906,5.7,16.4,731,1.3,32.8,0,327,327,1968
1988,25060,3376,3868,51363,51777,502,12.8,565,14.4,8846,3517,5329,6.8,17.1,9674,4106,5568,7.9,18.7,-828,-1.6,34.2,0,404,404,2104
1989,25060,3380,3892,53154,52556,511,13.2,485,12.5,9980,4824,5156,9.2,19,8784,3242,5542,6.2,16.7,1196,2.3,33.4,0,335,335,1604
1990,25060,3371,3907,54855,53923,486,12.5,427,11,9950,4318,5632,8,18.5,8085,3198,4887,5.9,15,1865,3.5,30,0,303,303,2227
1991,25060,3431,3991,53662,54310,505,12.8,430,10.9,9530,4220,5310,7.8,17.5,10826,3687,7139,6.8,19.9,-1296,-2.4,35,0,251,258,1900
1992,25060,3522,4081,52563,53069,551,13.6,433,10.7,10004,4076,5928,7.7,18.9,11015,3482,7533,6.6,20.8,-1011,-1.9,37.8,0,289,289,1978
1993,25060,3657,4219,58029,55282,565,13.6,431,10.4,13071,5380,7691,9.7,23.6,7576,3277,4299,5.9,13.7,5495,9.9,27.4,0,313,313,1893
1994,25060,3758,4334,72081,65051,575,13.4,459,10.7,23099,10874,12225,16.7,35.5,9038,3417,5621,5.3,13.9,14061,21.6,27.8,0,321,321,1738
1995,25060,3896,4499,74587,73186,654,14.8,471,10.7,17978,8960,9018,12.2,24.6,15176,4396,10780,6,20.7,2802,3.9,41.4,0,317,317,2132
1996,25060,4014,4666,74274,74483,657,14.3,479,10.5,13146,5940,7206,8,17.6,13563,4542,9021,6.1,18.2,-417,-0.6,35.2,0,324,324,2860
1997,25060,4083,4753,79531,76954,652,13.8,560,11.9,17326,6983,10343,9.1,22.5,12172,5222,6950,6.8,15.8,5154,6.7,31.6,0,376,376,2157
1998,25060,4094,4780,80357,79860,555,11.6,517,10.8,12696,4364,8332,5.5,15.9,11702,5034,6668,6.3,14.7,994,1.2,29.4,0,347,347,2460
1999,25060,4118,4843,91425,86851,586,12.2,519,10.8,19873,7977,11896,9.2,22.9,10725,3937,6788,4.5,12.3,9148,10.6,24.6,0,373,373,1815
2000,25060,4130,4893,91759,91651,582,12,544,11.2,11948,4459,7489,4.9,13,11731,3233,8498,3.5,12.8,217,0.2,25.6,0,336,336,1762
2001,25060,4149,4953,90048,90965,645,13.1,616,12.5,12755,6692,6063,7.4,14,14589,5469,9120,6,16,-1834,-2,28,0,393,393,1901
2002,25060,4174,4994,87822,88874,646,13,605,12.2,11738,5833,5905,6.6,13.2,13841,4725,9116,5.3,15.6,-2103,-2.4,26.4,0,329,329,1570
2003,25060,4221,5024,91118,88955,577,11.6,425,8.6,14167,4371,9796,4.9,15.9,9841,2885,6956,3.2,11.1,4326,4.8,22.2,0,319,320,1801
2004,25060,4240,5049,88929,89687,528,10.5,462,9.2,10892,4006,6886,4.5,12.1,12408,3851,8557,4.3,13.8,-1516,-1.7,24.2,0,314,321,2182
2005,25060,4241,5046,88089,88265,563,11.2,521,10.3,13879,6385,7494,7.2,15.7,14231,5504,8727,6.2,16.1,-352,-0.4,31.4,0,362,370,3440
2006,25060,3703,4458,74926,80698,586,12.4,1018,21.6,14959,5445,9514,6.7,18.5,26502,7943,18559,9.8,32.8,-11543,-14.3,37,0,620,620,3696
2007,25060,4051,4832,84423,79682,807,17.4,456,9.8,22529,6288,16241,7.9,28.3,13047,5053,7994,6.3,16.4,9482,11.9,32.8,0,246,249,1455
2008,25060,4111,4912,86108,84811,547,11.3,422,8.7,13924,5116,8808,6,16.4,11329,3557,7772,4.2,13.4,2595,3,26.8,0,317,317,1965
2009,25060,3959,4768,82612,83973,439,9.1,531,11,10527,4620,5907,5.5,12.5,13249,2974,10275,3.5,15.8,-2722,-3.3,25,0,372,382,1698
2010,25060,3909,4768,82212,82306,433,9.1,421,8.9,9415,3824,5591,4.6,11.4,9602,1945,7657,2.4,11.7,-187,-0.3,22.8,0,293,293,1299
2011,25060,3865,4767,84163,82965,442,9.3,399,8.4,11239,5566,5673,6.7,13.5,8842,2856,5986,3.4,10.7,2397,2.8,21.4,0,281,281,1666
2012,25060,3849,4783,83380,83633,472,9.9,465,9.7,11461,3425,8036,4.1,13.7,11967,3455,8512,4.1,14.3,-506,-0.6,27.4,0,308,308,1669
2013,25060,3805,4734,83847,83522,349,7.4,382,8.1,8305,2174,6131,2.6,9.9,7655,1576,6079,1.9,9.2,650,0.7,18.4,0,265,265,1064
2014,25060,3810,4755,83145,83104,423,9,354,7.5,8445,2813,5632,3.4,10.2,8363,2661,5702,3.2,10.1,82,0.1,20.2,0,269,269,1264
1977,25180,2638,2861,42633,41198,416,14.7,324,11.5,8695,3972,4723,9.6,21.1,5825,2709,3116,6.6,14.1,2870,7,28.2,0,218,219,1809
1978,25180,2703,2930,46234,44438,341,11.8,277,9.6,7321,1956,5365,4.4,16.5,3729,1478,2251,3.3,8.4,3592,8.1,16.8,0,178,178,788
1979,25180,2726,2965,48603,47377,354,12,299,10.1,7673,2074,5599,4.4,16.2,5221,2366,2855,5,11,2452,5.2,22,0,223,224,1050
1980,25180,2719,2966,50428,50702,335,11.3,313,10.6,5277,2343,2934,4.6,10.4,5824,1343,4481,2.6,11.5,-547,-1.1,20.8,0,222,222,875
1981,25180,2641,2883,47930,48932,308,10.5,364,12.5,5241,2277,2964,4.7,10.7,7244,2678,4566,5.5,14.8,-2003,-4.1,21.4,0,207,207,1234
1982,25180,2651,2924,46890,47362,375,12.9,304,10.5,4960,2259,2701,4.8,10.5,5904,1712,4192,3.6,12.5,-944,-2,21,0,171,171,704
1983,25180,2723,3003,46293,46686,294,9.9,248,8.4,5701,2230,3471,4.8,12.2,6486,1652,4834,3.5,13.9,-785,-1.7,24.4,0,158,158,659
1984,25180,2736,3017,48464,47344,363,12.1,335,11.1,7835,1983,5852,4.2,16.5,5595,1939,3656,4.1,11.8,2240,4.7,23.6,0,199,199,767
1985,25180,2926,3200,50990,49965,381,12.2,227,7.3,7654,2558,5096,5.1,15.3,5603,1931,3672,3.9,11.2,2051,4.1,22.4,0,61,62,559
1986,25180,3013,3308,51485,51226,434,13.3,315,9.7,7102,2653,4449,5.2,13.9,6584,2085,4499,4.1,12.9,518,1,25.8,0,205,206,1015
1987,25180,3145,3499,55943,54343,541,15.9,341,10,9583,3772,5811,6.9,17.6,6383,2334,4049,4.3,11.7,3200,5.9,23.4,0,225,225,1128
1988,25180,3179,3577,56442,55901,439,12.4,331,9.4,8931,3272,5659,5.9,16,7848,2486,5362,4.4,14,1083,2,28,0,226,226,1202
1989,25180,3265,3713,60380,58448,458,12.6,323,8.9,9855,3847,6008,6.6,16.9,5991,2190,3801,3.7,10.3,3864,6.6,20.6,0,219,219,1299
1990,25180,3380,3842,61782,61052,464,12.3,312,8.3,9918,3772,6146,6.2,16.2,8457,2142,6315,3.5,13.9,1461,2.3,27.8,0,187,187,1007
1991,25180,3437,3948,62061,62030,469,12,361,9.3,10108,5545,4563,8.9,16.3,10046,3442,6604,5.5,16.2,62,0.1,32.4,0,218,219,1161
1992,25180,3473,4018,63089,62534,447,11.2,364,9.1,8781,3014,5767,4.8,14,7671,2343,5328,3.7,12.3,1110,1.7,24.6,0,220,220,1346
1993,25180,3540,4089,63270,63225,406,10,327,8.1,8255,3045,5210,4.8,13.1,8165,2343,5822,3.7,12.9,90,0.2,25.8,0,185,186,1112
1994,25180,3558,4120,65017,64138,421,10.3,380,9.3,9162,2851,6311,4.4,14.3,7403,2389,5014,3.7,11.5,1759,2.8,23,0,247,247,1166
1995,25180,3654,4246,68340,66663,494,11.8,360,8.6,10285,3575,6710,5.4,15.4,6931,3107,3824,4.7,10.4,3354,5,20.8,0,226,226,1194
1996,25180,3703,4292,68206,68235,429,10.1,371,8.7,11820,6263,5557,9.2,17.3,11877,4340,7537,6.4,17.4,-57,-0.1,34.6,0,247,247,2450
1997,25180,3721,4326,70676,69474,481,11.2,442,10.2,11255,3719,7536,5.4,16.2,8850,3387,5463,4.9,12.7,2405,3.5,25.4,0,274,274,1763
1998,25180,3756,4369,72530,71655,451,10.4,404,9.3,9707,3921,5786,5.5,13.5,7957,2657,5300,3.7,11.1,1750,2.4,22.2,0,249,249,1339
1999,25180,3812,4458,75133,73976,484,11,388,8.8,11255,4855,6400,6.6,15.2,8940,3619,5321,4.9,12.1,2315,3.1,24.2,0,244,244,1313
2000,25180,3848,4527,80555,77858,482,10.7,414,9.2,12846,5557,7289,7.1,16.5,7451,2852,4599,3.7,9.6,5395,6.9,19.2,0,237,237,976
2001,25180,3906,4609,81321,81048,459,10,418,9.1,10608,3890,6718,4.8,13.1,10061,3009,7052,3.7,12.4,547,0.7,24.8,0,222,222,1036
2002,25180,3957,4693,82597,81932,558,12,462,9.9,11314,4054,7260,4.9,13.8,9983,2800,7183,3.4,12.2,1331,1.6,24.4,0,242,242,988
2003,25180,4015,4771,82707,82358,457,9.7,322,6.8,10471,4086,6385,5,12.7,9773,3295,6478,4,11.9,698,0.8,23.8,0,201,201,1832
2004,25180,4091,4835,83289,82747,471,9.8,362,7.6,11966,5441,6525,6.6,14.5,10881,5587,5294,6.8,13.1,1085,1.4,26.2,0,228,228,1524
2005,25180,4223,4984,86288,84592,567,11.6,377,7.7,11583,4558,7025,5.4,13.7,8190,2575,5615,3,9.7,3393,4,19.4,0,269,271,1171
2006,25180,4288,5084,88255,87044,549,10.9,422,8.4,12425,4707,7718,5.4,14.3,10003,3887,6116,4.5,11.5,2422,2.8,23,0,274,275,1545
2007,25180,4292,5120,86169,87016,569,11.2,499,9.8,10420,4141,6279,4.8,12,12114,3394,8720,3.9,13.9,-1694,-1.9,24,0,321,321,1746
2008,25180,4243,5083,83944,84688,443,8.7,446,8.8,9521,3450,6071,4.1,11.2,11009,2762,8247,3.3,13,-1488,-1.8,22.4,0,311,311,1404
2009,25180,4069,4918,78279,80620,363,7.3,470,9.4,6326,2555,3771,3.2,7.8,11008,1979,9029,2.5,13.7,-4682,-5.9,15.6,0,329,329,1317
2010,25180,3993,4854,76721,77271,365,7.5,398,8.2,7612,2781,4831,3.6,9.9,8712,1752,6960,2.3,11.3,-1100,-1.4,19.8,0,260,261,1008
2011,25180,3927,4796,77075,76726,370,7.7,392,8.1,8343,2568,5775,3.3,10.9,7645,1921,5724,2.5,10,698,0.9,20,0,264,264,1205
2012,25180,3929,4820,80913,79015,393,8.2,375,7.8,11099,2757,8342,3.5,14,7302,2307,4995,2.9,9.2,3797,4.8,18.4,0,229,231,1040
2013,25180,3948,4844,83645,81986,363,7.5,339,7,9771,2345,7426,2.9,11.9,6453,2029,4424,2.5,7.9,3318,4,15.8,0,204,204,1116
2014,25180,3934,4822,84874,84063,363,7.5,337,7,8451,2328,6123,2.8,10.1,6828,1820,5008,2.2,8.1,1623,2,16.2,0,224,224,1105
1977,25260,1002,1079,10626,10187,165,15.5,134,12.6,2324,881,1443,8.6,22.8,1445,545,900,5.3,14.2,879,8.6,28.4,0,91,91,377
1978,25260,1012,1096,11352,10990,166,15.3,149,13.7,2175,952,1223,8.7,19.8,1451,596,855,5.4,13.2,724,6.6,26.4,0,93,93,332
1979,25260,1083,1168,12178,11755,213,18.8,134,11.8,2628,1130,1498,9.6,22.4,1782,679,1103,5.8,15.2,846,7.2,30.4,0,92,94,413
1980,25260,1071,1149,11535,11834,152,13.1,165,14.2,1891,848,1043,7.2,16,2488,865,1623,7.3,21,-597,-5,32,0,119,120,394
1981,25260,1049,1122,11470,11423,145,12.8,152,13.5,2071,867,1204,7.6,18.1,1976,723,1253,6.3,17.3,95,0.8,34.6,0,88,88,365
1982,25260,1052,1133,11660,11533,166,14.7,131,11.6,2146,1088,1058,9.4,18.6,1892,681,1211,5.9,16.4,254,2.2,32.8,0,66,66,275
1983,25260,1076,1156,12062,11892,127,11.1,122,10.7,2188,657,1531,5.5,18.4,1848,551,1297,4.6,15.5,340,2.9,31,0,75,75,375
1984,25260,1124,1207,12882,12473,158,13.4,101,8.6,2770,1235,1535,9.9,22.2,1951,464,1487,3.7,15.6,819,6.6,31.2,0,72,72,292
1985,25260,1160,1243,12832,12882,154,12.5,123,10,2179,728,1451,5.7,16.9,2279,1057,1222,8.2,17.7,-100,-0.8,33.8,0,78,78,356
1986,25260,1164,1246,13429,13160,160,12.9,146,11.7,2750,1463,1287,11.1,20.9,2212,850,1362,6.5,16.8,538,4.1,33.6,0,91,91,517
1987,25260,1200,1287,14009,13757,185,14.6,141,11.1,2816,1274,1542,9.3,20.5,2311,674,1637,4.9,16.8,505,3.7,33.6,0,96,96,357
1988,25260,1175,1258,14139,14001,143,11.3,156,12.3,2595,723,1872,5.2,18.5,2318,1028,1290,7.3,16.6,277,1.9,33.2,0,107,107,395
1989,25260,1066,1144,13888,14057,133,11.1,246,20.5,2197,767,1430,5.5,15.6,2535,1491,1044,10.6,18,-338,-2.4,31.2,0,78,78,375
1990,25260,1196,1277,15218,14546,249,20.6,108,8.9,3233,1554,1679,10.7,22.2,1888,581,1307,4,13,1345,9.2,26,0,75,75,263
1991,25260,1208,1298,15657,15395,154,12,128,9.9,2665,1100,1565,7.1,17.3,2141,776,1365,5,13.9,524,3.4,27.8,0,86,87,570
1992,25260,1201,1301,16631,16111,143,11,130,10,3631,1254,2377,7.8,22.5,2590,657,1933,4.1,16.1,1041,6.4,32.2,0,86,87,557
1993,25260,1231,1340,17302,17008,171,12.9,117,8.9,4078,2449,1629,14.4,24,3489,886,2603,5.2,20.5,589,3.5,41,0,76,76,344
1994,25260,1189,1292,16456,16849,113,8.6,150,11.4,2451,1065,1386,6.3,14.5,3236,1170,2066,6.9,19.2,-785,-4.7,29,0,99,99,796
1995,25260,1199,1317,16575,16491,143,11,112,8.6,2764,1252,1512,7.6,16.8,2596,1041,1555,6.3,15.7,168,1.1,31.4,0,75,75,708
1996,25260,1209,1323,16410,16524,121,9.2,110,8.3,2353,703,1650,4.3,14.2,2580,809,1771,4.9,15.6,-227,-1.4,28.4,0,70,70,301
1997,25260,1239,1353,17153,16756,164,12.2,130,9.7,2906,969,1937,5.8,17.3,2111,780,1331,4.7,12.6,795,4.7,25.2,0,73,73,327
1998,25260,1240,1359,17479,17326,139,10.2,127,9.4,2688,883,1805,5.1,15.5,2382,876,1506,5.1,13.7,306,1.8,27.4,0,79,79,418
1999,25260,1249,1375,17378,17466,139,10.2,117,8.6,2338,854,1484,4.9,13.4,2513,905,1608,5.2,14.4,-175,-1,26.8,0,66,66,300
2000,25260,1252,1368,17973,17693,131,9.5,144,10.5,2863,924,1939,5.2,16.2,2302,992,1310,5.6,13,561,3.2,26,0,82,82,411
2001,25260,1296,1418,19641,18820,161,11.5,120,8.6,3833,1047,2786,5.6,20.4,2190,647,1543,3.4,11.6,1643,8.8,23.2,0,70,70,275
2002,25260,1312,1434,19457,19487,181,12.7,161,11.3,3352,1418,1934,7.3,17.2,3411,1160,2251,6,17.5,-59,-0.3,34.4,0,87,87,374
2003,25260,1309,1434,24997,22147,150,10.5,125,8.7,9002,5945,3057,26.8,40.6,3301,612,2689,2.8,14.9,5701,25.7,29.8,0,92,92,431
2004,25260,1285,1410,21276,23095,131,9.2,141,9.9,2798,833,1965,3.6,12.1,6435,947,5488,4.1,27.9,-3637,-15.8,24.2,0,88,88,429
2005,25260,1324,1455,21615,21458,177,12.4,124,8.7,3355,1704,1651,7.9,15.6,3040,797,2243,3.7,14.2,315,1.4,28.4,0,94,94,560
2006,25260,1341,1483,23016,22296,179,12.2,140,9.5,3754,1380,2374,6.2,16.8,2314,859,1455,3.9,10.4,1440,6.4,20.8,0,101,101,584
2007,25260,1363,1512,23576,23306,170,11.4,150,10,3638,1190,2448,5.1,15.6,3097,1074,2023,4.6,13.3,541,2.3,26.6,0,101,103,643
2008,25260,1368,1516,23555,23495,156,10.4,135,9,2671,972,1699,4.1,11.4,2551,793,1758,3.4,10.9,120,0.5,21.8,0,95,95,421
2009,25260,1367,1522,22512,22910,150,9.9,129,8.5,2699,1261,1438,5.5,11.8,3494,794,2700,3.5,15.3,-795,-3.5,23.6,0,85,85,456
2010,25260,1333,1482,21712,21984,115,7.7,145,9.7,2414,869,1545,4,11,2957,1003,1954,4.6,13.5,-543,-2.5,22,0,99,99,427
2011,25260,1306,1455,22028,21759,121,8.3,125,8.5,2947,1253,1694,5.8,13.5,2409,976,1433,4.5,11.1,538,2.4,22.2,0,84,84,470
2012,25260,1290,1433,22878,22451,124,8.6,145,10,3091,1156,1935,5.1,13.8,2237,837,1400,3.7,10,854,3.8,20,0,88,88,427
2013,25260,1283,1428,22618,22702,111,7.8,112,7.9,2386,624,1762,2.7,10.5,2554,888,1666,3.9,11.3,-168,-0.8,21,0,65,66,624
2014,25260,1301,1456,22412,22453,148,10.3,102,7.1,2180,647,1533,2.9,9.7,2261,730,1531,3.3,10.1,-81,-0.4,19.4,0,77,77,560
1977,25420,7127,8329,153806,147077,1234,15.1,897,11,33279,12074,21205,8.2,22.6,19820,7407,12413,5,13.5,13459,9.1,27,0,559,563,4061
1978,25420,7227,8411,154832,154311,958,11.4,867,10.4,26979,6941,20038,4.5,17.5,25937,9183,16754,6,16.8,1042,0.7,33.6,0,543,549,2829
1979,25420,7351,8586,163509,159109,975,11.5,755,8.9,27295,10541,16754,6.6,17.2,18495,6563,11932,4.1,11.6,8800,5.6,23.2,0,478,479,3326
1980,25420,7294,8558,163046,163194,837,9.8,836,9.8,21202,6255,14947,3.8,13,21498,6612,14886,4.1,13.2,-296,-0.2,26,0,547,547,3054
1981,25420,6980,8221,161290,161503,803,9.6,1032,12.3,20885,7601,13284,4.7,12.9,21311,8260,13051,5.1,13.2,-426,-0.3,25.8,0,557,560,3295
1982,25420,7019,8394,165526,163482,1010,12.1,760,9.1,24247,12235,12012,7.5,14.8,20159,5983,14176,3.7,12.3,4088,2.5,24.6,0,410,415,2272
1983,25420,7210,8573,163507,164058,776,9.1,693,8.2,20536,7515,13021,4.6,12.5,21637,7631,14006,4.7,13.2,-1101,-0.7,25,0,428,429,2366
1984,25420,7343,8752,173004,168127,972,11.2,803,9.3,24958,7154,17804,4.3,14.8,15204,5056,10148,3,9,9754,5.8,18,0,494,494,2284
1985,25420,7507,8903,181311,177357,971,11,813,9.2,26431,7959,18472,4.5,14.9,18522,6609,11913,3.7,10.4,7909,4.5,20.8,0,483,484,3087
1986,25420,7802,9230,187135,184130,1109,12.2,759,8.4,29139,10759,18380,5.8,15.8,23129,7430,15699,4,12.6,6010,3.2,25.2,0,454,454,4364
1987,25420,8063,9609,194767,191014,1272,13.5,879,9.3,29021,8944,20077,4.7,15.2,21514,7996,13518,4.2,11.3,7507,3.9,22.6,0,531,538,4108
1988,25420,8183,9771,200345,197144,1143,11.8,937,9.7,30756,9933,20823,5,15.6,24353,8669,15684,4.4,12.4,6403,3.2,24.8,0,581,581,3402
1989,25420,8379,10097,212163,206689,1173,11.8,853,8.6,34052,13325,20727,6.4,16.5,23103,7254,15849,3.5,11.2,10949,5.3,22.4,0,561,573,3480
1990,25420,8509,10268,218332,215091,1119,11,891,8.8,30234,9255,20979,4.3,14.1,23751,8221,15530,3.8,11,6483,3.1,22,0,556,559,3344
1991,25420,8679,10504,216442,217438,1158,11.2,913,8.8,29048,13015,16033,6,13.4,31039,10320,20719,4.7,14.3,-1991,-0.9,26.8,0,542,550,3815
1992,25420,8725,10609,218656,218959,1074,10.1,972,9.2,27288,9092,18196,4.2,12.5,27894,7918,19976,3.6,12.7,-606,-0.2,25,0,592,596,3165
1993,25420,8856,10757,222636,220740,974,9.1,809,7.6,27949,7881,20068,3.6,12.7,24157,5980,18177,2.7,10.9,3792,1.8,21.8,0,534,535,2895
1994,25420,8956,10923,222176,220854,1056,9.7,864,8,29091,10348,18743,4.7,13.2,26446,8780,17666,4,12,2645,1.2,24,0,543,543,4328
1995,25420,9140,11162,230389,226166,1153,10.4,866,7.8,31464,10214,21250,4.5,13.9,23018,6683,16335,3,10.2,8446,3.7,20.4,0,559,561,3051
1996,25420,9202,11241,235405,232935,1037,9.3,946,8.4,35630,15035,20595,6.5,15.3,30690,8855,21835,3.8,13.2,4940,2.1,26.4,0,584,584,3645
1997,25420,9300,11435,247408,243054,1256,11.1,1052,9.3,36362,12299,24063,5.1,15,27654,9447,18207,3.9,11.4,8708,3.6,22.8,0,555,555,3725
1998,25420,9378,11537,250978,249039,1157,10.1,1034,9,37759,15145,22614,6.1,15.2,33880,9964,23916,4,13.6,3879,1.6,27.2,0,609,609,3669
1999,25420,9389,11598,253698,252865,1101,9.5,1023,8.8,37400,14499,22901,5.7,14.8,35733,12875,22858,5.1,14.1,1667,0.7,28.2,0,597,597,4242
2000,25420,9434,11761,255105,252497,1196,10.2,1049,9,38093,13986,24107,5.5,15.1,32877,12221,20656,4.8,13,5216,2.1,26,0,594,594,3547
2001,25420,9506,11950,265024,260560,1205,10.2,1092,9.2,41464,14816,26648,5.7,15.9,32536,11239,21297,4.3,12.5,8928,3.4,25,0,625,625,4643
2002,25420,9557,11932,264094,264435,1287,10.8,1271,10.7,45646,19665,25981,7.4,17.3,46327,23553,22774,8.9,17.5,-681,-0.2,34.6,0,567,567,10388
2003,25420,9552,11952,265683,261244,1114,9.4,900,7.6,42274,9086,33188,3.5,16.2,33396,11161,22235,4.3,12.8,8878,3.4,25.6,0,589,589,7448
2004,25420,9778,12206,276192,271029,1217,10.1,866,7.2,44258,16961,27297,6.3,16.3,33932,10046,23886,3.7,12.5,10326,3.8,25,0,513,513,3654
2005,25420,9849,12355,262082,267431,1184,9.7,916,7.5,32484,11894,20590,4.4,12.1,43181,8605,34576,3.2,16.1,-10697,-4,24.2,0,584,584,3813
2006,25420,9875,12502,268231,264666,1290,10.4,1040,8.4,36111,16709,19402,6.3,13.6,28981,9433,19548,3.6,11,7130,2.6,22,0,672,691,5034
2007,25420,10002,12591,269619,268086,1276,10.2,1103,8.8,38046,14188,23858,5.3,14.2,34979,10898,24081,4.1,13,3067,1.2,26,0,596,608,5217
2008,25420,9990,12661,272200,270323,1148,9.1,941,7.5,33875,12000,21875,4.4,12.5,30121,8068,22053,3,11.1,3754,1.4,22.2,0,623,625,4630
2009,25420,9849,12496,266682,268634,949,7.6,1001,8,26275,9663,16612,3.6,9.8,30179,7074,23105,2.6,11.2,-3904,-1.4,19.6,0,641,648,4448
2010,25420,9791,12450,260518,262349,903,7.3,869,7,28065,10433,17632,4,10.7,31727,10546,21181,4,12.1,-3662,-1.4,21.4,0,521,521,6319
2011,25420,9676,12388,262662,260730,966,7.8,894,7.2,32443,11831,20612,4.5,12.4,28578,9685,18893,3.7,11,3865,1.4,22,0,561,561,6536
2012,25420,9733,12420,260340,257120,1008,8.1,943,7.6,36700,11678,25022,4.5,14.3,30259,8139,22120,3.2,11.8,6441,2.5,23.6,0,536,538,2889
2013,25420,9642,12294,262815,260674,886,7.2,951,7.7,29462,9112,20350,3.5,11.3,25180,6692,18488,2.6,9.7,4282,1.6,19.4,0,574,575,4102
2014,25420,9620,12318,257279,258890,975,8,825,6.7,30466,9370,21096,3.6,11.8,33688,6656,27032,2.6,13,-3222,-1.2,23.6,0,556,556,3284
1977,25500,1267,1345,21404,21158,169,12.6,155,11.6,3002,1150,1852,5.4,14.2,2510,936,1574,4.4,11.9,492,2.3,23.8,0,105,105,464
1978,25500,1324,1410,22540,21748,190,13.8,122,8.9,3590,1100,2490,5.1,16.5,2005,810,1195,3.7,9.2,1585,7.3,18.4,0,79,79,372
1979,25500,1347,1444,24609,23570,200,14,160,11.2,4345,1555,2790,6.6,18.4,2267,958,1309,4.1,9.6,2078,8.8,19.2,0,112,113,540
1980,25500,1360,1465,24604,24589,187,12.9,156,10.7,3252,1301,1951,5.3,13.2,3221,1660,1561,6.8,13.1,31,0.1,26.2,0,118,118,487
1981,25500,1353,1455,24563,24400,190,13.1,178,12.2,4516,2935,1581,12,18.5,4190,1341,2849,5.5,17.2,326,1.3,34.4,0,107,107,484
1982,25500,1332,1455,24526,24532,189,13,155,10.6,3764,1376,2388,5.6,15.3,3776,965,2811,3.9,15.4,-12,-0.1,30.6,0,97,97,551
1983,25500,1383,1509,24454,24505,156,10.5,127,8.6,3018,1179,1839,4.8,12.3,3119,1297,1822,5.3,12.7,-101,-0.4,24.6,0,85,85,659
1984,25500,1394,1516,25764,25054,197,13.1,176,11.7,3999,1159,2840,4.6,16,2579,1139,1440,4.5,10.3,1420,5.7,20.6,0,100,100,513
1985,25500,1524,1656,27374,26777,205,12.9,87,5.5,4012,1025,2987,3.8,15,2817,525,2292,2,10.5,1195,4.5,21,0,3,3,83
1986,25500,1579,1718,29835,28593,206,12.2,138,8.2,5231,1688,3543,5.9,18.3,2746,1044,1702,3.7,9.6,2485,8.7,19.2,0,86,86,742
1987,25500,1646,1804,30920,30433,239,13.6,151,8.6,4570,1883,2687,6.2,15,3596,1433,2163,4.7,11.8,974,3.2,23.6,0,111,111,840
1988,25500,1722,1893,33338,31851,258,14,154,8.4,6163,2566,3597,8.1,19.3,3189,814,2375,2.6,10,2974,9.3,20,0,98,98,334
1989,25500,1819,1995,33727,33546,273,14,174,9,4855,1503,3352,4.5,14.5,4493,1823,2670,5.4,13.4,362,1.1,26.8,0,115,116,933
1990,25500,1876,2057,35814,34815,243,12,173,8.5,5664,1824,3840,5.2,16.3,3665,1163,2502,3.3,10.5,1999,5.8,21,0,121,122,656
1991,25500,1901,2101,35844,35826,241,11.6,193,9.3,5108,2549,2559,7.1,14.3,5072,1570,3502,4.4,14.2,36,0.1,28.4,0,120,122,661
1992,25500,1912,2125,38123,36990,221,10.4,194,9.2,6025,2836,3189,7.7,16.3,3758,1253,2505,3.4,10.2,2267,6.1,20.4,0,128,131,773
1993,25500,1920,2136,42414,40255,208,9.8,185,8.7,8150,1131,7019,2.8,20.2,3831,1292,2539,3.2,9.5,4319,10.7,19,0,121,121,530
1994,25500,1956,2172,39565,40977,228,10.6,187,8.7,4365,1065,3300,2.6,10.7,7188,1104,6084,2.7,17.5,-2823,-6.8,21.4,0,116,116,649
1995,25500,2033,2238,41551,40575,265,12,196,8.9,5792,1966,3826,4.8,14.3,3840,1686,2154,4.2,9.5,1952,4.8,19,0,132,134,1002
1996,25500,2058,2266,42363,41928,218,9.7,189,8.4,4372,1281,3091,3.1,10.4,3502,964,2538,2.3,8.4,870,2,16.8,0,113,113,533
1997,25500,2064,2287,44010,43188,250,11,216,9.5,5503,1757,3746,4.1,12.7,3858,899,2959,2.1,8.9,1645,3.8,17.8,0,136,136,545
1998,25500,2089,2325,45499,44754,226,9.8,192,8.3,5390,1488,3902,3.3,12,3899,1299,2600,2.9,8.7,1491,3.3,17.4,0,132,132,620
1999,25500,2123,2373,46039,45799,244,10.4,192,8.2,5161,1489,3672,3.3,11.3,4680,1158,3522,2.5,10.2,481,1.1,20.4,0,122,122,625
2000,25500,2163,2425,47740,46876,240,10,190,7.9,5951,1631,4320,3.5,12.7,4223,1086,3137,2.3,9,1728,3.7,18,0,123,123,662
2001,25500,2205,2473,48019,48102,222,9,205,8.3,4818,1460,3358,3,10,4983,1273,3710,2.6,10.4,-165,-0.4,20,0,98,98,530
2002,25500,2264,2525,48348,48094,291,11.7,236,9.4,7343,2125,5218,4.4,15.3,6834,1773,5061,3.7,14.2,509,1.1,28.4,0,107,107,540
2003,25500,2324,2605,49817,48813,312,12.2,182,7.1,6556,2739,3817,5.6,13.4,4547,1299,3248,2.7,9.3,2009,4.1,18.6,0,131,131,719
2004,25500,2369,2664,52153,50903,253,9.6,164,6.2,6334,1328,5006,2.6,12.4,3834,912,2922,1.8,7.5,2500,4.9,15,0,106,106,476
2005,25500,2475,2780,53792,52758,328,12.1,195,7.2,6594,2130,4464,4,12.5,4526,872,3654,1.7,8.6,2068,3.9,17.2,0,140,142,648
2006,25500,2506,2831,52788,53158,345,12.3,260,9.3,7831,3547,4284,6.7,14.7,8570,3734,4836,7,16.1,-739,-1.4,29.4,0,181,181,1459
2007,25500,2551,2888,52496,52575,322,11.3,268,9.4,6933,2619,4314,5,13.2,7090,2135,4955,4.1,13.5,-157,-0.3,26.4,0,173,173,588
2008,25500,2543,2851,53466,52776,245,8.6,231,8.1,6231,1470,4761,2.8,11.8,4850,1465,3385,2.8,9.2,1381,2.6,18.4,0,165,165,1122
2009,25500,2465,2780,50777,52089,189,6.7,247,8.8,3869,1305,2564,2.5,7.4,6493,1439,5054,2.8,12.5,-2624,-5.1,14.8,0,172,172,812
2010,25500,2442,2757,50580,50555,188,6.8,200,7.2,4656,987,3669,2,9.2,4606,1075,3531,2.1,9.1,50,0.1,18.2,0,139,139,550
2011,25500,2443,2755,48554,49585,200,7.3,190,6.9,3857,997,2860,2,7.8,5919,696,5223,1.4,11.9,-2062,-4.1,15.6,0,132,132,505
2012,25500,2424,2758,49914,49137,198,7.2,192,7,5974,1437,4537,2.9,12.2,4420,1230,3190,2.5,9,1554,3.2,18,0,137,137,797
2013,25500,2450,2774,49655,49736,207,7.5,194,7,4383,1263,3120,2.5,8.8,4547,1224,3323,2.5,9.1,-164,-0.3,17.6,0,130,130,792
2014,25500,2409,2741,50563,50087,188,6.8,210,7.6,4363,1482,2881,3,8.7,3411,1323,2088,2.6,6.8,952,1.9,13.6,0,153,154,876
1977,25540,18013,20313,390196,382565,3024,15.1,2261,11.3,70894,22675,48219,5.9,18.5,55632,18008,37624,4.7,14.5,15262,4,29,0,1410,1414,8828
1978,25540,18596,20943,418934,404497,2653,12.9,2028,9.8,70986,18559,52427,4.6,17.5,42112,19436,22676,4.8,10.4,28874,7.1,20.8,0,1391,1397,8073
1979,25540,19000,21375,447682,433057,2520,11.9,1981,9.4,71781,19020,52761,4.4,16.6,42530,14176,28354,3.3,9.8,29251,6.8,19.6,0,1355,1358,6842
1980,25540,19294,21697,468196,457836,2475,11.5,2099,9.7,70023,20703,49320,4.5,15.3,49303,14276,35027,3.1,10.8,20720,4.5,21.6,0,1438,1458,7535
1981,25540,18868,21192,470390,466926,2434,11.4,2727,12.7,67344,29123,38221,6.2,14.4,60416,24411,36005,5.2,12.9,6928,1.5,25.8,0,1565,1568,9850
1982,25540,19241,21907,467682,468738,2870,13.3,1987,9.2,65159,26520,38639,5.7,13.9,67270,15998,51272,3.4,14.4,-2111,-0.5,27.8,0,1167,1168,6884
1983,25540,19733,22435,483202,475657,2420,10.9,2039,9.2,82728,23174,59554,4.9,17.4,67638,19958,47680,4.2,14.2,15090,3.2,28.4,0,1325,1326,7384
1984,25540,20345,23153,502863,492919,2774,12.2,2048,9,79978,23940,56038,4.9,16.2,60090,15311,44779,3.1,12.2,19888,4,24.4,0,1349,1349,8232
1985,25540,20999,23873,531010,519579,2941,12.5,2252,9.6,84530,20665,63865,4,16.3,61667,19997,41670,3.8,11.9,22863,4.4,23.8,0,1514,1521,10299
1986,25540,21742,24690,544679,537836,3167,13,2280,9.4,81321,32206,49115,6,15.1,67635,24833,42802,4.6,12.6,13686,2.5,25.2,0,1472,1473,14684
1987,25540,22757,25940,578757,562817,3781,14.9,2460,9.7,97072,30625,66447,5.4,17.2,65191,25049,40142,4.5,11.6,31881,5.6,23.2,0,1629,1634,11959
1988,25540,23424,26820,571721,571256,3642,13.8,2677,10.2,88505,34176,54329,6,15.5,87575,32908,54667,5.8,15.3,930,0.2,30.6,0,1814,1814,18868
1989,25540,23680,27210,579657,571492,3249,12,2873,10.6,93933,31035,62898,5.4,16.4,77602,25981,51621,4.5,13.6,16331,2.8,27.2,0,1948,1961,12158
1990,25540,23540,27165,571234,575314,2992,11,2871,10.6,73953,27622,46331,4.8,12.9,82113,27017,55096,4.7,14.3,-8160,-1.4,25.8,0,1932,1940,14621
1991,25540,22989,26812,546440,559124,2747,10.2,3070,11.4,66241,29124,37117,5.2,11.8,91608,26539,65069,4.7,16.4,-25367,-4.6,23.6,0,1982,2004,13769
1992,25540,22407,26288,525221,535516,2686,10.1,3056,11.5,67163,23410,43753,4.4,12.5,87752,25454,62298,4.8,16.4,-20589,-3.9,25,0,1941,1966,13370
1993,25540,22504,26362,517850,521414,2509,9.5,2403,9.1,66890,19224,47666,3.7,12.8,74018,22776,51242,4.4,14.2,-7128,-1.4,25.6,0,1569,1574,11867
1994,25540,22532,26391,509532,513252,2521,9.6,2432,9.2,65475,19307,46168,3.8,12.8,72914,20870,52044,4.1,14.2,-7439,-1.4,25.6,0,1619,1621,8848
1995,25540,22780,26648,511918,509887,2735,10.3,2405,9.1,66107,23238,42869,4.6,13,62044,20785,41259,4.1,12.2,4063,0.8,24.4,0,1555,1583,9485
1996,25540,22828,26777,515607,514115,2666,10,2471,9.3,72622,31551,41071,6.1,14.1,69637,20965,48672,4.1,13.5,2985,0.6,27,0,1528,1528,8607
1997,25540,22837,26952,533718,524663,2852,10.6,2695,10,89330,31997,57333,6.1,17,71220,24105,47115,4.6,13.6,18110,3.4,27.2,0,1598,1598,10497
1998,25540,22721,26914,537680,535231,2706,10,2703,10,83634,32793,50841,6.1,15.6,78735,24963,53772,4.7,14.7,4899,0.9,29.4,0,1724,1724,10531
1999,25540,22533,26969,550668,544089,2578,9.6,2505,9.3,81252,28924,52328,5.3,14.9,68094,25085,43009,4.6,12.5,13158,2.4,25,0,1608,1608,9934
2000,25540,22416,26872,560140,555344,2433,9,2534,9.4,81178,30106,51072,5.4,14.6,71585,26260,45325,4.7,12.9,9593,1.7,25.8,0,1440,1440,7910
2001,25540,22473,27063,563496,564160,2568,9.5,2580,9.6,80520,32020,48500,5.7,14.3,81847,35816,46031,6.3,14.5,-1327,-0.2,28.6,0,1446,1447,8271
2002,25540,22405,27014,561280,561772,2795,10.3,2789,10.3,81380,34109,47271,6.1,14.5,82363,26414,55949,4.7,14.7,-983,-0.2,29,0,1372,1372,8129
2003,25540,22224,26809,548283,549156,2440,9.1,2268,8.5,71320,20451,50869,3.7,13,73066,28014,45052,5.1,13.3,-1746,-0.3,26,0,1401,1403,9806
2004,25540,22386,27057,546606,545153,2591,9.6,2118,7.9,69004,24316,44688,4.5,12.7,66097,20181,45916,3.7,12.1,2907,0.6,24.2,0,1336,1337,7802
2005,25540,22563,27447,541826,542823,2784,10.2,2177,8,70636,28294,42342,5.2,13,72629,24107,48522,4.4,13.4,-1993,-0.4,26,0,1407,1407,9602
2006,25540,22421,27516,554014,546781,2767,10.1,2482,9.1,81010,29641,51369,5.4,14.8,66543,20951,45592,3.8,12.2,14467,2.6,24.4,0,1669,1670,11221
2007,25540,22443,27755,559432,556105,2732,9.9,2395,8.7,85696,30434,55262,5.5,15.4,79042,20858,58184,3.8,14.2,6654,1.2,28.4,0,1421,1437,9199
2008,25540,22302,27819,562294,559708,2499,9,2249,8.1,86460,35704,50756,6.4,15.4,81288,18470,62818,3.3,14.5,5172,0.9,29,0,1488,1488,9801
2009,25540,21772,27199,537488,548427,2080,7.6,2462,9,54995,17725,37270,3.2,10,76873,16459,60414,3,14,-21878,-4,20,0,1511,1518,8577
2010,25540,21458,26870,525509,530473,2021,7.5,2150,8,58007,18045,39962,3.4,10.9,67934,15558,52376,2.9,12.8,-9927,-1.9,21.8,0,1322,1323,9347
2011,25540,21191,26613,523746,524017,2036,7.6,2120,7.9,59055,19749,39306,3.8,11.3,59596,17596,42000,3.4,11.4,-541,-0.1,22.6,0,1286,1289,7081
2012,25540,21271,26738,538565,530599,2238,8.4,2081,7.8,72061,18615,53446,3.5,13.6,56129,17473,38656,3.3,10.6,15932,3,21.2,0,1201,1206,8068
2013,25540,21226,26754,546361,541983,2126,8,2068,7.8,58676,16485,42191,3,10.8,49919,13498,36421,2.5,9.2,8757,1.6,18.4,0,1180,1193,7511
2014,25540,21052,26590,541778,542239,2124,8,2080,7.8,63276,20162,43114,3.7,11.7,64198,20734,43464,3.8,11.8,-922,-0.1,23.4,0,1309,1322,7632
1977,25620,1540,1681,22956,22001,288,17.4,220,13.3,5127,2408,2719,10.9,23.3,3216,1579,1637,7.2,14.6,1911,8.7,29.2,0,156,156,1004
1978,25620,1558,1704,23979,23437,255,15.1,232,13.7,4359,1795,2564,7.7,18.6,3275,1598,1677,6.8,14,1084,4.6,28,0,145,146,838
1979,25620,1652,1808,25115,24631,301,17.1,188,10.7,4463,1688,2775,6.9,18.1,3494,1020,2474,4.1,14.2,969,3.9,28.4,0,142,142,574
1980,25620,1688,1841,25873,25459,254,13.9,213,11.7,4405,1419,2986,5.6,17.3,3577,1161,2416,4.6,14.1,828,3.2,28.2,0,140,140,725
1981,25620,1632,1788,24201,24660,233,12.9,268,14.8,3462,1533,1929,6.2,14,4379,1480,2899,6,17.8,-917,-3.8,28,0,173,173,818
1982,25620,1664,1844,23370,23753,304,16.7,217,12,3635,1764,1871,7.4,15.3,4400,1564,2836,6.6,18.5,-765,-3.2,30.6,0,114,114,551
1983,25620,1683,1865,24027,23485,261,14.1,249,13.4,5053,2254,2799,9.6,21.5,3968,1550,2418,6.6,16.9,1085,4.6,33.8,0,173,173,966
1984,25620,1784,1970,25748,24904,302,15.7,207,10.8,5295,2433,2862,9.8,21.3,3607,1584,2023,6.4,14.5,1688,6.8,29,0,136,138,797
1985,25620,1819,2008,26870,26522,253,12.7,222,11.1,4986,2243,2743,8.5,18.8,4289,1944,2345,7.3,16.2,697,2.6,32.4,0,147,148,1072
1986,25620,1897,2090,28049,27447,324,15.8,230,11.2,5337,2252,3085,8.2,19.4,4133,1553,2580,5.7,15.1,1204,4.3,30.2,0,141,147,805
1987,25620,1886,2087,28330,28168,304,14.5,283,13.5,5052,1930,3122,6.9,17.9,4728,2284,2444,8.1,16.8,324,1.1,33.6,0,192,192,1572
1988,25620,1903,2116,28368,28175,290,13.8,259,12.3,4880,1979,2901,7,17.3,4494,1814,2680,6.4,16,386,1.3,32,0,161,161,670
1989,25620,1941,2177,29069,28707,279,13,228,10.6,4492,1876,2616,6.5,15.6,3767,1180,2587,4.1,13.1,725,2.5,26.2,0,161,161,702
1990,25620,1968,2206,30633,29786,263,12,209,9.5,5012,1524,3488,5.1,16.8,3318,1154,2164,3.9,11.1,1694,5.7,22.2,0,151,151,704
1991,25620,1994,2245,30751,30695,264,11.9,237,10.6,4580,1760,2820,5.7,14.9,4467,1318,3149,4.3,14.6,113,0.3,29.2,0,160,160,796
1992,25620,2018,2274,30740,30782,293,13,260,11.5,5248,2406,2842,7.8,17,5331,1966,3365,6.4,17.3,-83,-0.3,34,0,179,182,1319
1993,25620,2090,2360,31515,31118,285,12.3,189,8.2,4493,1632,2861,5.2,14.4,3698,1062,2636,3.4,11.9,795,2.5,23.8,0,142,142,790
1994,25620,2147,2407,32932,32166,301,12.6,245,10.3,6212,1926,4286,6,19.3,4679,1507,3172,4.7,14.5,1533,4.8,29,0,171,171,833
1995,25620,2189,2471,35311,34088,332,13.6,258,10.6,7328,3594,3734,10.5,21.5,4882,1667,3215,4.9,14.3,2446,7.2,28.6,0,151,151,739
1996,25620,2273,2562,35907,35598,379,15.1,282,11.2,6033,2583,3450,7.3,16.9,5414,2252,3162,6.3,15.2,619,1.7,30.4,0,186,186,879
1997,25620,2323,2645,39769,37848,371,14.2,289,11.1,9104,4048,5056,10.7,24.1,5262,1886,3376,5,13.9,3842,10.2,27.8,0,185,185,1004
1998,25620,2322,2663,40167,39979,334,12.6,310,11.7,6488,2767,3721,6.9,16.2,6112,2479,3633,6.2,15.3,376,0.9,30.6,0,210,210,1203
1999,25620,2349,2695,42811,42934,353,13.2,319,11.9,7189,2789,4400,6.5,16.7,7435,2776,4659,6.5,17.3,-246,-0.6,33.4,0,210,210,1134
2000,25620,2362,2718,43312,43032,321,11.9,296,10.9,6998,3144,3854,7.3,16.3,6438,2793,3645,6.5,15,560,1.3,30,0,182,182,1406
2001,25620,2344,2720,42745,43074,282,10.4,298,10.9,6320,1756,4564,4.1,14.7,6978,2174,4804,5,16.2,-658,-1.5,29.4,0,199,199,1340
2002,25620,2374,2757,44181,43447,321,11.7,287,10.5,8118,3698,4420,8.5,18.7,6650,2732,3918,6.3,15.3,1468,3.4,30.6,0,167,167,1050
2003,25620,2397,2789,44980,44187,319,11.6,238,8.6,7550,2692,4858,6.1,17.1,5963,1656,4307,3.7,13.5,1587,3.6,27,0,166,166,1006
2004,25620,2422,2826,44424,44427,309,11,245,8.7,7182,3430,3752,7.7,16.2,7187,2888,4299,6.5,16.2,-5,0,32.4,0,181,181,684
2005,25620,2506,2929,47355,45897,374,13,237,8.3,8503,3843,4660,8.4,18.5,5587,2058,3529,4.5,12.2,2916,6.3,24.4,0,180,180,1271
2006,25620,2557,2986,49498,48259,355,12,270,9.2,8943,3452,5491,7.2,18.5,6464,1813,4651,3.8,13.4,2479,5.1,26.8,0,180,180,1034
2007,25620,2657,3122,51980,50705,380,12.5,254,8.3,9460,3115,6345,6.1,18.7,6909,1603,5306,3.2,13.6,2551,5.1,27.2,0,165,167,876
2008,25620,2672,3167,53471,52618,319,10.2,265,8.4,8014,2407,5607,4.6,15.2,6307,1642,4665,3.1,12,1707,3.2,24,0,208,208,1256
2009,25620,2646,3127,50090,52285,258,8.2,281,9,4776,1796,2980,3.4,9.1,9166,2600,6566,5,17.5,-4390,-8.4,18.2,0,198,198,1054
2010,25620,2613,3095,48757,49093,272,8.8,253,8.2,6079,2452,3627,5,12.4,6750,1287,5463,2.6,13.7,-671,-1.3,24.8,0,171,171,936
2011,25620,2589,3079,49216,48913,262,8.5,266,8.6,6353,1928,4425,3.9,13,5747,2022,3725,4.1,11.7,606,1.3,23.4,0,194,194,1378
2012,25620,2582,3079,48438,48777,256,8.3,261,8.5,5445,1900,3545,3.9,11.2,6123,1463,4660,3,12.6,-678,-1.4,22.4,0,168,168,816
2013,25620,2586,3087,49574,48983,245,8,233,7.6,6061,1767,4294,3.6,12.4,4878,1386,3492,2.8,10,1183,2.4,20,0,159,159,1020
2014,25620,2542,3028,51629,50433,229,7.5,252,8.3,7416,4095,3321,8.1,14.7,5024,1489,3535,3,10,2392,4.7,20,0,185,185,1042
1977,25860,4289,4792,104576,102723,735,15.7,522,11.1,16087,6424,9663,6.3,15.7,12381,5284,7097,5.1,12.1,3706,3.6,24.2,0,357,357,3011
1978,25860,4432,4949,111482,108012,698,14.3,541,11.1,18629,5804,12825,5.4,17.2,11688,5334,6354,4.9,10.8,6941,6.4,21.6,0,392,393,2424
1979,25860,4538,5114,114778,113073,743,14.8,551,11,17136,6856,10280,6.1,15.2,13725,5567,8158,4.9,12.1,3411,3.1,24.2,0,389,389,3039
1980,25860,4525,5099,113357,114005,590,11.6,576,11.3,13655,4678,8977,4.1,12,14951,5986,8965,5.3,13.1,-1296,-1.1,24,0,417,421,3850
1981,25860,4380,4953,113299,113206,566,11.3,679,13.5,14410,6097,8313,5.4,12.7,14223,4703,9520,4.2,12.6,187,0.1,25.2,0,441,442,2472
1982,25860,4430,5061,112303,112740,662,13.2,514,10.3,15374,8881,6493,7.9,13.6,16247,5178,11069,4.6,14.4,-873,-0.8,27.2,0,326,326,2929
1983,25860,4250,4890,111892,111823,496,10,613,12.3,13141,4607,8534,4.1,11.8,13002,5059,7943,4.5,11.6,139,0.2,23.2,0,344,346,2466
1984,25860,4852,5527,123398,117801,831,16,292,5.6,19405,6571,12834,5.6,16.5,8211,2960,5251,2.5,7,11194,9.5,14,1,3,3,
1985,25860,5027,5729,125685,124524,718,12.8,519,9.2,16091,6114,9977,4.9,12.9,13768,4293,9475,3.4,11.1,2323,1.8,22.2,0,342,342,2184
1986,25860,5159,5875,128810,126898,722,12.4,557,9.6,19072,6938,12134,5.5,15,15248,7212,8036,5.7,12,3824,3,24,0,374,374,4665
1987,25860,5303,6118,133457,131325,858,14.3,598,10,19927,6754,13173,5.1,15.2,15662,7478,8184,5.7,11.9,4265,3.3,23.8,0,383,388,2932
1988,25860,5377,6216,139053,135967,706,11.4,596,9.7,20549,7008,13541,5.2,15.1,14377,4903,9474,3.6,10.6,6172,4.5,21.2,0,385,385,2277
1989,25860,5506,6356,143959,142276,735,11.7,597,9.5,18931,6874,12057,4.8,13.3,15565,5187,10378,3.6,10.9,3366,2.4,21.8,0,391,392,3274
1990,25860,5576,6463,145782,144771,720,11.2,572,8.9,17747,6649,11098,4.6,12.3,15725,6164,9561,4.3,10.9,2022,1.4,21.8,0,408,408,2925
1991,25860,5624,6517,139028,141866,698,10.8,644,9.9,14620,5605,9015,4,10.3,20296,6164,14132,4.3,14.3,-5676,-4,20.6,0,416,428,3451
1992,25860,5644,6574,141591,140316,653,10,583,8.9,17498,4909,12589,3.5,12.5,14948,4380,10568,3.1,10.7,2550,1.8,21.4,0,389,391,2356
1993,25860,5690,6628,145183,143648,585,8.9,512,7.8,17810,4736,13074,3.3,12.4,14739,5148,9591,3.6,10.3,3071,2.1,20.6,0,358,358,2890
1994,25860,5761,6733,151833,148413,675,10.1,556,8.3,20982,7602,13380,5.1,14.1,14142,4575,9567,3.1,9.5,6840,4.6,19,0,393,393,2218
1995,25860,5909,6893,158378,155326,696,10.2,524,7.7,20987,7285,13702,4.7,13.5,14882,4915,9967,3.2,9.6,6105,3.9,19.2,0,351,352,2311
1996,25860,6002,7001,155321,156770,724,10.4,620,8.9,17313,7046,10267,4.5,11,20210,7775,12435,5,12.9,-2897,-1.9,22,0,433,433,5820
1997,25860,6121,7147,156750,156038,772,10.9,619,8.7,18499,5034,13465,3.2,11.9,17074,5808,11266,3.7,10.9,1425,1,21.8,0,396,396,3227
1998,25860,6151,7237,157401,157156,775,10.8,666,9.3,18091,5379,12712,3.4,11.5,17601,6897,10704,4.4,11.2,490,0.3,22.4,0,438,438,2504
1999,25860,6220,7342,165630,161994,712,9.8,602,8.3,23165,7460,15705,4.6,14.3,15892,4888,11004,3,9.8,7273,4.5,19.6,0,425,425,2204
2000,25860,6267,7414,167743,166094,724,9.8,651,8.8,23651,8144,15507,4.9,14.2,20352,6679,13673,4,12.3,3299,1.9,24.6,0,413,413,2721
2001,25860,6323,7493,165601,166794,734,9.8,704,9.4,20013,7947,12066,4.8,12,22398,7134,15264,4.3,13.4,-2385,-1.4,24,0,428,428,3091
2002,25860,6302,7467,153154,159138,734,9.8,753,10.1,16746,7524,9222,4.7,10.5,28714,7348,21366,4.6,18,-11968,-7.5,21,0,413,417,2423
2003,25860,6267,7422,149513,150501,696,9.4,617,8.3,16832,5186,11646,3.4,11.2,18808,3857,14951,2.6,12.5,-1976,-1.3,22.4,0,436,436,2085
2004,25860,6288,7416,143257,145182,694,9.4,626,8.5,17036,6313,10723,4.3,11.7,20886,6384,14502,4.4,14.4,-3850,-2.7,23.4,0,425,425,2931
2005,25860,6333,7482,143034,142601,696,9.4,574,7.7,17960,6449,11511,4.5,12.6,17094,4765,12329,3.3,12,866,0.6,24,0,427,427,2968
2006,25860,6298,7484,142213,141549,709,9.5,614,8.2,17316,5897,11419,4.2,12.2,15987,4858,11129,3.4,11.3,1329,0.9,22.6,0,453,453,2792
2007,25860,6382,7578,141194,141503,758,10.1,662,8.8,18243,7013,11230,5,12.9,18861,5567,13294,3.9,13.3,-618,-0.4,25.8,0,439,445,3177
2008,25860,6290,7500,139450,139354,617,8.2,612,8.2,18258,6075,12183,4.4,13.1,18066,4874,13192,3.5,13,192,0.1,26,0,461,461,3596
2009,25860,6019,7219,125453,131983,490,6.7,702,9.6,11138,4130,7008,3.1,8.4,24198,4927,19271,3.7,18.3,-13060,-9.9,16.8,0,511,511,2452
2010,25860,5850,7035,118997,121507,515,7.3,626,8.8,13290,4966,8324,4.1,10.9,18310,4738,13572,3.9,15.1,-5020,-4.2,21.8,0,436,436,2386
2011,25860,5700,6878,122311,120528,478,6.9,593,8.5,14756,5207,9549,4.3,12.2,11189,3531,7658,2.9,9.3,3567,2.9,18.6,0,404,404,2277
2012,25860,5692,6887,121321,121653,568,8.3,574,8.4,14048,4441,9607,3.7,11.5,14712,4740,9972,3.9,12.1,-664,-0.6,23,0,352,357,2149
2013,25860,5669,6855,122333,121563,464,6.8,506,7.4,13424,3161,10263,2.6,11,11884,3225,8659,2.7,9.8,1540,1.2,19.6,0,349,354,2068
2014,25860,5635,6797,121652,120907,517,7.6,518,7.6,14380,4561,9819,3.8,11.9,12889,6348,6541,5.3,10.7,1491,1.2,21.4,0,357,358,3348
1977,25980,256,260,2274,1956,67,27.2,39,15.8,946,663,283,33.9,48.4,309,156,153,8,15.8,637,32.6,31.6,0,30,30,87
1978,25980,268,274,2623,2447,72,27,55,20.6,843,394,449,16.1,34.5,491,231,260,9.4,20.1,352,14.4,40.2,0,39,39,161
1979,25980,290,295,2863,2740,65,22.8,39,13.7,741,270,471,9.9,27,495,168,327,6.1,18.1,246,8.9,36.2,0,32,32,147
1980,25980,301,305,3009,2936,52,17.3,45,15,655,300,355,10.2,22.3,508,221,287,7.5,17.3,147,5,34.6,0,34,34,120
1981,25980,327,337,3778,3314,84,26.3,47,14.7,1567,952,615,28.7,47.3,638,246,392,7.4,19.3,929,28,38.6,0,31,31,137
1982,25980,361,376,4037,3906,91,25.5,50,14,966,542,424,13.9,24.7,703,323,380,8.3,18,263,6.7,36,0,29,29,234
1983,25980,363,379,3652,3840,55,14.6,51,13.5,679,264,415,6.9,17.7,1054,467,587,12.2,27.4,-375,-9.7,35.4,0,40,40,444
1984,25980,370,387,4005,3829,64,16.7,56,14.6,916,370,546,9.7,23.9,563,297,266,7.8,14.7,353,9.2,29.4,0,36,36,125
1985,25980,399,415,4394,4212,72,17.9,48,11.9,931,439,492,10.4,22.1,566,222,344,5.3,13.4,365,8.7,26.8,0,33,33,158
1986,25980,423,443,4602,4493,86,20,53,12.4,1115,707,408,15.7,24.8,897,391,506,8.7,20,218,4.8,40,0,35,35,309
1987,25980,451,470,5274,5113,85,18.6,56,12.3,1090,428,662,8.4,21.3,767,325,442,6.4,15,323,6.3,30,0,39,39,217
1988,25980,459,479,5289,5271,85,18,74,15.6,858,435,423,8.3,16.3,821,370,451,7,15.6,37,0.7,31.2,0,56,56,184
1989,25980,454,474,5659,5404,67,14.1,68,14.3,1232,590,642,10.9,22.8,721,344,377,6.4,13.3,511,9.5,26.6,0,50,50,165
1990,25980,462,480,5858,5719,51,10.7,39,8.2,1061,173,888,3,18.6,783,249,534,4.4,13.7,278,4.9,27.4,0,26,26,182
1991,25980,454,477,5947,5998,66,13.8,72,15,1132,586,546,9.8,18.9,1233,434,799,7.2,20.6,-101,-1.7,37.8,0,42,42,277
1992,25980,492,518,6930,6438,98,19.6,58,11.6,2028,509,1519,7.9,31.5,1044,272,772,4.2,16.2,984,15.3,32.4,0,34,35,156
1993,25980,535,563,6918,6947,100,18.5,55,10.2,944,371,573,5.3,13.6,1001,612,389,8.8,14.4,-57,-0.8,27.2,0,40,40,337
1994,25980,532,565,7229,7056,79,14,69,12.2,1184,456,728,6.5,16.8,838,417,421,5.9,11.9,346,4.9,23.8,0,56,56,320
1995,25980,585,624,7961,7594,108,18.2,54,9.1,1532,776,756,10.2,20.2,798,243,555,3.2,10.5,734,9.7,21,0,40,40,188
1996,25980,595,634,8025,7999,74,11.8,65,10.3,1038,346,692,4.3,13,986,411,575,5.1,12.3,52,0.7,24.6,0,37,37,111
1997,25980,614,661,8050,8039,96,14.8,70,10.8,1616,764,852,9.5,20.1,1594,433,1161,5.4,19.8,22,0.3,39.6,0,52,52,242
1998,25980,609,658,8624,8347,92,13.9,94,14.3,1901,1112,789,13.3,22.8,1346,672,674,8.1,16.1,555,6.7,32.2,0,66,66,411
1999,25980,622,674,9143,8878,99,14.9,80,12,1778,923,855,10.4,20,1247,551,696,6.2,14,531,6,28,0,57,57,328
2000,25980,640,692,9659,9415,100,14.6,90,13.2,1867,935,932,9.9,19.8,1378,513,865,5.4,14.6,489,5.2,29.2,0,57,57,316
2001,25980,629,694,9736,9690,96,13.9,97,14,1736,675,1061,7,17.9,1643,685,958,7.1,17,93,0.9,34,0,53,53,317
2002,25980,635,708,9520,9640,99,14.1,86,12.3,1782,961,821,10,18.5,2021,708,1313,7.3,21,-239,-2.5,37,0,52,52,342
2003,25980,648,719,9925,9630,93,13.2,64,9.1,1571,439,1132,4.6,16.3,980,357,623,3.7,10.2,591,6.1,20.4,0,46,46,160
2004,25980,661,737,10916,10408,94,12.9,67,9.2,2061,870,1191,8.4,19.8,1045,392,653,3.8,10,1016,9.8,20,0,49,49,203
2005,25980,693,777,11275,11088,101,13.4,59,7.8,1993,801,1192,7.2,18,1619,315,1304,2.8,14.6,374,3.4,29.2,0,44,44,200
2006,25980,720,810,10889,10985,114,14.4,71,9,1758,644,1114,5.9,16,1949,826,1123,7.5,17.7,-191,-1.7,32,0,53,53,422
2007,25980,738,825,10689,10760,103,12.6,77,9.4,1973,954,1019,8.9,18.3,2114,705,1409,6.6,19.6,-141,-1.3,36.6,0,48,48,315
2008,25980,721,809,12422,11536,70,8.6,86,10.5,3103,1476,1627,12.8,26.9,1331,499,832,4.3,11.5,1772,15.4,23,0,60,60,342
2009,25980,734,826,13535,12929,93,11.4,71,8.7,2683,773,1910,6,20.8,1471,400,1071,3.1,11.4,1212,9.4,22.8,0,52,54,273
2010,25980,719,814,11882,12553,71,8.7,72,8.8,1552,657,895,5.2,12.4,2893,640,2253,5.1,23,-1341,-10.6,24.8,0,48,48,513
2011,25980,712,811,12332,12099,72,8.9,68,8.4,1675,479,1196,4,13.8,1209,448,761,3.7,10,466,3.8,20,0,50,50,186
2012,25980,744,838,12233,12310,91,11,75,9.1,1664,512,1152,4.2,13.5,1817,940,877,7.6,14.8,-153,-1.3,27,0,43,43,272
2013,25980,725,812,12512,12395,69,8.4,91,11.1,1428,619,809,5,11.5,1194,380,814,3.1,9.6,234,1.9,19.2,0,54,54,293
2014,25980,723,813,12728,12593,73,9,66,8.2,1472,434,1038,3.4,11.7,1201,282,919,2.2,9.5,271,2.2,19,0,44,44,172
1977,26100,2258,2382,37214,35357,351,15.1,227,9.8,7949,3322,4627,9.4,22.5,4234,1823,2411,5.2,12,3715,10.5,24,0,143,143,1296
1978,26100,2408,2545,40699,38966,401,16.3,240,9.7,8555,2767,5788,7.1,22,5088,2891,2197,7.4,13.1,3467,8.9,26.2,0,167,167,1327
1979,26100,2495,2647,45506,43087,367,14.1,250,9.6,9446,3517,5929,8.2,21.9,4607,2053,2554,4.8,10.7,4839,11.2,21.4,0,174,174,900
1980,26100,2503,2664,45462,45426,346,13,307,11.6,8289,3058,5231,6.7,18.2,8217,2439,5778,5.4,18.1,72,0.1,36.2,0,236,236,1451
1981,26100,2427,2589,43046,43423,279,10.6,326,12.4,8104,3510,4594,8.1,18.7,8857,2812,6045,6.5,20.4,-753,-1.7,37.4,0,191,191,1110
1982,26100,2455,2665,40132,41558,356,13.6,256,9.7,5628,2423,3205,5.8,13.5,8480,2580,5900,6.2,20.4,-2852,-6.9,27,0,150,150,840
1983,26100,2570,2795,42281,41228,330,12.1,227,8.3,8099,2645,5454,6.4,19.6,5993,1784,4209,4.3,14.5,2106,5.1,29,0,168,168,922
1984,26100,2708,2932,49544,46333,372,13,247,8.6,11015,3434,7581,7.4,23.8,4592,1781,2811,3.8,9.9,6423,13.9,19.8,0,172,172,969
1985,26100,2812,3029,54903,52549,393,13.2,287,9.6,11468,3298,8170,6.3,21.8,6760,2779,3981,5.3,12.9,4708,8.9,25.8,0,196,196,1801
1986,26100,2891,3116,57345,56159,413,13.4,315,10.3,11231,3079,8152,5.5,20,8859,2843,6016,5.1,15.8,2372,4.2,31.6,0,205,205,1463
1987,26100,3072,3341,59630,58462,534,16.5,299,9.3,11477,5081,6396,8.7,19.6,9140,2138,7002,3.7,15.6,2337,4,31.2,0,204,204,1276
1988,26100,3185,3453,63858,61286,461,13.6,342,10.1,11904,3623,8281,5.9,19.4,6760,2805,3955,4.6,11,5144,8.4,22,0,237,237,1678
1989,26100,3357,3665,68627,66453,531,14.9,325,9.1,11951,3872,8079,5.8,18,7602,3180,4422,4.8,11.4,4349,6.6,22.8,0,215,216,1238
1990,26100,3471,3789,69154,68868,479,12.9,334,9,10240,3853,6387,5.6,14.9,9667,3148,6519,4.6,14,573,0.9,28,0,240,240,1398
1991,26100,3584,3909,67835,68392,482,12.5,352,9.1,9650,4316,5334,6.3,14.1,10763,3529,7234,5.2,15.7,-1113,-1.6,28.2,0,229,231,2192
1992,26100,3700,4059,70319,68877,502,12.6,337,8.4,11164,3322,7842,4.8,16.2,8279,3006,5273,4.4,12,2885,4.2,24,0,232,232,1471
1993,26100,3815,4172,76419,73361,438,10.6,325,7.9,13490,4031,9459,5.5,18.4,7374,2470,4904,3.4,10.1,6116,8.3,20.2,0,215,215,1336
1994,26100,4002,4373,81214,78794,546,12.8,329,7.7,14390,4437,9953,5.6,18.3,9549,2602,6947,3.3,12.1,4841,6.2,24.2,0,239,239,1526
1995,26100,4206,4599,89244,85198,566,12.6,340,7.6,15701,4382,11319,5.1,18.4,7609,2593,5016,3,8.9,8092,9.5,17.8,0,249,250,1948
1996,26100,4301,4713,88219,88679,524,11.3,403,8.7,10422,3486,6936,3.9,11.8,11342,3217,8125,3.6,12.8,-920,-1,23.6,0,271,271,2014
1997,26100,4433,4859,96088,92271,575,12,421,8.8,16333,5375,10958,5.8,17.7,8699,2650,6049,2.9,9.4,7634,8.3,18.8,0,264,264,1279
1998,26100,4513,4972,98684,97252,565,11.5,419,8.5,13496,4494,9002,4.6,13.9,10632,3287,7345,3.4,10.9,2864,3,21.8,0,298,298,2240
1999,26100,4565,5061,103047,101124,532,10.6,441,8.8,14718,4571,10147,4.5,14.6,10872,2795,8077,2.8,10.8,3846,3.8,21.6,0,288,288,1781
2000,26100,4629,5149,106254,104858,534,10.5,454,8.9,16475,4829,11646,4.6,15.7,13683,5640,8043,5.4,13,2792,2.7,26,0,290,290,1845
2001,26100,4676,5215,104213,105400,512,9.9,482,9.3,13011,5059,7952,4.8,12.3,15385,3665,11720,3.5,14.6,-2374,-2.3,24.6,0,273,273,2051
2002,26100,4694,5244,99049,101218,591,11.3,549,10.5,13065,5508,7557,5.4,12.9,17402,5059,12343,5,17.2,-4337,-4.3,25.8,0,285,286,2039
2003,26100,4706,5246,99674,98862,540,10.3,477,9.1,13966,3637,10329,3.7,14.1,12341,4063,8278,4.1,12.5,1625,1.6,25,0,309,310,1592
2004,26100,4789,5328,100038,99668,565,10.7,451,8.5,12849,4391,8458,4.4,12.9,12109,3821,8288,3.8,12.1,740,0.8,24.2,0,280,281,1591
2005,26100,4943,5494,100036,99699,587,10.9,389,7.2,12748,5491,7257,5.5,12.8,12074,2414,9660,2.4,12.1,674,0.7,24.2,0,268,269,1642
2006,26100,4930,5550,99341,99510,626,11.4,523,9.5,14834,5485,9349,5.5,14.9,15171,3347,11824,3.4,15.2,-337,-0.3,29.8,0,361,361,1991
2007,26100,4896,5540,97272,98097,546,9.9,548,9.9,12843,4643,8200,4.7,13.1,14492,4094,10398,4.2,14.8,-1649,-1.7,26.2,0,342,344,1813
2008,26100,4778,5415,95722,95921,427,7.8,499,9.1,11814,4294,7520,4.5,12.3,12211,4451,7760,4.6,12.7,-397,-0.4,24.6,0,341,342,2436
2009,26100,4570,5189,89126,92303,371,7,550,10.4,10160,2509,7651,2.7,11,16513,4169,12344,4.5,17.9,-6353,-6.9,22,0,362,362,2301
2010,26100,4518,5137,84784,86888,392,7.6,415,8.1,9201,2672,6529,3.1,10.6,13408,3985,9423,4.6,15.4,-4207,-4.8,21.2,0,264,264,1688
2011,26100,4463,5101,88117,86204,386,7.6,400,7.8,12157,3152,9005,3.7,14.1,8330,3089,5241,3.6,9.7,3827,4.4,19.4,0,246,246,2044
2012,26100,4510,5147,94011,91026,447,8.7,411,8,14149,3855,10294,4.2,15.5,8179,2832,5347,3.1,9,5970,6.5,18,0,241,242,1596
2013,26100,4547,5185,96809,95327,377,7.3,348,6.7,10576,2900,7676,3,11.1,7612,2477,5135,2.6,8,2964,3.1,16,0,218,218,1753
2014,26100,4639,5295,102467,99550,451,8.6,316,6,13194,3819,9375,3.8,13.3,7360,2965,4395,3,7.4,5834,5.9,14.8,0,208,208,1248
1977,26180,11678,13801,212993,206801,2448,18.2,1721,12.8,45611,22287,23324,10.8,22.1,33226,16328,16898,7.9,16.1,12385,6,32.2,0,1147,1160,8403
1978,26180,12048,14201,223673,218346,2097,15,1692,12.1,45277,16516,28761,7.6,20.7,34622,16429,18193,7.5,15.9,10655,4.8,31.8,0,1095,1104,5939
1979,26180,12571,14843,242237,233329,2304,15.9,1582,10.9,51363,17632,33731,7.6,22,33547,12135,21412,5.2,14.4,17816,7.6,28.8,0,1078,1086,6522
1980,26180,13133,15494,245920,243821,2317,15.3,1616,10.7,43992,18674,25318,7.7,18,39793,13129,26664,5.4,16.3,4199,1.7,32.6,0,1067,1077,7410
1981,26180,13247,15474,246940,245480,2214,14.3,2110,13.6,45243,19739,25504,8,18.4,42322,16735,25587,6.8,17.2,2921,1.2,34.4,0,1259,1286,8425
1982,26180,13416,15953,246342,246811,2440,15.5,1787,11.4,43109,21476,21633,8.7,17.5,44047,14923,29124,6,17.8,-938,-0.3,35,0,1027,1027,6783
1983,26180,13891,16464,248280,247651,2076,12.8,1726,10.7,42130,15977,26153,6.5,17,40872,14790,26082,6,16.5,1258,0.5,33,0,1146,1159,8078
1984,26180,13846,16413,248164,248198,1851,11.3,1905,11.6,38426,13765,24661,5.5,15.5,38494,13581,24913,5.5,15.5,-68,0,31,0,1210,1231,7373
1985,26180,14140,16740,254799,251614,2094,12.6,1736,10.5,41450,15406,26044,6.1,16.5,35080,12503,22577,5,13.9,6370,2.6,27.8,0,1091,1099,5488
1986,26180,14397,17063,268642,261645,2099,12.4,1724,10.2,50588,17458,33130,6.7,19.3,36594,12737,23857,4.9,14,13994,5.3,28,0,1115,1115,5915
1987,26180,14687,17456,280873,275638,2436,14.1,1948,11.3,57643,21631,36012,7.8,20.9,47174,19535,27639,7.1,17.1,10469,3.8,34.2,0,1226,1237,8418
1988,26180,14840,17752,294881,288870,2178,12.4,1875,10.7,51934,18214,33720,6.3,18,39911,14808,25103,5.1,13.8,12023,4.2,27.6,0,1264,1264,6720
1989,26180,14930,18023,310138,302602,2059,11.5,1813,10.1,53019,19230,33789,6.4,17.5,37946,14346,23600,4.7,12.5,15073,5,25,0,1215,1215,7778
1990,26180,15298,18461,324992,317139,2155,11.8,1610,8.8,53066,18187,34879,5.7,16.7,37359,12919,24440,4.1,11.8,15707,4.9,23.6,0,1056,1058,7638
1991,26180,15729,19137,333551,330118,2385,12.7,1715,9.1,55292,22958,32334,7,16.7,48425,13367,35058,4,14.7,6867,2,29.4,0,1094,1106,7120
1992,26180,15620,19186,334109,333568,2085,10.9,1945,10.1,51050,16634,34416,5,15.3,49967,14822,35145,4.4,15,1083,0.3,30,0,1209,1234,7295
1993,26180,15612,19121,324661,329080,1860,9.7,1867,9.8,42401,14979,27422,4.6,12.9,51239,14929,36310,4.5,15.6,-8838,-2.7,25.8,0,1242,1246,7225
1994,26180,15519,19006,318249,321266,1823,9.6,1861,9.8,42238,18014,24224,5.6,13.1,48272,15193,33079,4.7,15,-6034,-1.9,26.2,0,1201,1211,8036
1995,26180,15524,19047,318844,318172,1929,10.1,1817,9.6,42204,18347,23857,5.8,13.3,40860,13698,27162,4.3,12.8,1344,0.5,25.6,0,1246,1251,6076
1996,26180,15527,19011,317749,318721,1881,9.9,1865,9.8,43777,18965,24812,6,13.7,45720,14065,31655,4.4,14.3,-1943,-0.6,27.4,0,1171,1171,6357
1997,26180,15484,18947,314463,316072,1947,10.3,1997,10.5,41212,13979,27233,4.4,13,44429,14287,30142,4.5,14.1,-3217,-1.1,26,0,1203,1203,6479
1998,26180,15382,18744,307841,311095,1810,9.6,1995,10.6,38568,14741,23827,4.7,12.4,45075,15937,29138,5.1,14.5,-6507,-2.1,24.8,0,1246,1246,5987
1999,26180,15203,18522,305229,306383,1707,9.2,1885,10.1,40357,15788,24569,5.2,13.2,42665,13788,28877,4.5,13.9,-2308,-0.7,26.4,0,1175,1175,5981
2000,26180,15295,18599,315028,310189,1778,9.6,1720,9.3,43860,16400,27460,5.3,14.1,34182,14134,20048,4.6,11,9678,3.1,22,0,1026,1026,5383
2001,26180,15439,18836,324616,321330,1820,9.7,1728,9.2,47060,19071,27989,5.9,14.6,40488,15047,25441,4.7,12.6,6572,2,25.2,0,981,983,7708
2002,26180,15532,18917,319243,321905,2159,11.4,2046,10.8,48444,19849,28595,6.2,15,53767,16319,37448,5.1,16.7,-5323,-1.7,30,0,1064,1068,6102
2003,26180,15854,19232,330202,323285,2010,10.6,1416,7.5,49002,15352,33650,4.7,15.2,35168,12421,22747,3.8,10.9,13834,4.3,21.8,0,945,945,6861
2004,26180,16059,19494,335467,332340,1954,10.1,1550,8,43600,14617,28983,4.4,13.1,37345,11376,25969,3.4,11.2,6255,1.9,22.4,0,1027,1027,5876
2005,26180,16317,19842,347091,340910,1921,9.8,1439,7.3,50874,18877,31997,5.5,14.9,38511,12351,26160,3.6,11.3,12363,3.6,22.6,0,981,988,8032
2006,26180,16503,20239,361261,353357,2060,10.3,1505,7.5,52821,18401,34420,5.2,14.9,37012,11162,25850,3.2,10.5,15809,4.4,21,0,1008,1008,7300
2007,26180,16666,20430,367445,363645,2074,10.2,1840,9.1,56369,19335,37034,5.3,15.5,48769,17588,31181,4.8,13.4,7600,2.1,26.8,0,1056,1069,8163
2008,26180,16443,20284,364656,364815,1759,8.7,1682,8.3,44607,14668,29939,4,12.2,44925,11658,33267,3.2,12.3,-318,-0.1,24.4,0,1181,1182,7683
2009,26180,16215,20052,346975,354196,1594,7.9,1730,8.6,35239,13156,22083,3.7,9.9,49680,12656,37024,3.6,14,-14441,-4.1,19.8,0,1169,1169,6665
2010,26180,15919,19783,342437,344201,1532,7.7,1663,8.4,39633,14349,25284,4.2,11.5,43161,13610,29551,4,12.5,-3528,-1,23,0,1072,1072,7897
2011,26180,15669,19575,344861,343004,1573,8,1612,8.2,39336,13343,25993,3.9,11.5,35622,10598,25024,3.1,10.4,3714,1.1,20.8,0,1102,1105,6831
2012,26180,15644,19484,352924,348631,1538,7.9,1612,8.3,42326,12683,29643,3.6,12.1,33739,11185,22554,3.2,9.7,8587,2.4,19.4,0,939,943,4965
2013,26180,15672,19507,360171,355797,1535,7.9,1504,7.7,41567,12871,28696,3.6,11.7,32819,12040,20779,3.4,9.2,8748,2.5,18.4,0,924,929,7083
2014,26180,15558,19472,367559,361556,1570,8.1,1486,7.6,43718,12763,30955,3.5,12.1,31712,8523,23189,2.4,8.8,12006,3.3,17.6,0,1070,1075,5855
1977,26300,1497,1587,19212,18238,286,18.5,202,13,4613,1808,2805,9.9,25.3,2664,1201,1463,6.6,14.6,1949,10.7,29.2,0,149,149,517
1978,26300,1400,1493,20147,19595,227,14.7,294,19.1,4692,1913,2779,9.8,23.9,3587,1586,2001,8.1,18.3,1105,5.6,36.6,0,181,181,941
1979,26300,1532,1624,21918,21051,277,17.8,159,10.2,4833,1714,3119,8.1,23,3098,787,2311,3.7,14.7,1735,8.3,29.4,1,1,1,
1980,26300,1513,1608,23022,22439,214,13.3,219,13.6,4681,1918,2763,8.5,20.9,3515,1314,2201,5.9,15.7,1166,5.2,31.4,0,164,164,697
1981,26300,1504,1593,20551,21214,231,14.5,223,14,3277,1844,1433,8.7,15.4,4602,1606,2996,7.6,21.7,-1325,-6.3,30.8,0,141,141,817
1982,26300,1536,1650,22278,21423,294,18.1,217,13.4,6308,3435,2873,16,29.4,4597,2218,2379,10.4,21.5,1711,7.9,43,0,136,136,1641
1983,26300,1599,1721,21515,21989,250,14.8,191,11.3,3890,1597,2293,7.3,17.7,4838,1143,3695,5.2,22,-948,-4.3,35.4,0,142,142,589
1984,26300,1651,1774,22794,22179,259,14.8,215,12.3,4150,1440,2710,6.5,18.7,2920,1135,1785,5.1,13.2,1230,5.5,26.4,0,147,148,640
1985,26300,1669,1776,23869,23749,253,14.2,255,14.3,4151,1468,2683,6.2,17.5,3913,1802,2111,7.6,16.5,238,1,33,0,180,182,1233
1986,26300,1698,1815,25110,24474,279,15.5,229,12.8,4884,2057,2827,8.4,20,3612,1429,2183,5.8,14.8,1272,5.2,29.6,0,163,163,952
1987,26300,1740,1873,25129,25326,293,15.9,228,12.4,3981,1708,2273,6.7,15.7,4375,1636,2739,6.5,17.3,-394,-1.6,31.4,0,174,174,1253
1988,26300,1635,1768,22248,23025,198,10.9,259,14.3,2912,888,2024,3.9,12.6,4465,2037,2428,8.8,19.4,-1553,-6.8,25.2,0,184,184,1006
1989,26300,1670,1805,23712,22974,237,13.3,200,11.2,5133,2432,2701,10.6,22.3,3656,1354,2302,5.9,15.9,1477,6.4,31.8,0,140,141,836
1990,26300,1701,1840,23636,23479,231,12.7,179,9.8,3717,1350,2367,5.7,15.8,3402,1085,2317,4.6,14.5,315,1.3,29,0,126,126,617
1991,26300,1763,1903,23959,23677,257,13.7,203,10.8,3994,1662,2332,7,16.9,3429,1109,2320,4.7,14.5,565,2.4,29,0,130,134,765
1992,26300,1843,1984,26306,25097,307,15.8,214,11,6092,1649,4443,6.6,24.3,3673,1394,2279,5.6,14.6,2419,9.7,29.2,0,148,148,712
1993,26300,1915,2044,25705,26012,277,13.8,216,10.7,4789,1786,3003,6.9,18.4,5402,3337,2065,12.8,20.8,-613,-2.4,36.8,0,156,156,813
1994,26300,2012,2142,26721,26227,306,14.6,199,9.5,4572,1819,2753,6.9,17.4,3584,1330,2254,5.1,13.7,988,3.7,27.4,0,146,146,795
1995,26300,2039,2172,27020,26848,277,12.8,248,11.5,4662,2097,2565,7.8,17.4,4318,1567,2751,5.8,16.1,344,1.3,32.2,0,189,189,831
1996,26300,2053,2181,28268,27731,254,11.7,236,10.8,4727,1425,3302,5.1,17,3652,1487,2165,5.4,13.2,1075,3.8,26.4,0,171,171,829
1997,26300,2081,2234,29124,28718,310,14,255,11.5,4982,2513,2469,8.8,17.3,4170,1516,2654,5.3,14.5,812,2.8,29,0,185,185,954
1998,26300,2066,2227,30816,29961,286,12.8,284,12.7,5413,2287,3126,7.6,18.1,3703,1592,2111,5.3,12.4,1710,5.7,24.8,0,211,211,1133
1999,26300,2098,2259,30354,30507,302,13.5,260,11.6,4691,2070,2621,6.8,15.4,4997,1779,3218,5.8,16.4,-306,-1,30.8,0,187,187,1010
2000,26300,2060,2236,31079,30719,236,10.5,256,11.4,4505,1516,2989,4.9,14.7,3785,1364,2421,4.4,12.3,720,2.4,24.6,0,174,174,948
2001,26300,2093,2277,31256,31215,267,11.8,249,11,4463,1897,2566,6.1,14.3,4380,1543,2837,4.9,14,83,0.3,28,0,145,145,625
2002,26300,2160,2360,31182,31183,355,15.3,264,11.4,5158,2749,2409,8.8,16.5,5159,1806,3353,5.8,16.5,-1,0,33,0,154,154,703
2003,26300,2166,2381,32064,31430,286,12.1,223,9.5,5068,1867,3201,5.9,16.1,3799,1545,2254,4.9,12.1,1269,4,24.2,0,176,176,824
2004,26300,2191,2400,32208,31730,256,10.7,216,9,4556,1108,3448,3.5,14.4,3600,1214,2386,3.8,11.3,956,3.1,22.6,0,153,153,666
2005,26300,2240,2474,32910,32478,297,12.2,211,8.7,5105,1891,3214,5.8,15.7,4241,1187,3054,3.7,13.1,864,2.6,26.2,0,164,164,896
2006,26300,2254,2497,33690,33223,297,12,240,9.7,5080,1929,3151,5.8,15.3,4145,1263,2882,3.8,12.5,935,2.8,25,0,162,163,853
2007,26300,2306,2550,33391,33310,292,11.6,236,9.4,5090,2092,2998,6.3,15.3,4927,1263,3664,3.8,14.8,163,0.5,29.6,0,164,164,878
2008,26300,2304,2565,33863,33655,255,10,221,8.7,5210,2212,2998,6.6,15.5,4795,1060,3735,3.1,14.2,415,1.3,28.4,0,173,173,866
2009,26300,2220,2476,32248,32741,209,8.3,268,10.7,4252,1820,2432,5.6,13,5238,2142,3096,6.5,16,-986,-3,26,0,202,202,1716
2010,26300,2165,2417,31164,31560,171,7,222,9.1,3186,1169,2017,3.7,10.1,3978,993,2985,3.1,12.6,-792,-2.5,20.2,0,164,164,792
2011,26300,2121,2386,31681,31387,222,9.3,241,10.1,3860,1518,2342,4.8,12.3,3272,1211,2061,3.9,10.4,588,1.9,20.8,0,156,162,922
2012,26300,2138,2418,32771,32221,234,9.7,200,8.3,4404,1354,3050,4.2,13.7,3304,896,2408,2.8,10.3,1100,3.4,20.6,0,127,128,498
2013,26300,2149,2424,32768,32732,190,7.9,187,7.7,3648,1215,2433,3.7,11.1,3575,1110,2465,3.4,10.9,73,0.2,21.8,0,124,124,823
2014,26300,2129,2404,33297,32948,207,8.6,214,8.9,3807,1465,2342,4.4,11.6,3108,851,2257,2.6,9.4,699,2.2,18.8,0,165,166,537
1977,26380,3029,3338,42751,42378,560,16.9,475,14.4,8894,4389,4505,10.4,21,8147,3190,4957,7.5,19.2,747,1.8,38.4,0,363,364,1502
1978,26380,2924,3240,49894,46261,461,14,528,16.1,12904,3509,9395,7.6,27.9,5638,2889,2749,6.2,12.2,7266,15.7,24.4,0,328,328,1517
1979,26380,3184,3507,54231,52111,547,16.2,299,8.9,12301,4205,8096,8.1,23.6,8061,2812,5249,5.4,15.5,4240,8.1,31,1,1,1,
1980,26380,3343,3677,57402,55783,572,15.9,382,10.6,14069,7127,6942,12.8,25.2,10831,4404,6427,7.9,19.4,3238,5.8,38.8,0,289,290,2831
1981,26380,3348,3690,61407,58860,518,14.1,469,12.8,15135,4900,10235,8.3,25.7,10041,3918,6123,6.7,17.1,5094,8.6,34.2,0,307,309,1847
1982,26380,3584,4004,65720,63529,725,18.8,390,10.1,15241,5318,9923,8.4,24,10858,3524,7334,5.5,17.1,4383,6.9,34.2,0,227,228,1882
1983,26380,3506,3917,52553,59101,423,10.7,533,13.5,8205,3369,4836,5.7,13.9,21300,4254,17046,7.2,36,-13095,-22.1,27.8,0,377,378,2391
1984,26380,3443,3886,52978,52772,465,11.9,491,12.6,10691,4723,5968,8.9,20.3,10278,2959,7319,5.6,19.5,413,0.8,39,0,329,330,1540
1985,26380,3430,3851,53395,53766,469,12.1,505,13,10411,4421,5990,8.2,19.4,11152,4407,6745,8.2,20.7,-741,-1.3,38.8,0,327,328,1989
1986,26380,3363,3787,48931,51024,403,10.6,453,11.9,7576,3550,4026,7,14.8,11761,4091,7670,8,23,-4185,-8.2,29.6,0,328,328,2692
1987,26380,3111,3503,42356,45012,386,10.6,635,17.4,8312,3670,4642,8.2,18.5,13623,5522,8101,12.3,30.3,-5311,-11.8,37,0,421,422,2922
1988,26380,3031,3446,44812,43449,432,12.5,461,13.3,10187,3373,6814,7.8,23.4,7460,3307,4153,7.6,17.2,2727,6.2,34.4,0,319,319,1880
1989,26380,3031,3460,45711,45317,382,11.1,388,11.2,9383,3312,6071,7.3,20.7,8595,3933,4662,8.7,19,788,1.7,38,0,266,268,1505
1990,26380,3065,3493,49228,47400,397,11.4,345,9.9,10495,3031,7464,6.4,22.1,6838,2794,4044,5.9,14.4,3657,7.7,28.8,0,256,259,1395
1991,26380,3145,3593,51903,50589,403,11.4,306,8.6,11175,4432,6743,8.8,22.1,8547,2319,6228,4.6,16.9,2628,5.2,33.8,0,223,223,1215
1992,26380,3167,3625,50156,51050,404,11.2,363,10,8388,2753,5635,5.4,16.4,10176,3431,6745,6.7,19.9,-1788,-3.5,32.8,0,247,248,2316
1993,26380,3254,3706,47924,49073,388,10.6,305,8.3,8456,2823,5633,5.8,17.2,10753,3159,7594,6.4,21.9,-2297,-4.7,34.4,0,223,226,1967
1994,26380,3300,3758,51330,49607,426,11.4,354,9.5,10553,2982,7571,6,21.3,7107,2383,4724,4.8,14.3,3446,7,28.6,0,249,251,1727
1995,26380,3360,3813,53386,52149,420,11.1,344,9.1,11651,5146,6505,9.9,22.3,9176,5262,3914,10.1,17.6,2475,4.7,35.2,0,229,233,2672
1996,26380,3393,3854,56023,54750,368,9.6,317,8.3,10529,2604,7925,4.8,19.2,7983,2952,5031,5.4,14.6,2546,4.6,29.2,0,234,234,1757
1997,26380,3474,3960,60789,58425,461,11.8,367,9.4,12183,3112,9071,5.3,20.9,7455,2539,4916,4.3,12.8,4728,8.1,25.6,0,228,228,1107
1998,26380,3582,4086,64865,62759,442,11,301,7.5,13622,4247,9375,6.8,21.7,9409,3028,6381,4.8,15,4213,6.7,30,0,217,217,1720
1999,26380,3620,4127,63712,66022,427,10.4,393,9.6,10026,3779,6247,5.7,15.2,14645,6414,8231,9.7,22.2,-4619,-7,30.4,0,249,249,3984
2000,26380,3605,4132,63494,63616,399,9.7,390,9.4,9711,4145,5566,6.5,15.3,9954,3441,6513,5.4,15.6,-243,-0.3,30.6,0,236,236,2283
2001,26380,3661,4196,67694,65985,422,10.1,391,9.4,11520,4020,7500,6.1,17.5,8102,2897,5205,4.4,12.3,3418,5.2,24.6,0,238,238,1523
2002,26380,3725,4260,66201,66944,492,11.6,424,10,10230,3868,6362,5.8,15.3,11715,3713,8002,5.5,17.5,-1485,-2.2,30.6,0,227,227,1327
2003,26380,3768,4303,69401,67425,420,9.9,301,7.1,11966,4223,7743,6.3,17.7,8013,2132,5881,3.2,11.9,3953,5.8,23.8,0,215,217,1358
2004,26380,3768,4329,69599,69289,411,9.5,347,8.1,10557,2818,7739,4.1,15.2,9936,3039,6897,4.4,14.3,621,0.9,28.6,0,251,251,1849
2005,26380,3756,4312,68717,69045,393,9.1,376,8.7,9680,3577,6103,5.2,14,10336,2460,7876,3.6,15,-656,-1,28,0,253,253,1593
2006,26380,3774,4344,78798,73666,438,10.1,358,8.3,17347,6733,10614,9.1,23.5,7083,2204,4879,3,9.6,10264,13.9,19.2,0,221,221,1245
2007,26380,3861,4468,82550,80521,475,10.8,357,8.1,15634,5560,10074,6.9,19.4,11575,4417,7158,5.5,14.4,4059,5,28.8,0,235,235,3566
2008,26380,3929,4557,85550,84040,417,9.3,307,6.8,12223,3909,8314,4.7,14.5,9202,2077,7125,2.5,10.9,3021,3.6,21.8,0,218,218,1533
2009,26380,3916,4537,84577,84955,386,8.5,383,8.4,11640,3865,7775,4.5,13.7,12396,4507,7889,5.3,14.6,-756,-0.9,27.4,0,276,276,3506
2010,26380,3890,4522,80545,82379,366,8.1,351,7.8,10521,4637,5884,5.6,12.8,14188,3252,10936,3.9,17.2,-3667,-4.4,25.6,0,248,248,1586
2011,26380,3790,4449,80763,80551,309,6.9,354,7.9,9704,2854,6850,3.5,12,9280,2444,6836,3,11.5,424,0.5,23,0,250,251,1614
2012,26380,3837,4497,82336,81406,353,7.9,308,6.9,11791,3210,8581,3.9,14.5,9933,2061,7872,2.5,12.2,1858,2.3,24.4,0,187,188,1392
2013,26380,3846,4497,84745,83540,290,6.5,294,6.6,11319,2039,9280,2.4,13.5,8909,2367,6542,2.8,10.7,2410,2.8,21.4,0,174,174,1648
2014,26380,3800,4466,89534,87035,359,8,369,8.3,15164,4654,10510,5.3,17.4,10166,2947,7219,3.4,11.7,4998,5.7,23.4,0,249,249,1515
1977,26420,45327,55207,1058326,1018672,11406,21.5,6899,13,251074,114749,136325,11.3,24.6,171766,60595,111171,5.9,16.9,79308,7.7,33.8,0,4833,4861,36618
1978,26420,43550,53860,1130861,1091325,9514,17.4,10058,18.4,272535,88821,183714,8.1,25,193463,92974,100489,8.5,17.7,79072,7.3,35.4,0,5813,5833,43787
1979,26420,50051,61268,1276927,1206999,11718,20.4,4864,8.4,320784,122287,198497,10.1,26.6,180927,49893,131034,4.1,15,139857,11.6,30,0,67,85,1375
1980,26420,35712,47433,1216743,1223665,2997,5.5,10301,19,224587,60071,164516,4.9,18.4,238430,98711,139719,8.1,19.5,-13843,-1.1,36.8,0,7924,7961,54838
1981,26420,52570,64563,1428837,1362057,13793,24.7,6146,11,325903,155983,169920,11.5,23.9,192343,71572,120771,5.3,14.1,133560,9.8,28.2,0,2996,3015,26707
1982,26420,57167,71219,1542177,1482560,14531,21.4,7529,11.1,385787,174444,211343,11.8,26,266555,86442,180113,5.8,18,119232,8,36,0,4500,4502,38220
1983,26420,58957,73196,1406292,1465855,11638,16.1,9716,13.5,273752,116562,157190,8,18.7,392878,102562,290316,7,26.8,-119126,-8.1,37.4,0,6502,6567,47607
1984,26420,58185,72956,1413869,1409644,10617,14.5,10745,14.7,291713,124984,166729,8.9,20.7,283263,100653,182610,7.1,20.1,8450,0.6,40.2,0,6945,6972,46422
1985,26420,60602,75682,1403455,1407087,11940,16.1,9222,12.4,280617,127456,153161,9.1,19.9,287880,97148,190732,6.9,20.5,-7263,-0.6,39.8,0,5384,5427,39323
1986,26420,60850,75782,1374463,1388383,11640,15.4,11249,14.9,261973,111069,150904,8,18.9,289813,108707,181106,7.8,20.9,-27840,-2,37.8,0,7282,7304,51797
1987,26420,59275,74267,1323984,1357527,11636,15.5,12520,16.7,257691,116659,141032,8.6,19,324776,134796,189980,9.9,23.9,-67085,-4.9,38,0,7960,8057,57634
1988,26420,58920,73930,1345658,1329923,10806,14.6,10785,14.6,295570,113088,182482,8.5,22.2,264099,106550,157549,8,19.9,31471,2.3,39.8,0,7012,7012,45515
1989,26420,59588,74731,1450041,1400141,10414,14,9656,13,342497,124996,217501,8.9,24.5,242697,104663,138034,7.5,17.3,99800,7.2,34.6,0,6243,6309,56016
1990,26420,61475,76851,1522488,1485941,10978,14.5,8449,11.2,314358,116052,198306,7.8,21.2,241263,99294,141969,6.7,16.2,73095,5,32.4,0,5443,5514,43763
1991,26420,64213,80214,1571556,1548027,12093,15.4,8758,11.2,308730,118768,189962,7.7,19.9,261673,97971,163702,6.3,16.9,47057,3,33.8,0,5392,5442,45741
1992,26420,66075,82334,1580388,1573495,12112,14.9,9680,11.9,310708,118851,191857,7.6,19.7,296922,112426,184496,7.1,18.9,13786,0.8,37.8,0,5966,6082,55501
1993,26420,67666,83464,1594185,1587183,11240,13.6,9888,11.9,310012,105993,204019,6.7,19.5,296008,102996,193012,6.5,18.6,14004,0.9,37.2,0,6384,6418,47263
1994,26420,69135,85194,1588885,1589711,11898,14.1,9788,11.6,284526,110496,174030,7,17.9,286180,102483,183697,6.4,18,-1654,-0.1,35.8,0,6422,6443,43721
1995,26420,70556,86993,1654777,1621836,11897,13.8,9679,11.2,314302,124096,190206,7.7,19.4,248421,88733,159688,5.5,15.3,65881,4.1,30.6,0,6419,6443,45704
1996,26420,72322,88986,1698370,1678129,12187,13.9,10004,11.4,309706,118411,191295,7.1,18.5,269225,98333,170892,5.9,16,40481,2.5,32,0,6496,6496,45900
1997,26420,73450,90709,1757611,1730272,12759,14.2,11068,12.3,364458,138564,225894,8,21.1,309781,130033,179748,7.5,17.9,54677,3.2,35.8,0,6761,6761,55933
1998,26420,74546,92667,1869467,1812793,12518,13.7,10335,11.3,402836,152604,250232,8.4,22.2,289489,112837,176652,6.2,16,113347,6.2,32,0,6691,6692,53529
1999,26420,75198,94088,1911802,1897690,12236,13.1,10681,11.4,362276,129885,232391,6.8,19.1,334052,133102,200950,7,17.6,28224,1.5,35.2,0,6759,6759,52822
2000,26420,75423,94790,1960357,1933795,11859,12.6,11165,11.8,384114,144004,240110,7.4,19.9,330989,136528,194461,7.1,17.1,53125,2.8,34.2,0,6707,6707,56018
2001,26420,76572,97079,2000590,1983744,12434,12.9,11100,11.5,365705,147391,218314,7.4,18.4,332012,133668,198344,6.7,16.7,33693,1.7,33.4,0,6496,6498,46840
2002,26420,77897,98418,1994865,1985697,13539,13.9,12064,12.4,396589,173098,223491,8.7,20,378254,140706,237548,7.1,19,18335,1,38,0,6385,6393,44627
2003,26420,79015,99525,2005930,1987173,13513,13.7,10314,10.5,366205,151412,214793,7.6,18.4,328692,126092,202600,6.3,16.5,37513,1.9,33,0,6809,6832,60480
2004,26420,80010,100703,2016922,2004092,12799,12.8,10395,10.4,343790,142807,200983,7.1,17.2,318129,111371,206758,5.6,15.9,25661,1.3,31.8,0,6954,6967,53609
2005,26420,81282,102912,2055455,2029766,13489,13.3,10055,9.9,347602,144839,202763,7.1,17.1,296223,102377,193846,5,14.6,51379,2.5,29.2,0,6989,6996,61486
2006,26420,82776,105349,2193858,2119690,13771,13.3,10438,10,414208,150470,263738,7.1,19.5,265871,102225,163646,4.8,12.5,148337,7,25,0,6896,6937,53744
2007,26420,84917,108406,2313888,2250044,14318,13.4,10925,10.2,466071,154394,311677,6.9,20.7,338384,135726,202658,6,15,127687,5.7,30,0,6903,6944,59904
2008,26420,85665,109757,2346521,2322260,12983,12,10307,9.5,400193,138878,261315,6,17.2,351671,111583,240088,4.8,15.1,48522,2.1,30.2,0,7291,7294,60998
2009,26420,85178,109741,2307324,2320237,11871,10.8,10999,10,335103,122872,212231,5.3,14.4,360928,95338,265590,4.1,15.6,-25825,-1.2,28.8,0,7475,7535,51646
2010,26420,85660,110333,2245191,2271614,11703,10.7,10332,9.4,301392,115286,186106,5.1,13.3,354237,102964,251273,4.5,15.6,-52845,-2.3,26.6,0,6915,6935,56725
2011,26420,86076,111363,2286211,2262612,12144,11,10388,9.4,331986,112045,219941,5,14.7,284788,90995,193793,4,12.6,47198,2.1,25.2,0,7020,7052,55758
2012,26420,88301,114153,2415332,2349422,13115,11.7,10281,9.1,408744,138173,270571,5.9,17.4,276923,90504,186419,3.9,11.8,131821,5.6,23.6,0,6349,6396,45328
2013,26420,90732,116711,2531447,2470026,12639,11,10129,8.8,422497,126894,295603,5.1,17.1,299655,105773,193882,4.3,12.1,122842,5,24.2,0,6454,6485,52999
2014,26420,92615,119333,2580972,2548632,13743,11.7,10269,8.7,384904,130498,254406,5.1,15.1,320224,92282,227942,3.6,12.6,64680,2.5,25.2,0,7081,7114,49890
1977,26580,4475,5026,79763,77794,769,15.5,623,12.6,13401,5935,7466,7.6,17.2,9462,3066,6396,3.9,12.2,3939,5,24.4,0,378,381,1718
1978,26580,4560,5134,79589,79494,755,14.9,650,12.8,12473,4627,7846,5.8,15.7,12283,5146,7137,6.5,15.5,190,0.2,31,0,426,426,2066
1979,26580,4553,5140,86585,83043,704,13.7,675,13.1,16695,5113,11582,6.2,20.1,9611,4515,5096,5.4,11.6,7084,8.5,23.2,0,450,451,1852
1980,26580,4569,5144,81760,84111,630,12.3,596,11.6,10155,4169,5986,5,12.1,14857,3762,11095,4.5,17.7,-4702,-5.6,24.2,0,403,403,2055
1981,26580,4394,5007,76720,77721,624,12.3,695,13.7,13858,6208,7650,8,17.8,15860,5473,10387,7,20.4,-2002,-2.6,35.6,0,430,431,2512
1982,26580,4293,4937,75351,76002,642,12.9,660,13.3,12065,6678,5387,8.8,15.9,13367,4235,9132,5.6,17.6,-1302,-1.7,31.8,0,365,365,1677
1983,26580,4331,4939,70236,72900,528,10.7,575,11.6,8978,3427,5551,4.7,12.3,14306,4307,9999,5.9,19.6,-5328,-7.3,24.6,0,357,357,1851
1984,26580,4266,4828,70534,70283,618,12.7,703,14.4,11811,4205,7606,6,16.8,11308,5557,5751,7.9,16.1,503,0.7,32.2,0,367,370,2603
1985,26580,4464,5024,71930,71711,586,11.9,439,8.9,9736,3676,6060,5.1,13.6,9298,3696,5602,5.2,13,438,0.6,26,0,186,186,809
1986,26580,4540,5087,73802,73061,569,11.3,518,10.2,11251,4768,6483,6.5,15.4,9768,3884,5884,5.3,13.4,1483,2,26.8,0,344,344,2711
1987,26580,4593,5196,76683,75495,707,13.7,566,11,13420,4833,8587,6.4,17.8,11044,5095,5949,6.7,14.6,2376,3.2,29.2,0,362,363,2635
1988,26580,4552,5161,76040,75896,542,10.5,532,10.3,11063,3792,7271,5,14.6,10775,4484,6291,5.9,14.2,288,0.4,28.4,0,357,357,2964
1989,26580,4596,5242,81750,79497,571,11,496,9.5,13465,5628,7837,7.1,16.9,8959,2949,6010,3.7,11.3,4506,5.6,22.6,0,342,342,1771
1990,26580,4675,5373,85784,83705,646,12.2,483,9.1,14378,5053,9325,6,17.2,10220,4748,5472,5.7,12.2,4158,5,24.4,0,340,340,2584
1991,26580,4756,5515,83356,83860,656,12,519,9.5,12033,5967,6066,7.1,14.3,13040,3871,9169,4.6,15.5,-1007,-1.2,28.6,0,362,365,2813
1992,26580,4758,5514,83177,83277,590,10.7,560,10.1,10883,3214,7669,3.9,13.1,11083,4013,7070,4.8,13.3,-200,-0.2,26.2,0,359,361,2305
1993,26580,4783,5552,83050,83181,514,9.3,485,8.8,10881,3400,7481,4.1,13.1,11143,2911,8232,3.5,13.4,-262,-0.3,26.2,0,342,343,1641
1994,26580,4809,5592,84142,83693,519,9.3,471,8.5,12025,4186,7839,5,14.4,11127,4892,6235,5.8,13.3,898,1.1,26.6,0,305,305,2037
1995,26580,4920,5714,86794,85422,600,10.6,452,8,13190,4980,8210,5.8,15.4,10446,3673,6773,4.3,12.2,2744,3.2,24.4,0,298,299,1780
1996,26580,4918,5743,88557,88355,579,10.1,538,9.4,12416,5225,7191,5.9,14.1,12012,3578,8434,4,13.6,404,0.5,27.2,0,353,353,1832
1997,26580,4978,5852,89046,88934,641,11,547,9.4,12912,4741,8171,5.3,14.5,12687,4014,8673,4.5,14.3,225,0.2,28.6,0,330,330,2144
1998,26580,4982,5916,91888,90381,577,9.8,487,8.3,14018,5830,8188,6.5,15.5,11003,3345,7658,3.7,12.2,3015,3.3,24.4,0,329,329,1477
1999,26580,4865,5801,91980,92356,487,8.3,595,10.2,12335,5106,7229,5.5,13.4,13087,4274,8813,4.6,14.2,-752,-0.8,26.8,0,361,361,1730
2000,26580,4834,5797,92785,92292,590,10.2,589,10.2,13028,5182,7846,5.6,14.1,12041,3637,8404,3.9,13,987,1.1,26,0,362,362,1648
2001,26580,4779,5781,92246,92677,535,9.2,590,10.2,13409,5041,8368,5.4,14.5,14270,5915,8355,6.4,15.4,-861,-0.9,29,0,345,345,2033
2002,26580,4755,5764,92502,92382,576,10,595,10.3,13541,4507,9034,4.9,14.7,13300,4609,8691,5,14.4,241,0.3,28.8,0,319,321,2112
2003,26580,4665,5674,93298,92282,495,8.7,460,8.1,13070,4410,8660,4.8,14.2,11038,2885,8153,3.1,12,2032,2.2,24,0,309,309,1423
2004,26580,4682,5715,92905,92511,509,9,412,7.3,12120,3586,8534,3.9,13.1,11331,3210,8121,3.5,12.2,789,0.9,24.4,0,293,293,1719
2005,26580,4691,5742,95587,94022,532,9.3,448,7.8,14513,4712,9801,5,15.4,11382,3233,8149,3.4,12.1,3131,3.3,24.2,0,294,294,1683
2006,26580,4634,5715,95930,95494,515,9,489,8.6,13061,4162,8899,4.4,13.7,12188,3622,8566,3.8,12.8,873,0.9,25.6,0,332,332,2676
2007,26580,4617,5696,96426,95797,523,9.2,529,9.3,14996,5103,9893,5.3,15.7,13738,3959,9779,4.1,14.3,1258,1.4,28.6,0,327,331,2136
2008,26580,4535,5646,97599,96717,455,8.1,450,8,12567,3625,8942,3.7,13,10802,2962,7840,3.1,11.2,1765,1.8,22.4,0,321,321,1896
2009,26580,4438,5550,96795,96894,375,6.7,425,7.6,11532,3969,7563,4.1,11.9,11729,2806,8923,2.9,12.1,-197,-0.2,23.8,0,285,285,1471
2010,26580,4286,5445,93271,94763,345,6.3,415,7.6,10266,3339,6927,3.5,10.8,13250,2916,10334,3.1,14,-2984,-3.2,21.6,0,286,286,2094
2011,26580,4169,5333,91966,92333,383,7.1,437,8.1,9971,2942,7029,3.2,10.8,10705,2926,7779,3.2,11.6,-734,-0.8,21.6,0,293,293,1984
2012,26580,4173,5357,91976,91871,392,7.3,370,6.9,9876,2477,7399,2.7,10.7,9666,2659,7007,2.9,10.5,210,0.2,21,0,247,247,1328
2013,26580,4147,5343,92295,92142,367,6.9,389,7.3,10279,3251,7028,3.5,11.2,9972,2840,7132,3.1,10.8,307,0.4,21.6,0,245,246,1930
2014,26580,4114,5303,93840,92742,395,7.5,388,7.3,11242,3698,7544,4,12.1,9046,2782,6264,3,9.8,2196,2.3,19.6,0,265,269,1671
1977,26620,3419,3798,59655,57828,692,18.6,504,13.6,12993,5954,7039,10.3,22.5,9339,3876,5463,6.7,16.1,3654,6.4,32.2,0,336,339,2679
1978,26620,3553,3948,68136,63901,610,15.8,465,12,15400,4537,10863,7.1,24.1,6929,3079,3850,4.8,10.8,8471,13.3,21.6,0,336,336,1647
1979,26620,3596,4012,67420,67580,603,15.2,491,12.3,12405,4364,8041,6.5,18.4,12725,6278,6447,9.3,18.8,-320,-0.4,36.8,0,365,369,2103
1980,26620,3574,3999,68068,67767,528,13.2,522,13,11221,3948,7273,5.8,16.6,10618,3404,7214,5,15.7,603,0.9,31.4,0,371,371,2064
1981,26620,3509,3927,63424,65273,517,13.1,552,13.9,9821,3665,6156,5.6,15,13518,5864,7654,9,20.7,-3697,-5.7,30,0,340,341,1959
1982,26620,3554,4029,65070,64434,572,14.4,444,11.1,11447,5445,6002,8.5,17.8,10174,3076,7098,4.8,15.8,1273,2,31.6,0,247,247,1298
1983,26620,3707,4189,67684,66090,552,13.4,412,10,12668,4683,7985,7.1,19.2,9480,2857,6623,4.3,14.3,3188,4.9,28.6,0,259,263,1330
1984,26620,3914,4399,81731,75597,687,16,477,11.1,21065,9372,11693,12.4,27.9,8797,3965,4832,5.2,11.6,12268,16.3,23.2,0,299,299,1568
1985,26620,4109,4657,89745,86106,764,16.9,505,11.1,17749,6962,10787,8.1,20.6,10470,3664,6806,4.3,12.2,7279,8.4,24.4,0,319,321,2042
1986,26620,4433,4997,98761,94188,873,18.1,512,10.6,20833,9477,11356,10.1,22.1,11686,4326,7360,4.6,12.4,9147,9.7,24.8,0,302,302,1831
1987,26620,4691,5291,99701,99151,902,17.5,584,11.3,17807,6959,10848,7,18,16706,5233,11473,5.3,16.8,1101,1.2,33.6,0,359,363,2030
1988,26620,4827,5464,104150,101644,866,16.1,663,12.3,19645,9333,10312,9.2,19.3,14633,5559,9074,5.5,14.4,5012,4.9,28.8,0,416,416,2870
1989,26620,4962,5679,114189,109709,854,15.3,642,11.5,21961,8322,13639,7.6,20,13001,4707,8294,4.3,11.9,8960,8.1,23.8,0,454,454,2772
1990,26620,5088,5809,116363,115143,787,13.7,601,10.5,17862,5985,11877,5.2,15.5,15421,5477,9944,4.8,13.4,2441,2.1,26.8,0,405,405,2198
1991,26620,5211,5959,118227,116241,737,12.5,606,10.3,21495,6403,15092,5.5,18.5,17523,4317,13206,3.7,15.1,3972,3.4,30.2,0,372,372,2323
1992,26620,5411,6199,121913,119968,870,14.3,600,9.8,22174,9126,13048,7.6,18.5,18283,5530,12753,4.6,15.2,3891,3.3,30.4,0,390,395,2630
1993,26620,5509,6278,122855,122309,738,11.8,645,10.3,16050,4564,11486,3.7,13.1,14958,4573,10385,3.7,12.2,1092,0.9,24.4,0,429,429,2253
1994,26620,5705,6470,122673,122658,857,13.4,647,10.2,16496,6467,10029,5.3,13.4,16466,4802,11664,3.9,13.4,30,0,26.8,0,408,409,2220
1995,26620,5864,6667,123904,123296,929,14.2,700,10.7,20497,8638,11859,7,16.6,19281,6902,12379,5.6,15.6,1216,1,31.2,0,454,456,2466
1996,26620,5986,6835,129145,126357,912,13.5,706,10.5,21669,6976,14693,5.5,17.1,16092,4652,11440,3.7,12.7,5577,4.4,25.4,0,491,491,2795
1997,26620,6136,7063,129070,129481,996,14.3,795,11.4,21471,7652,13819,5.9,16.6,22293,8320,13973,6.4,17.2,-822,-0.6,33.2,0,511,511,2893
1998,26620,6285,7221,128328,128802,944,13.2,768,10.8,21167,7665,13502,6,16.4,22114,9371,12743,7.3,17.2,-947,-0.8,32.8,0,507,507,2865
1999,26620,6282,7266,136090,134477,839,11.6,791,10.9,23418,10401,13017,7.7,17.4,20192,6562,13630,4.9,15,3226,2.4,30,0,524,524,2816
2000,26620,6357,7385,142743,139535,881,12,765,10.4,24652,9206,15446,6.6,17.7,18236,7877,10359,5.6,13.1,6416,4.6,26.2,0,469,469,2482
2001,26620,6362,7423,146393,144877,846,11.4,855,11.5,23015,8336,14679,5.8,15.9,19982,6375,13607,4.4,13.8,3033,2.1,27.6,0,493,493,2938
2002,26620,6428,7560,143652,144562,990,13.2,842,11.2,23093,8779,14314,6.1,16,24912,8046,16866,5.6,17.2,-1819,-1.2,32,0,467,467,2547
2003,26620,6537,7736,146639,144104,985,13,676,8.9,23281,7461,15820,5.2,16.2,18211,4739,13472,3.3,12.6,5070,3.6,25.2,0,472,472,3137
2004,26620,6651,7870,151088,148005,925,11.9,725,9.3,25532,8338,17194,5.6,17.3,19365,8077,11288,5.5,13.1,6167,4.2,26.2,0,491,491,4854
2005,26620,6758,8003,154661,152166,923,11.7,700,8.8,24593,8728,15865,5.7,16.2,19603,5485,14118,3.6,12.9,4990,3.3,25.8,0,479,479,2687
2006,26620,6890,8217,161774,157917,1051,13,762,9.4,27226,11271,15955,7.1,17.2,19511,6450,13061,4.1,12.4,7715,4.8,24.8,0,509,509,3764
2007,26620,7139,8575,165642,163503,1115,13.3,753,9,29641,10146,19495,6.2,18.1,25363,8464,16899,5.2,15.5,4278,2.6,31,0,463,465,2802
2008,26620,7247,8681,175014,169726,997,11.6,805,9.4,30490,11172,19318,6.6,18,19913,6130,13783,3.6,11.7,10577,6.3,23.4,0,564,564,2942
2009,26620,7196,8661,169993,171772,879,10.2,837,9.7,19279,6754,12525,3.9,11.2,22836,5833,17003,3.4,13.3,-3557,-2.1,22.4,0,590,592,3418
2010,26620,7089,8599,166648,167864,762,8.9,760,8.8,20710,6970,13740,4.2,12.3,23142,6461,16681,3.8,13.8,-2432,-1.5,24.6,0,516,516,3047
2011,26620,6966,8504,165952,165488,777,9.1,809,9.5,19890,6126,13764,3.7,12,18961,4465,14496,2.7,11.5,929,0.5,23,0,549,549,2811
2012,26620,7017,8569,169032,167261,832,9.8,744,8.7,24584,7921,16663,4.7,14.7,21041,6431,14610,3.8,12.6,3543,2.1,25.2,0,447,453,2973
2013,26620,7047,8671,172752,170713,801,9.3,686,8,23443,6968,16475,4.1,13.7,19365,4897,14468,2.9,11.3,4078,2.4,22.6,0,439,439,2920
2014,26620,7047,8713,170611,170971,786,9.1,662,7.7,23236,9722,13514,5.7,13.6,23956,7211,16745,4.2,14,-720,-0.4,27.2,0,479,479,4367
1977,26820,1500,1596,34120,27774,293,19,192,12.4,16050,2445,13605,8.8,57.8,3357,1233,2124,4.4,12.1,12693,45.7,24.2,0,117,117,687
1978,26820,1495,1584,25953,30005,239,15,238,15,5582,1977,3605,6.6,18.6,13685,1826,11859,6.1,45.6,-8103,-27,37.2,0,135,135,910
1979,26820,1575,1674,25850,26299,231,14.2,150,9.2,3444,1483,1961,5.6,13.1,4342,1227,3115,4.7,16.5,-898,-3.4,26.2,0,,,
1980,26820,1549,1650,28692,27194,210,12.6,217,13.1,7469,2362,5107,8.7,27.5,4473,2069,2404,7.6,16.4,2996,11.1,32.8,0,146,146,788
1981,26820,1497,1592,25644,27125,188,11.6,228,14.1,3862,1438,2424,5.3,14.2,6824,1748,5076,6.4,25.2,-2962,-11,28.4,0,136,136,614
1982,26820,1537,1645,24808,25188,243,15,181,11.2,3514,1593,1921,6.3,14,4273,1152,3121,4.6,17,-759,-3,28,0,95,95,485
1983,26820,1594,1708,25769,25234,226,13.5,172,10.3,4289,1533,2756,6.1,17,3218,965,2253,3.8,12.8,1071,4.2,25.6,0,118,119,728
1984,26820,1620,1742,26239,26008,228,13.2,191,11.1,4065,1590,2475,6.1,15.6,3603,1113,2490,4.3,13.9,462,1.7,27.8,0,138,138,784
1985,26820,1659,1790,28012,27115,246,13.9,198,11.2,5158,1827,3331,6.7,19,3363,1281,2082,4.7,12.4,1795,6.6,24.8,0,143,143,801
1986,26820,1708,1843,28920,28443,232,12.8,172,9.5,4846,1407,3439,4.9,17,3892,1048,2844,3.7,13.7,954,3.3,27.4,0,112,112,498
1987,26820,1757,1884,26974,27425,260,13.9,209,11.2,4243,1903,2340,6.9,15.5,5144,2081,3063,7.6,18.8,-901,-3.3,31,0,104,105,941
1988,26820,1737,1867,28411,27637,206,11,203,10.8,5587,2826,2761,10.2,20.2,4039,1542,2497,5.6,14.6,1548,5.6,29.2,0,127,127,800
1989,26820,1734,1875,30379,29427,227,12.1,230,12.3,6263,2173,4090,7.4,21.3,4358,2193,2165,7.5,14.8,1905,6.5,29.6,0,155,158,1099
1990,26820,1820,1961,31619,30979,277,14.4,180,9.4,5251,1583,3668,5.1,17,3971,1458,2513,4.7,12.8,1280,4.2,25.6,0,129,130,1023
1991,26820,1855,2011,33535,32531,243,12.3,187,9.4,5868,1879,3989,5.8,18,3859,1422,2437,4.4,11.9,2009,6.1,23.8,0,109,109,698
1992,26820,1908,2071,35425,34491,245,12,176,8.6,5819,1737,4082,5,16.9,3950,1587,2363,4.6,11.5,1869,5.4,23,0,93,94,648
1993,26820,1970,2132,36483,35930,275,13.1,205,9.8,5291,2150,3141,6,14.7,4184,1332,2852,3.7,11.6,1107,3.1,23.2,0,147,147,946
1994,26820,2038,2194,36443,36460,265,12.3,193,8.9,4941,1949,2992,5.3,13.6,4974,1931,3043,5.3,13.6,-33,0,27.2,0,125,125,1310
1995,26820,2081,2243,32118,34268,261,11.8,201,9.1,4777,1892,2885,5.5,13.9,9076,6400,2676,18.7,26.5,-4299,-12.6,27.8,0,129,129,617
1996,26820,2193,2358,35938,34014,321,14,206,9,9937,2378,7559,7,29.2,6089,2912,3177,8.6,17.9,3848,11.3,35.8,0,139,139,768
1997,26820,2266,2434,38184,37051,361,15,279,11.6,7136,2674,4462,7.2,19.3,4869,1895,2974,5.1,13.1,2267,6.2,26.2,0,158,158,1062
1998,26820,2289,2462,38381,38290,317,12.9,287,11.7,5421,2304,3117,6,14.2,5239,1581,3658,4.1,13.7,182,0.5,27.4,0,189,189,953
1999,26820,2368,2556,38868,38620,352,14,252,10,5876,2301,3575,6,15.2,5380,2891,2489,7.5,13.9,496,1.3,27.8,0,178,178,1019
2000,26820,2403,2594,33974,36425,340,13.2,306,11.9,6754,2932,3822,8,18.5,11656,1799,9857,4.9,32,-4902,-13.5,37,0,192,192,1087
2001,26820,2432,2634,40831,37516,339,12.9,318,12.1,11946,8513,3433,22.7,31.8,5315,1784,3531,4.8,14.2,6631,17.6,28.4,0,173,173,991
2002,26820,2488,2678,42153,41390,382,14.4,329,12.4,7446,2650,4796,6.4,18,5920,2084,3836,5,14.3,1526,3.7,28.6,0,191,191,1144
2003,26820,2595,2794,43696,42787,398,14.6,239,8.8,6815,2531,4284,5.9,15.9,4997,1702,3295,4,11.7,1818,4.2,23.4,0,163,164,881
2004,26820,2719,2932,46681,45100,428,15,263,9.2,7285,2654,4631,5.9,16.2,4123,1375,2748,3,9.1,3162,7.1,18.2,0,168,168,887
2005,26820,2804,3032,47406,46960,424,14.3,294,9.9,12752,8473,4279,18,27.2,11859,8439,3420,18,25.3,893,1.9,50.6,0,216,216,1903
2006,26820,2899,3152,50990,49170,448,14.5,315,10.2,9548,4457,5091,9.1,19.4,5907,2571,3336,5.2,12,3641,7.4,24,0,217,217,1915
2007,26820,3055,3331,51726,51292,490,15.1,322,9.9,8632,4100,4532,8,16.8,7764,3093,4671,6,15.1,868,1.7,30.2,0,220,221,1250
2008,26820,3130,3431,51409,51454,443,13.1,325,9.6,7415,2564,4851,5,14.4,7505,2037,5468,4,14.6,-90,-0.2,28.8,0,238,238,1468
2009,26820,3024,3315,47364,49217,301,8.9,380,11.3,4410,1548,2862,3.1,9,8116,1757,6359,3.6,16.5,-3706,-7.5,18,0,261,261,1283
2010,26820,2937,3222,46039,46572,294,9,366,11.2,5553,2133,3420,4.6,11.9,6619,1804,4815,3.9,14.2,-1066,-2.3,23.8,0,237,237,1065
2011,26820,2888,3175,46299,46018,331,10.4,342,10.7,6109,2149,3960,4.7,13.3,5547,1449,4098,3.1,12.1,562,1.2,24.2,0,226,226,983
2012,26820,2940,3221,46177,46237,350,11,306,9.6,6540,2167,4373,4.7,14.1,6659,2698,3961,5.8,14.4,-119,-0.3,28.2,0,187,187,898
2013,26820,2953,3237,47399,46756,313,9.7,305,9.5,6458,1642,4816,3.5,13.8,5172,1699,3473,3.6,11.1,1286,2.7,22.2,0,207,207,1278
2014,26820,3010,3301,48089,47699,368,11.3,287,8.8,6170,1842,4328,3.9,12.9,5390,1668,3722,3.5,11.3,780,1.6,22.6,0,191,191,919
1977,26900,18201,21930,410331,408767,3434,15.9,2834,13.1,73806,29290,44516,7.2,18.1,70677,21983,48694,5.4,17.3,3129,0.8,34.6,0,1815,1833,13931
1978,26900,18758,22543,434666,422521,3110,14,2494,11.2,79730,22320,57410,5.3,18.9,55440,18786,36654,4.4,13.1,24290,5.8,26.2,0,1696,1701,8634
1979,26900,19111,22996,461766,448042,3035,13.3,2467,10.8,80202,26081,54121,5.8,17.9,52756,20087,32669,4.5,11.8,27446,6.1,23.6,0,1725,1733,10285
1980,26900,19250,23275,461128,461217,2869,12.4,2498,10.8,73223,26745,46478,5.8,15.9,73401,18470,54931,4,15.9,-178,0,31.8,0,1690,1703,8943
1981,26900,18646,22592,441149,446827,2621,11.5,3098,13.5,64008,23044,40964,5.2,14.3,75365,25758,49607,5.8,16.9,-11357,-2.6,28.6,0,1805,1810,11069
1982,26900,18931,23236,437909,439489,3198,13.9,2426,10.6,65908,29376,36532,6.7,15,69069,18856,50213,4.3,15.7,-3161,-0.7,30,0,1387,1393,8968
1983,26900,18063,22371,419778,427405,2536,11.1,3180,13.9,60145,21350,38795,5,14.1,75399,24562,50837,5.7,17.6,-15254,-3.5,28.2,0,1770,1780,10650
1984,26900,19776,24222,458096,440378,3072,13.2,1641,7,94048,40370,53678,9.2,21.4,58613,27476,31137,6.2,13.3,35435,8.1,26.6,0,44,57,675
1985,26900,20540,25062,478363,470277,3382,13.7,2629,10.7,87605,38415,49190,8.2,18.6,71433,23506,47927,5,15.2,16172,3.4,30.4,0,1664,1672,11850
1986,26900,21400,26072,502209,488091,3665,14.3,2580,10.1,91797,36161,55636,7.4,18.8,63561,23140,40421,4.7,13,28236,5.8,26,0,1644,1647,10216
1987,26900,22215,27097,518945,513440,4021,15.1,2933,11,95928,36842,59086,7.2,18.7,84918,34011,50907,6.6,16.5,11010,2.2,33,0,1745,1752,13296
1988,26900,22691,27689,534797,522746,3704,13.5,2961,10.8,100936,38833,62103,7.4,19.3,76833,30816,46017,5.9,14.7,24103,4.6,29.4,0,1837,1837,11421
1989,26900,23347,28707,563895,550622,3759,13.3,2780,9.9,102965,38404,64561,7,18.7,76418,29359,47059,5.3,13.9,26547,4.8,27.8,0,1844,1861,14740
1990,26900,23964,29527,587286,575234,3663,12.6,2707,9.3,95519,34804,60715,6.1,16.6,71415,24530,46885,4.3,12.4,24104,4.2,24.8,0,1801,1808,12676
1991,26900,24600,30385,590151,588450,3876,12.9,3014,10.1,92561,39249,53312,6.7,15.7,89159,29073,60086,4.9,15.2,3402,0.5,30.4,0,1859,1887,14730
1992,26900,25119,31212,598335,595035,4033,13.1,3140,10.2,100764,43768,56996,7.4,16.9,94164,27843,66321,4.7,15.8,6600,1.1,31.6,0,2009,2039,15134
1993,26900,25740,31787,612747,605419,3658,11.6,3033,9.6,98673,32740,65933,5.4,16.3,84017,29406,54611,4.9,13.9,14656,2.4,27.8,0,1990,1998,12073
1994,26900,26531,32703,621017,616612,4041,12.5,3042,9.4,100679,36315,64364,5.9,16.3,91870,34527,57343,5.6,14.9,8809,1.4,29.8,0,1941,1960,13318
1995,26900,27152,33642,659683,640576,4272,12.9,3242,9.8,115573,41265,74308,6.4,18,77359,27681,49678,4.3,12.1,38214,5.9,24.2,0,2158,2161,13553
1996,26900,27617,34188,666056,663053,4113,12.1,3506,10.3,110261,39964,70297,6,16.6,104254,38656,65598,5.8,15.7,6007,0.9,31.4,0,2133,2133,15766
1997,26900,28031,34995,685341,675630,4604,13.3,3804,11,125428,45676,79752,6.8,18.6,106006,46896,59110,6.9,15.7,19422,2.9,31.4,0,2233,2233,16185
1998,26900,28376,35463,713247,699644,4292,12.2,3748,10.6,120700,44535,76165,6.4,17.3,93493,36763,56730,5.3,13.4,27207,3.9,26.8,0,2379,2379,17016
1999,26900,28364,35787,739086,728601,4016,11.3,3671,10.3,119465,41508,77957,5.7,16.4,98494,35226,63268,4.8,13.5,20971,2.9,27,0,2345,2345,16940
2000,26900,28389,35954,776384,757799,4035,11.2,3906,10.9,135646,48252,87394,6.4,17.9,98476,36429,62047,4.8,13,37170,4.9,26,0,2251,2251,14180
2001,26900,28373,36163,778244,778384,4056,11.2,4105,11.4,119415,44211,75204,5.7,15.3,119695,43484,76211,5.6,15.4,-280,-0.1,30.6,0,2218,2220,17258
2002,26900,28689,36474,768508,773264,4723,13,4383,12.1,130006,56284,73722,7.3,16.8,139519,47306,92213,6.1,18,-9513,-1.2,33.6,0,2059,2071,13660
2003,26900,28925,36916,764346,759093,4367,12,3271,9,119029,42761,76268,5.6,15.7,108524,37804,70720,5,14.3,10505,1.4,28.6,0,2161,2170,16442
2004,26900,29387,37681,783312,771354,4416,11.9,3296,8.9,121018,41673,79345,5.4,15.7,97102,31647,65455,4.1,12.6,23916,3.1,25.2,0,2149,2151,15928
2005,26900,29657,38107,791554,784764,4347,11.5,3538,9.4,115379,47303,68076,6,14.7,101799,36596,65203,4.7,13,13580,1.7,26,0,2294,2299,17531
2006,26900,30019,38997,813068,800638,4723,12.3,3550,9.2,129615,49588,80027,6.2,16.2,104755,33587,71168,4.2,13.1,24860,3.1,26.2,0,2218,2220,19010
2007,26900,30397,39681,810653,810646,4780,12.2,3948,10.1,134418,48970,85448,6,16.6,134404,44684,89720,5.5,16.6,14,0,33.2,0,2373,2393,18386
2008,26900,30204,39630,809782,806041,4191,10.6,3841,9.7,121523,41517,80006,5.2,15.1,114041,35655,78386,4.4,14.1,7482,1,28.2,0,2637,2638,18205
2009,26900,29198,38600,772095,788222,3569,9.2,4126,10.6,97790,35138,62652,4.5,12.4,130044,28474,101570,3.6,16.5,-32254,-4.1,24.8,0,2647,2676,15789
2010,26900,28739,38063,753811,761819,3370,8.8,3657,9.6,92524,29655,62869,3.9,12.1,108540,29152,79388,3.8,14.2,-16016,-2.1,24.2,0,2335,2335,18289
2011,26900,28574,38043,764139,757556,3690,9.7,3382,8.9,101364,32721,68643,4.3,13.4,88198,29014,59184,3.8,11.6,13166,1.8,23.2,0,2099,2110,16825
2012,26900,28889,38476,813774,795467,3993,10.5,3526,9.2,127263,43734,83529,5.5,16,90650,28897,61753,3.6,11.4,36613,4.6,22.8,0,1975,1991,13278
2013,26900,29032,38540,825450,811351,3531,9.2,3352,8.7,116371,34146,82225,4.2,14.3,88174,27245,60929,3.4,10.9,28197,3.4,21.8,0,2019,2022,14437
2014,26900,29005,38532,844068,832242,3685,9.6,3309,8.6,114612,32592,82020,3.9,13.8,90959,31285,59674,3.8,10.9,23653,2.9,21.8,0,2134,2151,17279
1977,26980,1813,1934,21715,21094,373,20,237,12.7,4591,2178,2413,10.3,21.8,3349,1526,1823,7.2,15.9,1242,5.9,31.8,0,160,160,1062
1978,26980,1896,2024,24569,23134,316,16,222,11.2,5414,1944,3470,8.4,23.4,2544,1122,1422,4.9,11,2870,12.4,22,0,178,178,796
1979,26980,1885,2011,25826,25181,227,11.3,233,11.6,4923,1404,3519,5.6,19.6,3633,1310,2323,5.2,14.4,1290,5.2,28.8,0,169,171,958
1980,26980,1928,2058,25308,25525,243,11.9,186,9.1,3316,1345,1971,5.3,13,3750,935,2815,3.7,14.7,-434,-1.7,26,0,129,129,655
1981,26980,1912,2037,24276,24451,278,13.6,282,13.8,4215,2446,1769,10,17.2,4565,1559,3006,6.4,18.7,-350,-1.5,34.4,0,175,176,820
1982,26980,1883,2046,24987,24645,289,14.1,269,13.1,4741,2371,2370,9.6,19.2,4057,1799,2258,7.3,16.5,684,2.7,33,0,179,179,1229
1983,26980,1976,2137,24794,24809,245,11.7,183,8.7,3720,1291,2429,5.2,15,3749,1115,2634,4.5,15.1,-29,-0.1,30,0,130,132,755
1984,26980,2062,2230,26278,25525,279,12.8,192,8.8,4457,1569,2888,6.1,17.5,2951,1284,1667,5,11.6,1506,5.9,23.2,0,129,129,647
1985,26980,2110,2280,27540,27160,267,11.8,212,9.4,4268,1640,2628,6,15.7,3507,1188,2319,4.4,12.9,761,2.8,25.8,0,146,146,835
1986,26980,2109,2275,28637,28074,224,9.8,215,9.4,4626,1592,3034,5.7,16.5,3500,902,2598,3.2,12.5,1126,4,25,0,151,151,693
1987,26980,2135,2301,36139,35815,266,11.6,236,10.3,4865,2195,2670,6.1,13.6,4216,1408,2808,3.9,11.8,649,1.8,23.6,0,148,149,767
1988,26980,2141,2311,38074,36808,251,10.9,231,10,6279,2762,3517,7.5,17.1,3746,1299,2447,3.5,10.2,2533,6.9,20.4,0,144,144,801
1989,26980,2147,2315,39444,38886,226,9.8,229,9.9,4732,1547,3185,4,12.2,3616,1201,2415,3.1,9.3,1116,2.9,18.6,0,147,147,826
1990,26980,2185,2389,42042,40730,262,11.1,175,7.4,5598,1609,3989,4,13.7,2974,936,2038,2.3,7.3,2624,6.4,14.6,0,124,124,713
1991,26980,2261,2496,42449,42210,287,11.8,178,7.3,5450,2069,3381,4.9,12.9,4972,1698,3274,4,11.8,478,1.1,23.6,0,113,113,1144
1992,26980,2306,2559,44479,43407,271,10.7,202,8,7019,2160,4859,5,16.2,4874,1535,3339,3.5,11.2,2145,5,22.4,0,136,136,801
1993,26980,2335,2596,45792,45117,263,10.2,213,8.3,5642,1739,3903,3.9,12.5,4293,1632,2661,3.6,9.5,1349,3,19,0,151,152,983
1994,26980,2401,2655,45882,45812,275,10.5,199,7.6,5610,1987,3623,4.3,12.2,5470,1746,3724,3.8,11.9,140,0.3,23.8,0,130,130,640
1995,26980,2479,2746,47979,46773,318,11.8,219,8.1,5972,1924,4048,4.1,12.8,3560,949,2611,2,7.6,2412,5.2,15.2,0,142,142,489
1996,26980,2536,2793,47687,47803,288,10.4,229,8.3,5264,1880,3384,3.9,11,5495,1407,4088,2.9,11.5,-231,-0.5,22,0,155,155,849
1997,26980,2580,2846,48607,48237,302,10.7,267,9.4,6086,1815,4271,3.8,12.6,5345,1713,3632,3.6,11.1,741,1.5,22.2,0,144,144,747
1998,26980,2636,2902,50648,49591,324,11.3,264,9.2,7266,2335,4931,4.7,14.7,5152,1628,3524,3.3,10.4,2114,4.3,20.8,0,168,168,1040
1999,26980,2679,2969,54447,52640,334,11.4,265,9,8866,4361,4505,8.3,16.8,5252,1895,3357,3.6,10,3614,6.8,20,0,183,183,892
2000,26980,2708,3014,56853,55524,324,10.8,289,9.7,8317,2806,5511,5.1,15,5659,2139,3520,3.9,10.2,2658,4.8,20.4,0,183,183,943
2001,26980,2668,2975,57261,57149,276,9.2,338,11.3,6858,2653,4205,4.6,12,6633,2247,4386,3.9,11.6,225,0.4,23.2,0,185,185,1023
2002,26980,2705,3012,57179,57185,359,12,310,10.4,9659,4518,5141,7.9,16.9,9671,3400,6271,5.9,16.9,-12,0,33.8,0,164,164,835
2003,26980,2767,3087,58432,57611,367,12.1,239,7.9,8170,2773,5397,4.8,14.2,6527,1940,4587,3.4,11.3,1643,2.9,22.6,0,154,154,1291
2004,26980,2805,3127,59885,59227,306,9.9,245,7.9,7260,2398,4862,4,12.3,5943,1862,4081,3.1,10,1317,2.3,20,0,162,162,744
2005,26980,2881,3219,60212,59951,342,10.8,219,6.9,7093,3292,3801,5.5,11.8,6570,2348,4222,3.9,11,523,0.8,22,0,144,144,1086
2006,26980,2947,3305,60695,60348,394,12.1,281,8.6,6872,2777,4095,4.6,11.4,6177,1518,4659,2.5,10.2,695,1.2,20.4,0,189,189,1090
2007,26980,2989,3346,64729,62659,329,9.9,284,8.5,11655,2061,9594,3.3,18.6,7515,2076,5439,3.3,12,4140,6.6,24,0,175,175,904
2008,26980,3009,3374,65849,64940,299,8.9,247,7.4,7602,2342,5260,3.6,11.7,5784,1272,4512,2,8.9,1818,2.8,17.8,0,175,175,822
2009,26980,2986,3350,65201,65462,274,8.2,279,8.3,9067,4171,4896,6.4,13.9,9589,1467,8122,2.2,14.6,-522,-0.7,27.8,0,189,189,1028
2010,26980,2996,3363,63627,64363,258,7.7,239,7.1,6177,1752,4425,2.7,9.6,7649,2530,5119,3.9,11.9,-1472,-2.3,19.2,0,152,152,891
2011,26980,2995,3380,64933,64378,291,8.7,253,7.5,6723,2151,4572,3.3,10.4,5613,1432,4181,2.2,8.7,1110,1.7,17.4,0,167,167,916
2012,26980,3017,3413,63732,64162,283,8.3,249,7.3,6563,2012,4551,3.1,10.2,7422,1763,5659,2.7,11.6,-859,-1.4,20.4,0,156,156,983
2013,26980,3086,3504,66331,64992,306,8.9,213,6.2,7136,1685,5451,2.6,11,4457,1109,3348,1.7,6.9,2679,4.1,13.8,0,137,137,676
2014,26980,3101,3503,66076,65543,272,7.8,241,6.9,5958,1914,4044,2.9,9.1,4892,1123,3769,1.7,7.5,1066,1.6,15,0,150,151,702
1977,27060,1311,1404,27053,24643,274,20.3,162,12,7695,1853,5842,7.5,31.2,2874,1157,1717,4.7,11.7,4821,19.5,23.4,0,108,108,846
1978,27060,1388,1484,24791,25923,231,16,151,10.5,4586,1279,3307,4.9,17.7,6849,1043,5806,4,26.4,-2263,-8.7,35.4,0,98,98,365
1979,27060,1403,1499,31015,27890,172,11.5,146,9.8,8845,966,7879,3.5,31.7,2594,884,1710,3.2,9.3,6251,22.4,18.6,0,99,99,569
1980,27060,1382,1474,31721,31357,163,11,178,12,3436,1017,2419,3.2,11,2707,843,1864,2.7,8.6,729,2.4,17.2,0,121,122,411
1981,27060,1370,1451,33215,32215,168,11.5,180,12.3,4919,2190,2729,6.8,15.3,2919,903,2016,2.8,9.1,2000,6.2,18.2,0,104,104,463
1982,27060,1405,1501,32670,32939,215,14.6,154,10.4,3603,1211,2392,3.7,10.9,4140,752,3388,2.3,12.6,-537,-1.7,21.8,0,88,88,353
1983,27060,1452,1545,32868,32795,172,11.3,139,9.1,2856,682,2174,2.1,8.7,2709,637,2072,1.9,8.3,147,0.4,16.6,0,91,91,401
1984,27060,1501,1599,33394,33153,189,12,137,8.7,3423,901,2522,2.7,10.3,2940,1557,1383,4.7,8.9,483,1.4,17.8,0,92,92,411
1985,27060,1550,1643,34680,34319,186,11.5,153,9.4,4221,1557,2664,4.5,12.3,3498,1062,2436,3.1,10.2,723,2.1,20.4,0,104,104,693
1986,27060,1584,1688,35907,35271,199,12,148,8.9,4119,1019,3100,2.9,11.7,2847,891,1956,2.5,8.1,1272,3.6,16.2,0,93,93,482
1987,27060,1638,1760,37016,36478,245,14.2,161,9.3,3873,1358,2515,3.7,10.6,2796,901,1895,2.5,7.7,1077,2.9,15.4,0,107,108,569
1988,27060,1668,1795,37667,36995,196,11,143,8.1,4127,1693,2434,4.6,11.2,2782,982,1800,2.7,7.5,1345,3.7,15,0,96,96,568
1989,27060,1714,1844,39317,38484,219,12,172,9.5,4355,1317,3038,3.4,11.3,2688,1187,1501,3.1,7,1667,4.3,14,0,111,111,586
1990,27060,1754,1891,40522,39896,207,11.1,149,8,4260,1311,2949,3.3,10.7,3008,798,2210,2,7.5,1252,3.2,15,0,100,100,502
1991,27060,1753,1896,39815,40198,178,9.4,180,9.5,2641,848,1793,2.1,6.6,3407,850,2557,2.1,8.5,-766,-1.9,13.2,0,120,120,552
1992,27060,1753,1901,40566,40196,191,10,182,9.6,3746,1446,2300,3.6,9.3,3005,1023,1982,2.5,7.5,741,1.8,15,0,121,123,696
1993,27060,1727,1877,40380,40469,160,8.5,172,9.1,3075,904,2171,2.2,7.6,3253,1259,1994,3.1,8,-178,-0.4,15.2,0,119,119,910
1994,27060,1741,1893,40365,40365,179,9.5,151,8,2758,753,2005,1.9,6.8,2757,680,2077,1.7,6.8,1,0,13.6,0,106,106,425
1995,27060,1766,1921,40630,40445,204,10.7,171,9,3389,992,2397,2.5,8.4,3019,1010,2009,2.5,7.5,370,0.9,15,0,115,115,684
1996,27060,1756,1918,40873,40765,156,8.1,166,8.6,4415,2033,2382,5,10.8,4199,1822,2377,4.5,10.3,216,0.5,20.6,0,117,117,467
1997,27060,1761,1921,40120,40418,193,10,191,9.9,3422,1470,1952,3.6,8.5,4018,1323,2695,3.3,9.9,-596,-1.4,17,0,119,119,835
1998,27060,1777,1932,40121,40111,175,9.1,160,8.3,4274,1252,3022,3.1,10.7,4254,1051,3203,2.6,10.6,20,0.1,21.2,0,98,98,740
1999,27060,1761,1909,42239,41277,155,8.1,175,9.1,4969,804,4165,1.9,12,3044,1010,2034,2.4,7.4,1925,4.6,14.8,0,108,108,691
2000,27060,1741,1894,41560,41897,155,8.2,167,8.8,3091,986,2105,2.4,7.4,3765,1082,2683,2.6,9,-674,-1.6,14.8,0,98,98,652
2001,27060,1785,1951,42831,42283,184,9.5,148,7.7,3780,1076,2704,2.5,8.9,2683,876,1807,2.1,6.3,1097,2.6,12.6,0,91,91,453
2002,27060,1797,1952,43518,43256,209,10.7,207,10.6,4438,1343,3095,3.1,10.3,3913,1439,2474,3.3,9,525,1.3,18,0,117,117,655
2003,27060,1811,1976,44227,43765,178,9.1,138,7,4227,1162,3065,2.7,9.7,3302,848,2454,1.9,7.5,925,2.2,15,0,102,102,633
2004,27060,1815,1968,47565,45836,166,8.4,158,8,7236,884,6352,1.9,15.8,3778,965,2813,2.1,8.2,3458,7.6,16.4,0,104,104,406
2005,27060,1825,1986,45000,46251,179,9.1,137,6.9,4611,1913,2698,4.1,10,7113,832,6281,1.8,15.4,-2502,-5.4,20,0,102,102,662
2006,27060,1820,1991,45306,45107,202,10.2,190,9.6,4163,1903,2260,4.2,9.2,3764,1635,2129,3.6,8.3,399,0.9,16.6,0,142,142,1401
2007,27060,1867,2036,45110,45207,224,11.1,180,8.9,3853,1393,2460,3.1,8.5,4047,1513,2534,3.3,9,-194,-0.5,17,0,104,105,806
2008,27060,1899,2071,45906,45405,197,9.6,139,6.8,3908,1308,2600,2.9,8.6,2905,677,2228,1.5,6.4,1003,2.2,12.8,0,91,91,464
2009,27060,1903,2073,44537,45171,158,7.6,151,7.3,2932,1067,1865,2.4,6.5,4200,826,3374,1.8,9.3,-1268,-2.8,13,0,94,94,480
2010,27060,1888,2070,44505,44497,162,7.8,153,7.4,4008,1311,2697,2.9,9,3991,1016,2975,2.3,9,17,0,18,0,91,91,646
2011,27060,1914,2098,44624,44430,204,9.8,161,7.7,3779,1267,2512,2.9,8.5,3390,1350,2040,3,7.6,389,0.9,15.2,0,94,94,708
2012,27060,1966,2152,45949,45270,189,8.9,140,6.6,4266,1362,2904,3,9.4,2907,779,2128,1.7,6.4,1359,3,12.8,0,80,80,287
2013,27060,1945,2137,46072,45950,166,7.8,181,8.5,3351,891,2460,1.9,7.3,3106,1110,1996,2.4,6.8,245,0.5,13.6,0,120,120,757
2014,27060,1938,2126,46921,46434,187,8.8,175,8.3,3730,813,2917,1.8,8,2756,944,1812,2,5.9,974,2.1,11.8,0,111,111,544
1977,27100,2181,2387,49403,48201,355,15,307,13,8173,4371,3802,9.1,17,5769,2446,3323,5.1,12,2404,5,24,0,201,201,1764
1978,27100,2216,2421,53532,51496,268,11.1,239,9.9,8128,1676,6452,3.3,15.8,4056,1462,2594,2.8,7.9,4072,7.9,15.8,0,158,158,739
1979,27100,2274,2485,48451,51017,317,12.9,248,10.1,7461,1990,5471,3.9,14.6,12593,1753,10840,3.4,24.7,-5132,-10.1,29.2,0,169,169,824
1980,27100,2230,2446,45780,47076,249,10.1,272,11,4982,1583,3399,3.4,10.6,7573,1660,5913,3.5,16.1,-2591,-5.5,21.2,0,176,176,981
1981,27100,2178,2380,42035,43694,270,11.2,308,12.8,4019,2090,1929,4.8,9.2,7336,2680,4656,6.1,16.8,-3317,-7.6,18.4,0,168,168,858
1982,27100,2178,2426,42086,42024,289,12,221,9.2,5630,2555,3075,6.1,13.4,5506,1207,4299,2.9,13.1,124,0.3,26.2,0,128,128,630
1983,27100,2177,2422,42531,42276,223,9.2,253,10.4,6674,1055,5619,2.5,15.8,6163,1295,4868,3.1,14.6,511,1.2,29.2,0,160,160,726
1984,27100,2217,2461,42217,42364,258,10.6,223,9.1,7714,1493,6221,3.5,18.2,8007,2450,5557,5.8,18.9,-293,-0.7,36.4,0,132,132,552
1985,27100,2271,2521,43565,43034,290,11.6,230,9.2,6925,1653,5272,3.8,16.1,5862,1775,4087,4.1,13.6,1063,2.5,27.2,0,153,153,760
1986,27100,2329,2581,43663,43575,297,11.6,229,9,7084,2222,4862,5.1,16.3,6907,1675,5232,3.8,15.9,177,0.4,31.8,0,150,150,764
1987,27100,2360,2607,44775,44287,310,11.9,278,10.7,7075,2918,4157,6.6,16,6098,2160,3938,4.9,13.8,977,2.2,27.6,0,164,164,955
1988,27100,2392,2650,45823,45143,281,10.7,243,9.3,7326,2081,5245,4.6,16.2,5966,1702,4264,3.8,13.2,1360,3,26.4,0,150,150,976
1989,27100,2414,2672,46173,45968,279,10.5,245,9.2,7429,2095,5334,4.6,16.2,7018,1833,5185,4,15.3,411,0.9,30.6,0,165,165,740
1990,27100,2459,2718,46339,46251,243,9,191,7.1,5349,1764,3585,3.8,11.6,5173,927,4246,2,11.2,176,0.4,22.4,0,123,123,477
1991,27100,2508,2773,44860,45534,288,10.5,228,8.3,6589,3313,3276,7.3,14.5,7937,1787,6150,3.9,17.4,-1348,-2.9,29,0,138,138,1206
1992,27100,2528,2812,45249,45015,293,10.5,237,8.5,6291,2360,3931,5.2,14,5822,1726,4096,3.8,12.9,469,1.1,25.8,0,150,150,657
1993,27100,2563,2847,46403,45799,246,8.7,215,7.6,5710,1791,3919,3.9,12.5,4502,1388,3114,3,9.8,1208,2.7,19.6,0,140,141,632
1994,27100,2593,2886,47549,46976,269,9.4,221,7.7,6430,2098,4332,4.5,13.7,5284,1604,3680,3.4,11.2,1146,2.5,22.4,0,141,141,660
1995,27100,2663,2957,50789,49189,287,9.8,212,7.3,7064,1797,5267,3.7,14.4,3863,1305,2558,2.7,7.9,3201,6.5,15.8,0,148,148,797
1996,27100,2712,3015,51613,51354,288,9.6,233,7.8,6180,2207,3973,4.3,12,5661,1204,4457,2.3,11,519,1,22,0,156,156,695
1997,27100,2766,3081,51833,51721,332,10.9,266,8.7,7712,3122,4590,6,14.9,7487,2487,5000,4.8,14.5,225,0.4,29,0,163,163,897
1998,27100,2763,3087,53076,52466,284,9.2,268,8.7,7424,2264,5160,4.3,14.2,6204,2672,3532,5.1,11.8,1220,2.4,23.6,0,162,162,1113
1999,27100,2750,3083,53266,53171,266,8.6,258,8.4,6462,1894,4568,3.6,12.2,6272,2104,4168,4,11.8,190,0.4,23.6,0,167,167,879
2000,27100,2737,3068,54115,53560,265,8.6,288,9.4,8201,2578,5623,4.8,15.3,7090,3459,3631,6.5,13.2,1111,2.1,26.4,0,165,165,1061
2001,27100,2713,3045,53832,54237,258,8.4,304,9.9,5987,1690,4297,3.1,11,6797,2222,4575,4.1,12.5,-810,-1.5,22,0,155,155,1259
2002,27100,2742,3072,51337,52535,342,11.2,308,10.1,7322,3183,4139,6.1,13.9,9718,3440,6278,6.5,18.5,-2396,-4.6,27.8,0,166,166,1357
2003,27100,2725,3067,51834,51371,283,9.2,254,8.3,7417,3053,4364,5.9,14.4,6491,1839,4652,3.6,12.6,926,1.8,25.2,0,173,173,1360
2004,27100,2702,3020,53311,52412,272,9,288,9.5,8168,4086,4082,7.8,15.6,6369,1916,4453,3.7,12.2,1799,3.4,24.4,0,168,168,1108
2005,27100,2708,3053,52255,52597,271,8.9,220,7.3,7519,2662,4857,5.1,14.3,8202,1545,6657,2.9,15.6,-683,-1.3,28.6,0,147,147,669
2006,27100,2650,3014,53237,52695,242,8,265,8.8,6795,1954,4841,3.7,12.9,5710,1644,4066,3.1,10.8,1085,2.1,21.6,0,183,183,1069
2007,27100,2646,3022,49606,51427,264,8.8,261,8.7,5516,1958,3558,3.8,10.7,9157,3438,5719,6.7,17.8,-3641,-7.1,21.4,0,170,173,2507
2008,27100,2572,2952,49452,49380,225,7.6,272,9.1,6078,2118,3960,4.3,12.3,5933,2029,3904,4.1,12,145,0.3,24,0,207,207,1512
2009,27100,2448,2809,45642,47463,191,6.6,315,11,4498,1594,2904,3.4,9.5,8139,2081,6058,4.4,17.1,-3641,-7.6,19,0,203,203,1246
2010,27100,2382,2734,43750,44620,187,6.8,239,8.7,4280,1101,3179,2.5,9.6,6020,2250,3770,5,13.5,-1740,-3.9,19.2,0,157,157,1819
2011,27100,2357,2716,45436,44514,209,7.7,200,7.4,5071,1164,3907,2.6,11.4,3227,982,2245,2.2,7.2,1844,4.2,14.4,0,132,132,518
2012,27100,2348,2698,47217,46256,194,7.2,206,7.6,6199,889,5310,1.9,13.4,4277,1607,2670,3.5,9.2,1922,4.2,18.4,0,122,124,806
2013,27100,2336,2674,47897,47579,159,5.9,198,7.4,4546,1297,3249,2.7,9.6,3909,892,3017,1.9,8.2,637,1.4,16.4,0,120,123,527
2014,27100,2315,2662,46979,47373,205,7.7,201,7.6,3871,1200,2671,2.5,8.2,4658,1353,3305,2.9,9.8,-787,-1.6,16.4,0,152,152,930
1977,27140,6909,7847,118626,114278,1322,17.2,1016,13.2,25502,9583,15919,8.4,22.3,16805,7114,9691,6.2,14.7,8697,7.6,29.4,0,705,718,5385
1978,27140,7134,8129,126334,122492,1320,16.5,1042,13,28573,10685,17888,8.7,23.3,20889,7595,13294,6.2,17.1,7684,6.2,34.2,0,697,702,3075
1979,27140,7355,8414,136390,131327,1339,16.2,993,12,27803,9211,18592,7,21.2,17676,6110,11566,4.7,13.5,10127,7.7,27,0,707,711,3543
1980,27140,7534,8618,137472,136918,1197,14.1,968,11.4,22500,8182,14318,6,16.4,21391,6521,14870,4.8,15.6,1109,0.8,31.2,0,706,711,4097
1981,27140,7284,8324,129657,131296,1045,12.4,1247,14.7,19791,8606,11185,6.6,15.1,23069,9186,13883,7,17.6,-3278,-2.5,30.2,0,792,793,5104
1982,27140,7265,8413,125829,127577,1237,14.8,1016,12.1,17667,8415,9252,6.6,13.8,21162,6896,14266,5.4,16.6,-3495,-2.8,27.6,0,598,598,2882
1983,27140,7456,8608,123976,123541,1028,12.1,919,10.8,21256,9319,11937,7.5,17.2,20386,8585,11801,6.9,16.5,870,0.7,33,0,625,626,3818
1984,27140,7671,8820,135087,129474,1204,13.8,1005,11.5,25648,9141,16507,7.1,19.8,14421,5255,9166,4.1,11.1,11227,8.7,22.2,0,627,627,2641
1985,27140,7830,9062,142219,140519,1243,13.9,1003,11.2,24502,8919,15583,6.3,17.4,21102,8441,12661,6,15,3400,2.4,30,0,674,674,3872
1986,27140,7989,9262,155035,148511,1242,13.6,1007,11,36368,10857,25511,7.3,24.5,23319,8208,15111,5.5,15.7,13049,8.8,31.4,0,648,651,4055
1987,27140,8040,9341,150705,154638,1304,14,1178,12.7,28316,12444,15872,8,18.3,36181,11204,24977,7.2,23.4,-7865,-5.1,36.6,0,765,770,5270
1988,27140,7906,9284,157817,153178,1194,12.8,1196,12.9,29406,11788,17618,7.7,19.2,20128,7695,12433,5,13.1,9278,6.1,26.2,0,801,801,4153
1989,27140,7944,9396,163827,161498,1153,12.3,1041,11.1,27550,10822,16728,6.7,17.1,22892,8693,14199,5.4,14.2,4658,2.9,28.4,0,723,734,5305
1990,27140,8046,9502,167614,165519,1143,12.1,982,10.4,26506,8569,17937,5.2,16,22315,7624,14691,4.6,13.5,4191,2.5,27,0,666,667,4640
1991,27140,8107,9622,171373,169760,1194,12.5,1097,11.5,28541,11731,16810,6.9,16.8,25314,9378,15936,5.5,14.9,3227,1.9,29.8,0,671,676,5784
1992,27140,8183,9707,172286,170489,1169,12.1,1039,10.7,30931,8994,21937,5.3,18.1,27336,8224,19112,4.8,16,3595,2.1,32,0,645,653,3901
1993,27140,8343,9812,173783,172921,1121,11.5,988,10.1,26243,6985,19258,4,15.2,24519,9570,14949,5.5,14.2,1724,1,28.4,0,652,652,5691
1994,27140,8540,9987,182582,178362,1275,12.9,1074,10.8,29164,9382,19782,5.3,16.4,20724,7766,12958,4.4,11.6,8440,4.8,23.2,0,731,736,4211
1995,27140,8688,10163,189777,186150,1226,12.2,1045,10.4,31745,12173,19572,6.5,17.1,24490,10997,13493,5.9,13.2,7255,3.9,26.4,0,710,712,6101
1996,27140,8749,10245,191213,190433,1217,11.9,1098,10.8,30485,11328,19157,5.9,16,28925,11918,17007,6.3,15.2,1560,0.8,30.4,0,738,738,4541
1997,27140,8863,10426,198597,196051,1290,12.5,1125,10.9,38229,11711,26518,6,19.5,33136,11853,21283,6,16.9,5093,2.6,33.8,0,684,684,4852
1998,27140,8943,10562,204204,201284,1263,12,1101,10.5,32635,11154,21481,5.5,16.2,26794,9728,17066,4.8,13.3,5841,2.9,26.6,0,697,697,5264
1999,27140,8988,10669,204020,204388,1250,11.8,1124,10.6,30888,11022,19866,5.4,15.1,31624,13319,18305,6.5,15.5,-736,-0.4,30.2,0,723,723,5602
2000,27140,8946,10770,208299,205914,1309,12.2,1207,11.3,34964,13353,21611,6.5,17,30193,12736,17457,6.2,14.7,4771,2.3,29.4,0,715,715,3513
2001,27140,8955,10813,204634,207179,1227,11.4,1273,11.8,30171,10613,19558,5.1,14.6,35261,12286,22975,5.9,17,-5090,-2.4,29.2,0,661,661,4459
2002,27140,9158,11014,202407,203007,1548,14.2,1326,12.2,35498,14965,20533,7.4,17.5,36698,14214,22484,7,18.1,-1200,-0.6,35,0,706,710,4640
2003,27140,9310,11213,202327,201313,1370,12.4,992,9,31786,11190,20596,5.6,15.8,29757,9836,19921,4.9,14.8,2029,1,29.6,0,696,696,6722
2004,27140,9553,11474,217436,210017,1318,11.6,976,8.6,41065,17668,23397,8.4,19.6,26227,8950,17277,4.3,12.5,14838,7.1,25,0,650,650,4018
2005,27140,9604,11608,215236,215519,1313,11.4,1046,9.1,28909,10849,18060,5,13.4,29475,10051,19424,4.7,13.7,-566,-0.3,26.8,0,717,717,5420
2006,27140,9681,11748,220329,216868,1348,11.6,1083,9.3,35628,15102,20526,7,16.4,28705,9331,19374,4.3,13.2,6923,3.2,26.4,0,711,711,5658
2007,27140,9820,11960,214204,216399,1385,11.7,1130,9.5,29961,11552,18409,5.3,13.8,34351,10398,23953,4.8,15.9,-4390,-2.1,27.6,0,718,720,4466
2008,27140,9767,11965,216981,214899,1170,9.8,1054,8.9,29595,10107,19488,4.7,13.8,25430,7610,17820,3.5,11.8,4165,2,23.6,0,783,783,5440
2009,27140,9574,11763,209867,212788,1025,8.7,1142,9.7,27961,14220,13741,6.7,13.1,33803,9309,24494,4.4,15.9,-5842,-2.8,26.2,0,783,783,5447
2010,27140,9523,11711,201665,205118,1026,8.8,1025,8.8,21268,7619,13649,3.7,10.4,28174,7489,20685,3.7,13.7,-6906,-3.3,20.8,0,690,690,3928
2011,27140,9347,11568,203298,202296,955,8.2,1010,8.7,23829,8333,15496,4.1,11.8,21824,6137,15687,3,10.8,2005,1,21.6,0,672,674,3531
2012,27140,9427,11661,207891,205531,1006,8.7,950,8.2,27125,7129,19996,3.5,13.2,22405,5784,16621,2.8,10.9,4720,2.3,21.8,0,583,584,3016
2013,27140,9467,11680,213527,210363,952,8.2,913,7.8,25793,5936,19857,2.8,12.3,19465,4959,14506,2.4,9.3,6328,3,18.6,0,623,626,3251
2014,27140,9461,11714,215906,213462,1023,8.8,933,8,24733,7899,16834,3.7,11.6,19844,5706,14138,2.7,9.3,4889,2.3,18.6,0,659,661,3675
1977,27180,1587,1713,27274,26440,287,17.1,201,12,5173,2402,2771,9.1,19.6,3505,1406,2099,5.3,13.3,1668,6.3,26.6,0,134,136,825
1978,27180,1630,1753,28908,28067,236,13.6,197,11.4,5338,1864,3474,6.6,19,3656,1242,2414,4.4,13,1682,6,26,0,124,124,676
1979,27180,1649,1783,30392,29646,250,14.1,213,12.1,6219,2468,3751,8.3,21,4726,2596,2130,8.8,15.9,1493,5.1,31.8,0,151,151,845
1980,27180,1685,1813,32587,31501,261,14.5,219,12.2,6316,1852,4464,5.9,20.1,4144,1289,2855,4.1,13.2,2172,6.9,26.4,0,155,156,748
1981,27180,1651,1779,29099,30514,236,13.2,243,13.6,4390,1967,2423,6.4,14.4,7220,2188,5032,7.2,23.7,-2830,-9.3,28.8,0,155,156,779
1982,27180,1659,1810,27941,28439,254,14.1,196,10.9,3888,2030,1858,7.1,13.7,4883,1419,3464,5,17.2,-995,-3.5,27.4,0,106,106,553
1983,27180,1686,1818,27901,27763,216,11.9,218,12,4319,1589,2730,5.7,15.6,4043,1358,2685,4.9,14.6,276,1,29.2,0,137,139,733
1984,27180,1784,1912,30059,28986,303,16.2,206,11,5419,1774,3645,6.1,18.7,3273,952,2321,3.3,11.3,2146,7.4,22.6,0,145,145,700
1985,27180,1825,1950,30903,30680,233,12,198,10.2,4503,1409,3094,4.6,14.7,4057,1236,2821,4,13.2,446,1.5,26.4,0,124,124,668
1986,27180,1844,1974,31736,31228,251,12.8,214,10.9,4811,1394,3417,4.5,15.4,3794,1687,2107,5.4,12.1,1017,3.3,24.2,0,138,138,598
1987,27180,1899,2039,33293,32558,279,13.9,211,10.5,6524,3015,3509,9.3,20,5054,2150,2904,6.6,15.5,1470,4.5,31,0,131,132,743
1988,27180,1891,2032,33365,33008,262,12.9,239,11.8,5334,2156,3178,6.5,16.2,4620,1566,3054,4.7,14,714,2.2,28,0,158,158,893
1989,27180,1956,2114,37320,36385,263,12.7,189,9.1,6430,2064,4366,5.7,17.7,4560,828,3732,2.3,12.5,1870,5.2,25,0,140,142,618
1990,27180,1977,2152,37391,37413,255,12,205,9.6,5961,2351,3610,6.3,15.9,6007,1276,4731,3.4,16.1,-46,-0.2,31.8,0,138,138,741
1991,27180,2071,2267,38566,37964,306,13.9,192,8.7,7065,2949,4116,7.8,18.6,5861,1584,4277,4.2,15.4,1204,3.2,30.8,0,126,127,811
1992,27180,2101,2308,42159,40395,289,12.6,240,10.5,8368,3102,5266,7.7,20.7,4840,1870,2970,4.6,12,3528,8.7,24,0,165,167,1090
1993,27180,2141,2336,43306,42710,265,11.4,224,9.7,6813,1523,5290,3.6,16,5622,2275,3347,5.3,13.2,1191,2.8,26.4,0,159,160,1455
1994,27180,2201,2412,44993,44146,296,12.5,218,9.2,7009,2525,4484,5.7,15.9,5314,1550,3764,3.5,12,1695,3.9,24,0,160,160,937
1995,27180,2260,2472,47599,46237,291,11.9,223,9.1,7850,3057,4793,6.6,17,5126,1613,3513,3.5,11.1,2724,5.9,22.2,0,144,144,790
1996,27180,2295,2517,47491,47680,316,12.7,272,10.9,6748,2517,4231,5.3,14.2,7126,2199,4927,4.6,14.9,-378,-0.7,28.4,0,196,196,1412
1997,27180,2324,2569,50759,49116,344,13.5,292,11.5,10047,3454,6593,7,20.5,6761,3079,3682,6.3,13.8,3286,6.7,27.6,0,182,182,1537
1998,27180,2370,2633,52663,51667,321,12.3,249,9.6,8650,3641,5009,7,16.7,6658,2396,4262,4.6,12.9,1992,3.8,25.8,0,156,156,974
1999,27180,2403,2689,53392,53098,320,12,273,10.3,7937,3097,4840,5.8,14.9,7349,2319,5030,4.4,13.8,588,1.1,27.6,0,181,181,961
2000,27180,2348,2643,56953,55169,254,9.5,298,11.2,9792,3753,6039,6.8,17.7,6224,3159,3065,5.7,11.3,3568,6.4,22.6,0,194,194,1564
2001,27180,2321,2639,56499,56853,258,9.8,280,10.6,6694,2532,4162,4.5,11.8,7401,1719,5682,3,13,-707,-1.2,23.6,0,168,168,681
2002,27180,2279,2587,53416,54846,310,11.9,362,13.9,7547,2947,4600,5.4,13.8,10407,3660,6747,6.7,19,-2860,-5.2,27.6,0,198,198,1131
2003,27180,2271,2564,54115,53509,267,10.4,236,9.2,7517,2704,4813,5.1,14,6305,1862,4443,3.5,11.8,1212,2.2,23.6,0,172,172,1443
2004,27180,2306,2625,55450,54698,301,11.6,220,8.5,8178,2341,5837,4.3,15,6674,1961,4713,3.6,12.2,1504,2.8,24.4,0,154,154,1426
2005,27180,2292,2625,55738,55485,272,10.4,240,9.2,6875,2417,4458,4.4,12.4,6368,1551,4817,2.8,11.5,507,0.9,23,0,175,175,935
2006,27180,2260,2590,55534,55462,277,10.7,269,10.4,6703,2807,3896,5.1,12.1,6559,1864,4695,3.4,11.8,144,0.3,23.6,0,189,189,1212
2007,27180,2303,2656,55570,55108,296,11.3,224,8.6,7530,2902,4628,5.3,13.7,6605,1662,4943,3,12,925,1.7,24,0,152,153,1017
2008,27180,2302,2667,54882,55159,239,9,221,8.3,6016,1635,4381,3,10.9,6569,1619,4950,2.9,11.9,-553,-1,21.8,0,167,167,1296
2009,27180,2240,2592,52358,53443,198,7.6,246,9.4,5194,1681,3513,3.1,9.7,7363,1363,6000,2.6,13.8,-2169,-4.1,19.4,0,169,169,825
2010,27180,2251,2600,51890,51905,215,8.3,199,7.7,5755,1297,4458,2.5,11.1,5785,1383,4402,2.7,11.1,-30,0,22.2,0,139,141,1125
2011,27180,2239,2588,52823,52298,211,8.2,206,8,5929,2094,3835,4,11.3,4878,983,3895,1.9,9.3,1051,2,18.6,0,140,140,523
2012,27180,2244,2590,53233,52928,218,8.4,208,8.1,6861,2468,4393,4.7,13,6250,1197,5053,2.3,11.8,611,1.2,23.6,0,138,138,633
2013,27180,2228,2569,53701,53323,177,6.9,195,7.6,5695,1559,4136,2.9,10.7,4938,1557,3381,2.9,9.3,757,1.4,18.6,0,131,131,814
2014,27180,2220,2586,54600,53897,222,8.7,182,7.1,5720,1718,4002,3.2,10.6,4314,1211,3103,2.2,8,1406,2.6,16,0,129,130,767
1977,27260,11838,14075,211670,206268,2485,18,1953,14.1,48354,19023,29331,9.2,23.4,37550,13870,23680,6.7,18.2,10804,5.2,36.4,0,1327,1332,7692
1978,27260,12083,14400,222900,217267,2250,15.8,1895,13.3,48698,16618,32080,7.6,22.4,37431,13202,24229,6.1,17.2,11267,5.2,34.4,0,1284,1294,6502
1979,27260,12303,14708,234869,228782,2160,14.8,1772,12.2,46774,15662,31112,6.8,20.4,34600,11227,23373,4.9,15.1,12174,5.3,30.2,0,1228,1229,6429
1980,27260,12514,14945,233634,234083,2111,14.2,1824,12.3,39169,14378,24791,6.1,16.7,40067,13035,27032,5.6,17.1,-898,-0.4,33.4,0,1254,1262,7489
1981,27260,12474,14927,241148,236810,2189,14.7,2078,13.9,50077,18628,31449,7.9,21.1,41401,16021,25380,6.8,17.5,8676,3.6,35,0,1236,1239,6264
1982,27260,12873,15615,248470,244900,2518,16.5,1726,11.3,48383,22581,25802,9.2,19.8,41243,15699,25544,6.4,16.8,7140,3,33.6,0,961,963,8085
1983,27260,13340,16144,253184,250633,2280,14.4,1865,11.7,47864,18369,29495,7.3,19.1,42761,14958,27803,6,17.1,5103,2,34.2,0,1062,1063,7160
1984,27260,14279,17221,284032,269517,2887,17.3,1812,10.9,68247,26343,41904,9.8,25.3,39216,13597,25619,5,14.6,29031,10.7,29.2,0,1128,1137,6939
1985,27260,14927,18005,300525,292368,2854,16.2,2060,11.7,61354,22167,39187,7.6,21,45039,16944,28095,5.8,15.4,16315,5.6,30.8,0,1302,1304,8581
1986,27260,15727,18905,312246,305891,3115,16.9,2140,11.6,65484,26106,39378,8.5,21.4,52773,18639,34134,6.1,17.3,12711,4.1,34.6,0,1366,1366,9635
1987,27260,16400,19866,324697,319362,3438,17.7,2439,12.6,70099,32116,37983,10.1,21.9,59428,25081,34347,7.9,18.6,10671,3.3,37.2,0,1583,1590,11707
1988,27260,16640,20251,336170,329811,3054,15.2,2599,13,69250,29329,39921,8.9,21,56532,21941,34591,6.7,17.1,12718,3.9,34.2,0,1747,1747,9995
1989,27260,16888,20704,356150,346918,2906,14.2,2468,12.1,73220,33511,39709,9.7,21.1,54756,19561,35195,5.6,15.8,18464,5.3,31.6,0,1677,1685,10234
1990,27260,17149,21083,360911,354664,2947,14.1,2417,11.6,67481,25147,42334,7.1,19,54986,18761,36225,5.3,15.5,12495,3.5,31,0,1624,1626,10224
1991,27260,17541,21665,358572,359569,3096,14.5,2515,11.8,63095,26369,36726,7.3,17.5,65088,20400,44688,5.7,18.1,-1993,-0.6,35,0,1555,1570,9584
1992,27260,17771,21983,363920,361558,3158,14.4,2776,12.7,68044,29740,38304,8.2,18.8,63319,24550,38769,6.8,17.5,4725,1.3,35,0,1715,1723,11766
1993,27260,18127,22301,381816,372483,2904,13.1,2536,11.5,78109,32213,45896,8.6,21,59443,22811,36632,6.1,16,18666,5,32,0,1699,1709,11774
1994,27260,18584,22935,391806,386607,3214,14.2,2530,11.2,70064,28448,41616,7.4,18.1,59666,20306,39360,5.3,15.4,10398,2.7,30.8,0,1704,1710,10928
1995,27260,18971,23396,410023,400779,3078,13.3,2531,10.9,72285,26767,45518,6.7,18,53797,19357,34440,4.8,13.4,18488,4.6,26.8,0,1693,1706,11177
1996,27260,19307,23841,424728,417575,3132,13.3,2643,11.2,78176,28400,49776,6.8,18.7,63870,21806,42064,5.2,15.3,14306,3.4,30.6,0,1789,1789,11273
1997,27260,19552,24810,431774,428526,4007,16.5,3016,12.4,82322,35683,46639,8.3,19.2,75827,27335,48492,6.4,17.7,6495,1.5,35.4,0,1859,1860,11984
1998,27260,19712,24707,454285,442917,3388,13.7,3442,13.9,93534,36077,57457,8.1,21.1,70798,31090,39708,7,16,22736,5.1,32,0,1847,1847,12138
1999,27260,19860,24990,464554,459421,3375,13.6,3040,12.2,89846,37021,52825,8.1,19.6,79579,36153,43426,7.9,17.3,10267,2.3,34.6,0,1808,1808,10146
2000,27260,19976,25148,476262,471884,3261,13,3116,12.4,85589,30433,55156,6.4,18.1,76833,27227,49606,5.8,16.3,8756,1.8,32.6,0,1767,1767,10728
2001,27260,20338,25854,504344,490421,3556,13.9,3010,11.8,99159,39566,59593,8.1,20.2,71314,24336,46978,5,14.5,27845,5.7,29,0,1709,1710,9274
2002,27260,20767,26312,505965,502434,3846,14.8,3351,12.9,103849,37202,66647,7.4,20.7,96788,43100,53688,8.6,19.3,7061,1.4,38.6,0,1734,1743,16754
2003,27260,21342,26884,491103,494242,3977,15,2870,10.8,87856,35302,52554,7.1,17.8,94134,43638,50496,8.8,19,-6278,-1.2,35.6,0,1891,1892,28682
2004,27260,22427,27862,494437,490958,4473,16.4,3160,11.6,95629,35367,60262,7.2,19.5,88670,42032,46638,8.6,18.1,6959,1.4,36.2,0,1917,1921,12447
2005,27260,23573,29486,523039,507369,4746,16.6,2808,9.8,98409,47151,51258,9.3,19.4,67071,19443,47628,3.8,13.2,31338,6.2,26.4,0,1893,1893,11933
2006,27260,24564,30748,559821,547619,4718,15.7,3122,10.4,104288,43267,61021,7.9,19,79884,21201,58683,3.9,14.6,24404,4.4,29.2,0,2095,2095,12222
2007,27260,25118,31724,551225,554606,4705,15.1,3590,11.5,93357,39173,54184,7.1,16.8,100119,33478,66641,6,18.1,-6762,-1.3,33.6,0,2343,2359,15733
2008,27260,24826,31514,550197,546380,4026,12.8,3935,12.5,89992,36592,53400,6.7,16.5,82357,24239,58118,4.4,15.1,7635,1.4,30.2,0,2763,2770,13004
2009,27260,23684,30448,526775,536462,3538,11.5,4208,13.6,82665,44140,38525,8.2,15.4,102039,26018,76021,4.8,19,-19374,-3.6,30.8,0,2837,2863,13651
2010,27260,23380,29981,519932,521943,3436,11.4,3690,12.3,84042,28485,55557,5.5,16.1,88063,26708,61355,5.1,16.9,-4021,-0.8,32.2,0,2268,2271,12607
2011,27260,23223,29896,508227,513318,3513,11.8,3401,11.4,76621,28630,47991,5.6,14.9,86803,34518,52285,6.7,16.9,-10182,-2,29.8,0,2258,2260,22973
2012,27260,23580,30315,514193,509954,3530,11.8,3122,10.4,77657,24289,53368,4.8,15.2,69178,25342,43836,5,13.6,8479,1.6,27.2,0,1919,1947,13372
2013,27260,24091,30879,524866,518324,3532,11.6,2964,9.7,78117,25592,52525,4.9,15.1,65032,19652,45380,3.8,12.5,13085,2.6,25,0,1848,1852,9943
2014,27260,24376,31203,542178,530487,3643,11.8,3011,9.7,83123,27418,55705,5.2,15.7,59741,19155,40586,3.6,11.3,23382,4.4,22.6,0,2086,2086,10714
1977,27340,1087,1206,11413,11298,223,18.7,189,15.8,2596,1503,1093,13.3,23,2365,967,1398,8.6,20.9,231,2.1,41.8,0,127,127,659
1978,27340,1112,1229,12655,12033,213,17.5,191,15.7,3191,1286,1905,10.7,26.5,1946,844,1102,7,16.2,1245,10.3,32.4,0,125,125,456
1979,27340,1131,1261,12998,12804,213,17.1,169,13.6,2776,1412,1364,11,21.7,2388,1036,1352,8.1,18.7,388,3,37.4,0,131,131,594
1980,27340,1126,1261,13577,13269,199,15.8,193,15.3,3421,1711,1710,12.9,25.8,2805,1309,1496,9.9,21.1,616,4.7,42.2,0,139,139,756
1981,27340,1084,1205,12695,13083,158,12.8,203,16.5,2001,690,1311,5.3,15.3,2777,1164,1613,8.9,21.2,-776,-5.9,30.6,0,122,122,422
1982,27340,1152,1297,14140,13419,241,19.2,141,11.3,3451,1786,1665,13.3,25.7,2009,961,1048,7.2,15,1442,10.7,30,0,84,84,404
1983,27340,1149,1309,13886,13995,193,14.8,168,12.9,2727,1164,1563,8.3,19.5,2945,1018,1927,7.3,21,-218,-1.5,39,0,94,94,457
1984,27340,1304,1475,16099,15031,249,17.9,106,7.6,3778,1885,1893,12.5,25.1,1641,534,1107,3.6,10.9,2137,14.2,21.8,0,9,9,94
1985,27340,1436,1611,17579,16843,300,19.5,163,10.6,3631,1995,1636,11.8,21.6,2159,771,1388,4.6,12.8,1472,8.8,25.6,0,107,107,455
1986,27340,1514,1689,18398,17929,300,18.2,212,12.9,3814,1895,1919,10.6,21.3,2876,1149,1727,6.4,16,938,5.3,32,0,150,152,869
1987,27340,1601,1784,20650,19662,337,19.4,230,13.2,5078,2751,2327,14,25.8,3102,1248,1854,6.3,15.8,1976,10,31.6,0,147,148,720
1988,27340,1631,1838,20528,20545,266,14.7,196,10.8,3650,1436,2214,7,17.8,3683,1269,2414,6.2,17.9,-33,-0.1,35.6,0,123,123,798
1989,27340,1662,1868,22863,22049,260,14,227,12.2,4928,2233,2695,10.1,22.4,3300,1346,1954,6.1,15,1628,7.4,30,0,149,149,712
1990,27340,1688,1918,22810,22828,281,14.9,222,11.7,4116,1990,2126,8.7,18,4152,1447,2705,6.3,18.2,-36,-0.2,36,0,172,172,1128
1991,27340,1708,1949,20813,21451,269,13.9,228,11.8,3405,1516,1889,7.1,15.9,4680,1741,2939,8.1,21.8,-1275,-5.9,31.8,0,142,142,676
1992,27340,1724,1985,22014,21397,261,13.2,213,10.8,4455,1780,2675,8.3,20.8,3220,1160,2060,5.4,15,1235,5.8,30,0,161,163,894
1993,27340,1767,2017,23460,22722,238,11.9,195,9.7,4397,1540,2857,6.8,19.4,2920,995,1925,4.4,12.9,1477,6.5,25.8,0,118,118,529
1994,27340,1823,2092,24174,23795,288,14,210,10.2,4500,1782,2718,7.5,18.9,3742,1873,1869,7.9,15.7,758,3.2,31.4,0,158,158,1294
1995,27340,1846,2111,25094,24976,249,11.8,223,10.6,3749,1395,2354,5.6,15,3513,1261,2252,5,14.1,236,0.9,28.2,0,144,144,638
1996,27340,1893,2159,25735,25388,289,13.5,228,10.7,4513,1813,2700,7.1,17.8,3819,1603,2216,6.3,15,694,2.8,30,0,154,154,655
1997,27340,1967,2247,26927,26372,324,14.7,243,11,5089,2622,2467,9.9,19.3,3978,1557,2421,5.9,15.1,1111,4.2,30.2,0,150,150,800
1998,27340,1999,2280,28006,27455,304,13.4,264,11.7,5777,1944,3833,7.1,21,4674,2336,2338,8.5,17,1103,4,34,0,167,167,860
1999,27340,2003,2297,28038,28042,299,13.1,271,11.8,4841,1961,2880,7,17.3,4849,1684,3165,6,17.3,-8,0,34.6,0,187,187,852
2000,27340,2028,2337,28739,28400,266,11.5,228,9.8,5186,2477,2709,8.7,18.3,4508,1472,3036,5.2,15.9,678,2.4,31.8,0,144,144,762
2001,27340,2001,2322,29687,29244,253,10.8,288,12.3,5820,1462,4358,5,19.9,4934,2116,2818,7.2,16.9,886,3,33.8,0,170,170,771
2002,27340,1979,2279,29177,29416,249,10.8,288,12.5,4875,2449,2426,8.3,16.6,5352,1902,3450,6.5,18.2,-477,-1.6,33.2,0,150,150,762
2003,27340,2019,2318,29627,28853,263,11.5,170,7.4,5166,2051,3115,7.1,17.9,3618,781,2837,2.7,12.5,1548,5.4,25,0,117,117,538
2004,27340,2045,2346,30652,30005,233,10,174,7.5,5345,1570,3775,5.2,17.8,4051,1205,2846,4,13.5,1294,4.3,27,0,116,116,539
2005,27340,2048,2356,31547,30999,239,10.2,196,8.4,5588,1889,3699,6.1,18,4491,1056,3435,3.4,14.5,1097,3.5,29,0,132,132,738
2006,27340,2083,2424,30942,31005,305,12.8,214,9,4921,1937,2984,6.2,15.9,5046,1641,3405,5.3,16.3,-125,-0.4,31.8,0,149,149,1000
2007,27340,2154,2514,32068,31587,308,12.5,228,9.2,5882,1990,3892,6.3,18.6,4919,1599,3320,5.1,15.6,963,3,31.2,0,142,145,843
2008,27340,2124,2510,34158,33105,223,8.9,223,8.9,6276,2370,3906,7.2,19,4170,1063,3107,3.2,12.6,2106,6.4,25.2,0,167,167,814
2009,27340,2050,2432,33494,33634,201,8.2,237,9.6,4382,1780,2602,5.3,13,4662,1132,3530,3.4,13.9,-280,-0.9,26,0,168,168,687
2010,27340,2058,2473,33207,33308,246,10.1,209,8.5,4560,2111,2449,6.3,13.7,4762,1291,3471,3.9,14.3,-202,-0.6,27.4,0,152,153,855
2011,27340,2061,2497,32700,32701,248,10,202,8.2,3801,1423,2378,4.4,11.6,3802,947,2855,2.9,11.6,-1,0,23.2,0,123,123,597
2012,27340,2108,2507,34438,33516,244,9.8,235,9.4,6039,1857,4182,5.5,18,4195,1702,2493,5.1,12.5,1844,5.5,25,0,123,129,1043
2013,27340,2122,2525,34551,34477,229,9.2,194,7.8,5046,2209,2837,6.4,14.6,4898,2305,2593,6.7,14.2,148,0.4,28.4,0,129,129,895
2014,27340,2097,2508,35139,34657,225,9,218,8.7,5527,2382,3145,6.9,15.9,4563,1503,3060,4.3,13.2,964,2.7,26.4,0,147,147,870
1977,27500,2183,2378,43011,42015,369,15.8,277,11.9,6892,2966,3926,7.1,16.4,4900,2161,2739,5.1,11.7,1992,4.7,23.4,0,160,160,948
1978,27500,2229,2441,47031,45004,332,13.8,267,11.1,8350,2770,5580,6.2,18.6,4295,2283,2012,5.1,9.5,4055,9.1,19,0,189,189,1019
1979,27500,2291,2495,50009,48495,318,12.9,255,10.3,7112,2260,4852,4.7,14.7,4084,1750,2334,3.6,8.4,3028,6.3,16.8,0,158,158,609
1980,27500,2295,2501,44508,47227,291,11.6,274,11,5219,2244,2975,4.8,11.1,10657,1693,8964,3.6,22.6,-5438,-11.5,22.2,0,194,194,1060
1981,27500,2214,2397,39879,41910,241,9.9,326,13.3,4280,1455,2825,3.5,10.2,8341,2551,5790,6.1,19.9,-4061,-9.7,20.4,0,186,186,843
1982,27500,2202,2435,41758,40813,334,13.8,260,10.8,7371,3089,4282,7.6,18.1,5481,1829,3652,4.5,13.4,1890,4.7,26.8,0,167,167,930
1983,27500,2261,2505,42656,42233,249,10.1,212,8.6,7286,1843,5443,4.4,17.3,6440,1517,4923,3.6,15.2,846,2.1,30.4,0,141,141,886
1984,27500,2328,2570,47180,44899,317,12.5,250,9.9,9017,1678,7339,3.7,20.1,4455,1310,3145,2.9,9.9,4562,10.2,19.8,0,161,162,664
1985,27500,2360,2605,46982,47250,312,12.1,271,10.5,6132,1976,4156,4.2,13,6667,2097,4570,4.4,14.1,-535,-1.1,26,0,190,190,1490
1986,27500,2267,2500,45849,46333,259,10.2,334,13.1,5307,2210,3097,4.8,11.5,6274,2534,3740,5.5,13.5,-967,-2,23,0,174,174,1021
1987,27500,2408,2661,47494,46795,342,13.3,203,7.9,7062,2896,4166,6.2,15.1,5664,1825,3839,3.9,12.1,1398,3,24.2,0,49,50,645
1988,27500,2412,2668,49553,48468,259,9.7,246,9.2,7093,1574,5519,3.2,14.6,4923,1547,3376,3.2,10.2,2170,4.4,20.4,0,165,165,928
1989,27500,2472,2720,51394,50523,304,11.3,263,9.8,7653,2308,5345,4.6,15.1,5911,2952,2959,5.8,11.7,1742,3.4,23.4,0,165,165,1352
1990,27500,2468,2725,51577,51349,275,10.1,255,9.4,6978,2782,4196,5.4,13.6,6521,2927,3594,5.7,12.7,457,0.9,25.4,0,189,189,1624
1991,27500,2492,2766,48655,50099,304,11.1,259,9.4,6348,2696,3652,5.4,12.7,9235,1765,7470,3.5,18.4,-2887,-5.7,25.4,0,178,179,1059
1992,27500,2465,2743,52281,50327,280,10.2,287,10.4,10291,2790,7501,5.5,20.4,6382,2631,3751,5.2,12.7,3909,7.7,25.4,0,188,190,1397
1993,27500,2560,2840,53100,52821,307,11,203,7.3,7005,2457,4548,4.7,13.3,6446,2286,4160,4.3,12.2,559,1.1,24.4,0,143,143,1258
1994,27500,2590,2883,54588,53814,277,9.7,218,7.6,7381,2761,4620,5.1,13.7,5833,1749,4084,3.3,10.8,1548,2.9,21.6,0,158,158,997
1995,27500,2634,2923,56950,55711,288,9.9,238,8.2,8007,2023,5984,3.6,14.4,5529,2340,3189,4.2,9.9,2478,4.5,19.8,0,159,159,1330
1996,27500,2656,2952,57356,57210,265,9,247,8.4,6488,1904,4584,3.3,11.3,6196,1590,4606,2.8,10.8,292,0.5,21.6,0,180,180,833
1997,27500,2678,2980,58051,57795,325,10.9,288,9.7,7772,2268,5504,3.9,13.4,7259,2334,4925,4,12.6,513,0.8,25.2,0,185,185,1080
1998,27500,2676,3012,59332,58607,300,10,262,8.7,7938,2737,5201,4.7,13.5,6488,1677,4811,2.9,11.1,1450,2.4,22.2,0,191,191,1070
1999,27500,2679,3030,60871,60252,276,9.1,257,8.5,7177,1864,5313,3.1,11.9,5939,1541,4398,2.6,9.9,1238,2,19.8,0,167,167,821
2000,27500,2679,3041,60249,60751,272,9,265,8.7,6923,2555,4368,4.2,11.4,7927,4022,3905,6.6,13,-1004,-1.6,22.8,0,169,169,1909
2001,27500,2711,3088,58379,59368,317,10.3,291,9.5,6619,2552,4067,4.3,11.1,8596,2390,6206,4,14.5,-1977,-3.4,22.2,0,182,182,868
2002,27500,2707,3091,58393,58370,344,11.2,332,10.8,7644,2683,4961,4.6,13.1,7597,2657,4940,4.6,13,47,0.1,26,0,165,165,813
2003,27500,2733,3137,59312,58564,342,11,258,8.3,6859,2365,4494,4,11.7,5362,1852,3510,3.2,9.2,1497,2.5,18.4,0,173,173,1099
2004,27500,2732,3142,60588,59800,289,9.2,258,8.2,7604,1765,5839,3,12.7,6027,1506,4521,2.5,10.1,1577,2.6,20.2,0,173,175,864
2005,27500,2796,3199,59302,59750,339,10.7,252,8,7160,3086,4074,5.2,12,8056,1746,6310,2.9,13.5,-896,-1.5,24,0,169,169,1057
2006,27500,2775,3197,60773,59860,301,9.4,278,8.7,8383,2724,5659,4.6,14,6557,2482,4075,4.1,11,1826,3,22,0,183,183,1478
2007,27500,2823,3246,61755,61206,331,10.3,285,8.9,8717,3006,5711,4.9,14.2,7619,1819,5800,3,12.4,1098,1.8,24.8,0,170,170,990
2008,27500,2781,3205,60377,60930,279,8.7,289,9,6952,2372,4580,3.9,11.4,8058,2723,5335,4.5,13.2,-1106,-1.8,22.8,0,200,200,1406
2009,27500,2678,3094,52032,54587,211,6.7,299,9.5,4117,1347,2770,2.5,7.5,9227,2522,6705,4.6,16.9,-5110,-9.4,15,0,208,208,1045
2010,27500,2624,3049,50791,51340,221,7.2,241,7.9,5237,1650,3587,3.2,10.2,6335,1639,4696,3.2,12.3,-1098,-2.1,20.4,0,154,154,1009
2011,27500,2583,2981,49351,49877,199,6.6,238,7.9,4575,1070,3505,2.1,9.2,5626,2012,3614,4,11.3,-1051,-2.1,18.4,0,140,140,1098
2012,27500,2571,2975,52196,50713,241,8.1,246,8.3,7631,2367,5264,4.7,15,4664,1412,3252,2.8,9.2,2967,5.8,18.4,0,141,141,631
2013,27500,2522,2935,53635,52924,197,6.7,240,8.1,6865,1412,5453,2.7,13,5443,1529,3914,2.9,10.3,1422,2.7,20.6,0,153,154,602
2014,27500,2528,2934,53770,53467,227,7.8,211,7.2,5477,918,4559,1.7,10.2,4871,1166,3705,2.2,9.1,606,1.1,18.2,0,133,133,639
1977,27620,1974,2110,24458,23385,290,13.8,263,12.5,5466,3273,2193,14,23.4,3319,1567,1752,6.7,14.2,2147,9.2,28.4,0,189,190,990
1978,27620,2066,2199,26587,25505,327,15.2,233,10.8,5336,1935,3401,7.6,20.9,3171,1556,1615,6.1,12.4,2165,8.5,24.8,0,155,156,917
1979,27620,2111,2251,29025,27784,315,14.2,246,11.1,5844,1877,3967,6.8,21,3361,1407,1954,5.1,12.1,2483,8.9,24.2,0,190,190,954
1980,27620,2113,2259,28241,28580,289,12.8,273,12.1,4086,1653,2433,5.8,14.3,4763,1665,3098,5.8,16.7,-677,-2.4,28.6,0,204,205,967
1981,27620,2021,2162,27548,27164,223,10.2,262,11.9,4529,1843,2686,6.8,16.7,3760,1310,2450,4.8,13.8,769,2.9,27.6,0,166,166,783
1982,27620,2042,2211,29032,28278,297,13.6,222,10.1,5468,2475,2993,8.8,19.3,3959,1311,2648,4.6,14,1509,5.3,28,0,129,129,745
1983,27620,2109,2274,28061,28559,249,11.1,207,9.2,3956,1312,2644,4.6,13.9,4952,1353,3599,4.7,17.3,-996,-3.4,27.8,0,120,121,521
1984,27620,2177,2342,30023,29261,302,13.1,245,10.6,5315,1634,3681,5.6,18.2,3790,1982,1808,6.8,13,1525,5.2,26,0,144,144,1021
1985,27620,2300,2486,32341,31683,344,14.2,225,9.3,5692,1815,3877,5.7,18,4376,1312,3064,4.1,13.8,1316,4.2,27.6,0,153,153,629
1986,27620,2358,2544,34092,33213,291,11.6,233,9.3,5802,2259,3543,6.8,17.5,4043,1214,2829,3.7,12.2,1759,5.3,24.4,0,128,128,483
1987,27620,2431,2631,36824,36122,345,13.3,251,9.7,6362,2099,4263,5.8,17.6,4958,1485,3473,4.1,13.7,1404,3.9,27.4,0,168,168,967
1988,27620,2385,2594,37319,36413,272,10.5,276,10.6,6160,2435,3725,6.7,16.9,4348,1315,3033,3.6,11.9,1812,5,23.8,0,179,179,659
1989,27620,2418,2632,38464,37825,290,11.1,249,9.5,5737,1412,4325,3.7,15.2,4459,1194,3265,3.2,11.8,1278,3.4,23.6,0,175,175,671
1990,27620,2408,2619,39610,39097,230,8.8,230,8.8,5391,1339,4052,3.4,13.8,4364,1298,3066,3.3,11.2,1027,2.6,22.4,0,144,144,509
1991,27620,2441,2690,38998,39380,303,11.4,234,8.8,5717,2349,3368,6,14.5,6481,2660,3821,6.8,16.5,-764,-2,29,0,159,159,875
1992,27620,2485,2750,38896,38501,300,11,221,8.1,5897,1888,4009,4.9,15.3,5106,1831,3275,4.8,13.3,791,2,26.6,0,137,139,1306
1993,27620,2538,2807,39933,39405,289,10.4,229,8.2,5619,1863,3756,4.7,14.3,4565,1723,2842,4.4,11.6,1054,2.7,23.2,0,152,152,972
1994,27620,2554,2835,42646,41339,270,9.6,235,8.3,6256,2224,4032,5.4,15.1,3643,1318,2325,3.2,8.8,2613,6.3,17.6,0,163,164,662
1995,27620,2627,2902,43210,42580,322,11.2,241,8.4,5456,1853,3603,4.4,12.8,4196,1410,2786,3.3,9.9,1260,2.9,19.8,0,158,159,887
1996,27620,2715,2991,45629,44462,350,11.9,258,8.8,6746,2346,4400,5.3,15.2,4411,1651,2760,3.7,9.9,2335,5.3,19.8,0,183,183,748
1997,27620,2691,2990,45440,45587,321,10.7,314,10.5,5846,1881,3965,4.1,12.8,6140,2597,3543,5.7,13.5,-294,-0.7,25.6,0,204,204,992
1998,27620,2742,3040,46235,45824,316,10.5,258,8.6,6020,2137,3883,4.7,13.1,5197,1310,3887,2.9,11.3,823,1.8,22.6,0,179,179,827
1999,27620,2780,3091,49535,47871,345,11.3,288,9.4,8385,2980,5405,6.2,17.5,5056,1545,3511,3.2,10.6,3329,6.9,21.2,0,198,198,940
2000,27620,2813,3137,51558,50550,330,10.6,286,9.2,7221,1865,5356,3.7,14.3,5204,1581,3623,3.1,10.3,2017,4,20.6,0,186,186,782
2001,27620,2801,3127,50860,51246,305,9.7,333,10.6,5903,1897,4006,3.7,11.5,6674,2008,4666,3.9,13,-771,-1.5,23,0,217,217,1079
2002,27620,2819,3159,49582,50194,366,11.7,330,10.5,6617,2943,3674,5.9,13.2,7840,2128,5712,4.2,15.6,-1223,-2.4,26.4,0,176,177,808
2003,27620,2844,3201,49556,49406,345,10.9,247,7.8,5975,1836,4139,3.7,12.1,5675,1331,4344,2.7,11.5,300,0.6,23,0,176,176,835
2004,27620,2948,3305,49379,49249,384,11.8,247,7.6,6980,2627,4353,5.3,14.2,6720,1122,5598,2.3,13.6,260,0.6,27.2,0,169,169,693
2005,27620,2999,3368,51217,50258,350,10.5,271,8.1,7829,3767,4062,7.5,15.6,5910,1341,4569,2.7,11.8,1919,3.8,23.6,0,198,199,852
2006,27620,2956,3344,51170,51105,351,10.5,339,10.1,6360,2713,3647,5.3,12.4,6229,1895,4334,3.7,12.2,131,0.2,24.4,0,241,241,1093
2007,27620,3008,3419,51829,51503,366,10.8,303,9,7514,2836,4678,5.5,14.6,6861,1729,5132,3.4,13.3,653,1.3,26.6,0,198,204,1086
2008,27620,2969,3372,51369,51327,261,7.7,296,8.7,5520,1259,4261,2.5,10.8,5435,1339,4096,2.6,10.6,85,0.2,21.2,0,227,227,1076
2009,27620,2885,3300,49789,50484,250,7.5,300,9,5532,1996,3536,4,11,6921,1883,5038,3.7,13.7,-1389,-2.7,22,0,222,222,1233
2010,27620,2851,3294,49476,49600,271,8.2,262,8,5590,2133,3457,4.3,11.3,5838,1099,4739,2.2,11.8,-248,-0.5,22.6,0,169,169,769
2011,27620,2787,3227,48895,49084,213,6.6,255,7.8,4431,1236,3195,2.5,9,4808,1235,3573,2.5,9.8,-377,-0.8,18,0,175,175,890
2012,27620,2824,3264,49081,48986,276,8.5,237,7.3,5256,1652,3604,3.4,10.7,5065,1335,3730,2.7,10.3,191,0.4,20.6,0,145,146,677
2013,27620,2846,3295,49293,49179,231,7.1,207,6.3,4961,1545,3416,3.1,10.1,4733,854,3879,1.7,9.6,228,0.5,19.2,0,144,145,513
2014,27620,2828,3268,49367,48963,240,7.3,235,7.2,4886,1319,3567,2.7,10,4078,1401,2677,2.9,8.3,808,1.7,16.6,0,160,160,700
1977,27740,2163,2335,34047,32719,359,15.7,252,11,6966,2081,4885,6.4,21.3,4309,1520,2789,4.6,13.2,2657,8.1,26.4,0,185,185,703
1978,27740,2216,2395,37398,35721,311,13.2,251,10.6,6728,2347,4381,6.6,18.8,3374,1232,2142,3.4,9.4,3354,9.4,18.8,0,181,181,801
1979,27740,2255,2434,40674,38972,333,13.8,274,11.4,8057,2184,5873,5.6,20.7,4652,1940,2712,5,11.9,3405,8.8,23.8,0,192,192,1020
1980,27740,2304,2505,41477,41072,340,13.8,265,10.7,7237,3681,3556,9,17.6,6427,1632,4795,4,15.6,810,2,31.2,0,188,188,918
1981,27740,2214,2411,38249,39192,284,11.6,337,13.8,5260,1787,3473,4.6,13.4,7145,2556,4589,6.5,18.2,-1885,-4.8,26.8,0,210,210,898
1982,27740,2188,2401,36761,37491,340,14.1,314,13,4751,2059,2692,5.5,12.7,6210,1772,4438,4.7,16.6,-1459,-3.9,25.4,0,192,192,917
1983,27740,2238,2452,36989,36938,272,11.2,257,10.6,5627,2248,3379,6.1,15.2,5525,1663,3862,4.5,15,102,0.2,30,0,168,175,1058
1984,27740,2372,2589,39479,38239,409,16.2,280,11.1,6825,2360,4465,6.2,17.8,4345,1601,2744,4.2,11.4,2480,6.4,22.8,0,192,192,963
1985,27740,2452,2668,41379,40824,350,13.3,288,10.9,7571,2793,4778,6.8,18.5,6461,3866,2595,9.5,15.8,1110,2.7,31.6,0,190,192,1323
1986,27740,2494,2719,43186,42379,338,12.5,278,10.3,7333,2715,4618,6.4,17.3,5718,2201,3517,5.2,13.5,1615,3.8,27,0,199,199,1128
1987,27740,2611,2862,47150,45862,388,13.9,234,8.4,7435,2489,4946,5.4,16.2,4858,1242,3616,2.7,10.6,2577,5.6,21.2,0,166,168,679
1988,27740,2637,2905,47776,46789,361,12.6,295,10.3,7884,3006,4878,6.4,16.9,5909,1923,3986,4.1,12.6,1975,4.3,25.2,0,209,209,1090
1989,27740,2662,2952,50581,49304,329,11.2,277,9.5,7839,2594,5245,5.3,15.9,5284,2231,3053,4.5,10.7,2555,5.2,21.4,0,204,204,1593
1990,27740,2669,2977,52502,51524,295,10,256,8.6,7572,2338,5234,4.5,14.7,5616,1710,3906,3.3,10.9,1956,3.8,21.8,0,184,184,864
1991,27740,2698,3030,49952,51205,333,11.1,287,9.6,5967,2320,3647,4.5,11.7,8472,2669,5803,5.2,16.5,-2505,-4.8,23.4,0,181,181,1531
1992,27740,2729,3063,52594,51263,374,12.3,333,10.9,9345,3974,5371,7.8,18.2,6683,2639,4044,5.1,13,2662,5.2,26,0,218,223,1762
1993,27740,2820,3156,55058,53817,343,11,247,7.9,9437,3886,5551,7.2,17.5,6954,2584,4370,4.8,12.9,2483,4.6,25.8,0,172,172,1038
1994,27740,2857,3207,55506,55269,334,10.5,269,8.5,7664,2205,5459,4,13.9,7189,2410,4779,4.4,13,475,0.9,26,0,180,180,878
1995,27740,2915,3262,59149,57327,356,11,285,8.8,9930,3813,6117,6.7,17.3,6286,2322,3964,4.1,11,3644,6.3,22,0,204,204,963
1996,27740,2953,3321,61001,60121,377,11.5,321,9.8,9922,4388,5534,7.3,16.5,8162,2310,5852,3.8,13.6,1760,2.9,27.2,0,221,221,1033
1997,27740,2979,3379,63026,62054,442,13.2,382,11.4,13492,7157,6335,11.5,21.7,11548,5512,6036,8.9,18.6,1944,3.1,37.2,0,241,241,2292
1998,27740,3024,3426,64593,63772,393,11.6,345,10.1,8799,2796,6003,4.4,13.8,7157,2146,5011,3.4,11.2,1642,2.6,22.4,0,229,229,1108
1999,27740,3012,3434,67227,65813,377,11,353,10.3,10912,5443,5469,8.3,16.6,8084,2319,5765,3.5,12.3,2828,4.3,24.6,0,219,219,1028
2000,27740,2978,3401,65550,66404,333,9.7,373,10.9,10321,3649,6672,5.5,15.5,12028,6644,5384,10,18.1,-1707,-2.6,31,0,208,208,987
2001,27740,2984,3406,63767,64817,342,10,360,10.6,7701,2819,4882,4.3,11.9,9800,2705,7095,4.2,15.1,-2099,-3.2,23.8,0,202,202,1061
2002,27740,3040,3451,60304,61465,421,12.3,373,10.9,8716,2896,5820,4.7,14.2,11038,4923,6115,8,18,-2322,-3.8,28.4,0,204,204,1400
2003,27740,2999,3437,63017,61269,334,9.7,299,8.7,10485,5179,5306,8.5,17.1,6988,1560,5428,2.5,11.4,3497,5.7,22.8,0,218,218,1201
2004,27740,3049,3502,64148,63235,380,11,282,8.1,11131,5161,5970,8.2,17.6,9305,4111,5194,6.5,14.7,1826,2.9,29.4,0,203,203,1304
2005,27740,3060,3537,65020,64436,329,9.4,265,7.5,8809,2877,5932,4.5,13.7,7640,2207,5433,3.4,11.9,1169,1.8,23.8,0,189,189,910
2006,27740,3061,3565,66349,65586,340,9.6,301,8.5,8924,2866,6058,4.4,13.6,7397,2391,5006,3.6,11.3,1527,2.3,22.6,0,218,219,1399
2007,27740,3111,3654,68136,67157,385,10.7,309,8.5,11455,4324,7131,6.4,17.1,9497,1798,7699,2.7,14.1,1958,3,28.2,0,199,199,893
2008,27740,3084,3647,67124,67441,325,8.9,296,8.1,8931,3020,5911,4.5,13.2,9564,2895,6669,4.3,14.2,-633,-1,26.4,0,218,221,1966
2009,27740,3013,3586,63011,64937,289,8,317,8.8,6610,2927,3683,4.5,10.2,10462,2769,7693,4.3,16.1,-3852,-5.9,20.4,0,221,221,1379
2010,27740,2970,3550,62906,62767,283,8,285,8,8147,4247,3900,6.8,13,7869,2029,5840,3.2,12.5,278,0.5,25,0,188,188,1095
2011,27740,2927,3501,61691,61837,268,7.6,278,7.9,6712,2372,4340,3.8,10.9,7003,2097,4906,3.4,11.3,-291,-0.4,21.8,0,196,196,1691
2012,27740,2900,3482,63822,62676,304,8.7,316,9.1,8662,2851,5811,4.5,13.8,6369,2533,3836,4,10.2,2293,3.6,20.4,0,199,200,1703
2013,27740,2881,3460,63297,63475,247,7.1,270,7.8,6458,1526,4932,2.4,10.2,6814,1823,4991,2.9,10.7,-356,-0.5,20.4,0,173,173,1133
2014,27740,2880,3496,64642,63894,307,8.9,252,7.3,8086,3831,4255,6,12.7,6589,1950,4639,3.1,10.3,1497,2.4,20.6,0,191,191,1350
1977,27780,2616,2922,58638,55771,350,12.1,278,9.6,11928,2844,9084,5.1,21.4,6194,2320,3874,4.2,11.1,5734,10.3,22.2,0,185,185,1125
1978,27780,2613,2908,48943,53789,294,10.1,305,10.5,6689,1962,4727,3.6,12.4,16381,1825,14556,3.4,30.5,-9692,-18.1,24.8,0,196,196,1054
1979,27780,2664,2970,52594,50765,300,10.2,228,7.8,8413,1757,6656,3.5,16.6,4755,1503,3252,3,9.4,3658,7.2,18.8,0,152,153,1007
1980,27780,2659,2962,51258,52086,285,9.6,275,9.3,5070,1901,3169,3.6,9.7,6725,1983,4742,3.8,12.9,-1655,-3.2,19.4,0,185,185,982
1981,27780,2480,2777,45655,47831,207,7.2,349,12.2,3757,1621,2136,3.4,7.9,8108,2641,5467,5.5,17,-4351,-9.1,15.8,0,196,196,947
1982,27780,2494,2815,44834,45256,313,11.2,245,8.8,5406,2220,3186,4.9,11.9,6250,1183,5067,2.6,13.8,-844,-1.9,23.8,0,141,141,635
1983,27780,2535,2848,40744,42825,250,8.8,256,9,5191,1609,3582,3.8,12.1,9352,2217,7135,5.2,21.8,-4161,-9.7,24.2,0,151,151,716
1984,27780,2591,2913,42070,41401,310,10.8,245,8.5,5754,1987,3767,4.8,13.9,4416,1293,3123,3.1,10.7,1338,3.2,21.4,0,145,145,579
1985,27780,2659,2973,41942,42233,329,11.2,275,9.3,5701,1918,3783,4.5,13.5,6282,2703,3579,6.4,14.9,-581,-1.4,27,0,164,164,1742
1986,27780,2699,3015,43601,42764,340,11.4,287,9.6,8037,3250,4787,7.6,18.8,6362,2198,4164,5.1,14.9,1675,3.9,29.8,0,186,186,1015
1987,27780,2725,3069,45683,44633,353,11.6,288,9.5,7335,2456,4879,5.5,16.4,5234,1798,3436,4,11.7,2101,4.7,23.4,0,204,204,1024
1988,27780,2715,3064,46444,45842,295,9.6,273,8.9,6499,2122,4377,4.6,14.2,5294,1496,3798,3.3,11.5,1205,2.7,23,0,171,171,778
1989,27780,2756,3124,48197,47332,319,10.3,253,8.2,6857,2002,4855,4.2,14.5,5127,1337,3790,2.8,10.8,1730,3.7,21.6,0,182,182,862
1990,27780,2773,3144,48106,47993,260,8.3,224,7.2,5926,2220,3706,4.6,12.3,5700,1950,3750,4.1,11.9,226,0.4,23.8,0,156,156,1050
1991,27780,2785,3179,47657,47851,296,9.4,265,8.4,5957,2544,3413,5.3,12.4,6344,2000,4344,4.2,13.3,-387,-0.9,24.8,0,167,167,1045
1992,27780,2773,3183,48479,48107,282,8.9,264,8.3,6429,2156,4273,4.5,13.4,5685,1514,4171,3.1,11.8,744,1.6,23.6,0,180,181,942
1993,27780,2777,3193,47865,48083,282,8.8,249,7.8,7353,3231,4122,6.7,15.3,7788,2496,5292,5.2,16.2,-435,-0.9,30.6,0,168,168,791
1994,27780,2800,3210,46634,47049,261,8.2,234,7.3,5934,2064,3870,4.4,12.6,6763,2408,4355,5.1,14.4,-829,-1.8,25.2,0,144,144,732
1995,27780,2851,3265,48414,47518,276,8.5,218,6.7,6511,2527,3984,5.3,13.7,4719,1433,3286,3,9.9,1792,3.8,19.8,0,140,141,716
1996,27780,2843,3266,49427,49162,286,8.8,273,8.4,5571,2100,3471,4.3,11.3,5041,1573,3468,3.2,10.3,530,1,20.6,0,200,200,890
1997,27780,2806,3242,48969,49205,274,8.4,293,9,8460,2389,6071,4.9,17.2,8932,3654,5278,7.4,18.2,-472,-1,34.4,0,173,173,1825
1998,27780,2786,3222,49899,49427,256,7.9,277,8.6,6781,1799,4982,3.6,13.7,5836,1658,4178,3.4,11.8,945,1.9,23.6,0,173,173,917
1999,27780,2809,3267,51609,50836,282,8.7,246,7.6,7386,2390,4996,4.7,14.5,5839,1638,4201,3.2,11.5,1547,3,23,0,157,157,953
2000,27780,2801,3254,51508,51480,255,7.8,264,8.1,7144,2843,4301,5.5,13.9,7087,1776,5311,3.4,13.8,57,0.1,27.6,0,152,152,735
2001,27780,2772,3247,49760,50713,243,7.5,281,8.6,5519,2002,3517,3.9,10.9,7425,1834,5591,3.6,14.6,-1906,-3.7,21.8,0,167,167,721
2002,27780,2777,3256,49803,49739,323,9.9,304,9.4,8061,3557,4504,7.2,16.2,7932,2980,4952,6,15.9,129,0.3,31.8,0,149,149,966
2003,27780,2761,3252,48796,48927,245,7.6,210,6.5,5826,1355,4471,2.8,11.9,6088,2300,3788,4.7,12.4,-262,-0.5,23.8,0,137,137,728
2004,27780,2732,3230,49589,48980,235,7.3,229,7.1,6137,2144,3993,4.4,12.5,4918,1684,3234,3.4,10,1219,2.5,20,0,151,151,872
2005,27780,2746,3257,50146,49372,273,8.4,215,6.6,7114,2519,4595,5.1,14.4,5565,1397,4168,2.8,11.3,1549,3.1,22.6,0,145,146,784
2006,27780,2739,3274,51303,50635,304,9.3,265,8.1,7815,2536,5279,5,15.4,6479,1996,4483,3.9,12.8,1336,2.6,25.6,0,173,174,1317
2007,27780,2707,3235,49521,50396,251,7.7,279,8.6,7933,1676,6257,3.3,15.7,9682,5335,4347,10.6,19.2,-1749,-3.5,31.4,0,151,154,578
2008,27780,2697,3221,50351,49783,206,6.4,181,5.6,5950,1324,4626,2.7,12,4814,1078,3736,2.2,9.7,1136,2.3,19.4,0,123,123,702
2009,27780,2659,3188,48786,49416,178,5.6,188,5.9,4789,1256,3533,2.5,9.7,6048,1684,4364,3.4,12.2,-1259,-2.5,19.4,0,122,122,1280
2010,27780,2615,3150,50768,49706,164,5.2,190,6,6855,3497,3358,7,13.8,4730,1253,3477,2.5,9.5,2125,4.3,19,0,118,118,733
2011,27780,2583,3129,49129,49890,193,6.2,192,6.1,4546,1183,3363,2.4,9.1,6068,1612,4456,3.2,12.2,-1522,-3.1,18.2,0,121,121,1210
2012,27780,2565,3112,48712,48877,196,6.3,206,6.6,5122,1876,3246,3.8,10.5,5452,1807,3645,3.7,11.2,-330,-0.7,21,0,115,117,675
2013,27780,2555,3100,47189,47855,171,5.5,181,5.8,5024,1421,3603,3,10.5,6356,2557,3799,5.3,13.3,-1332,-2.8,21,0,121,121,1962
2014,27780,2521,3051,51205,49104,166,5.4,188,6.1,8749,1279,7470,2.6,17.8,4547,1055,3492,2.1,9.3,4202,8.5,18.6,0,129,134,550
1977,27860,1684,1803,22720,21846,353,20.1,255,14.5,4766,2226,2540,10.2,21.8,3017,1166,1851,5.3,13.8,1749,8,27.6,0,190,190,796
1978,27860,1600,1720,23218,22949,270,15.3,338,19.2,4449,1424,3025,6.2,19.4,3911,1480,2431,6.4,17,538,2.4,34,0,205,206,760
1979,27860,1762,1880,25724,24482,318,17.7,168,9.3,5321,2846,2475,11.6,21.7,2837,662,2175,2.7,11.6,2484,10.1,23.2,1,3,3,
1980,27860,1712,1824,25708,25636,227,12.3,273,14.7,3679,1300,2379,5.1,14.4,3534,1235,2299,4.8,13.8,145,0.6,27.6,0,200,201,735
1981,27860,1624,1729,23339,24027,229,13,289,16.4,3951,1975,1976,8.2,16.4,5327,2307,3020,9.6,22.2,-1376,-5.8,32.8,0,177,178,791
1982,27860,1589,1720,23759,23561,241,14,220,12.8,4521,2152,2369,9.1,19.2,4124,1756,2368,7.5,17.5,397,1.7,35,0,129,129,682
1983,27860,1617,1741,23070,23256,189,10.9,184,10.6,3372,1328,2044,5.7,14.5,3743,1861,1882,8,16.1,-371,-1.6,29,0,117,117,579
1984,27860,1652,1777,24177,23625,242,13.8,208,11.8,4656,2086,2570,8.8,19.7,3551,1496,2055,6.3,15,1105,4.7,30,0,152,155,1202
1985,27860,1741,1866,25521,25473,258,14.1,194,10.6,4195,1527,2668,6,16.5,4098,1856,2242,7.3,16.1,97,0.4,32.2,0,128,128,592
1986,27860,1786,1913,27521,26491,260,13.8,199,10.5,5696,2226,3470,8.4,21.5,3636,1408,2228,5.3,13.7,2060,7.8,27.4,0,142,142,970
1987,27860,1830,1971,28638,28215,286,14.7,216,11.1,4747,1743,3004,6.2,16.8,3900,1555,2345,5.5,13.8,847,3,27.6,0,153,153,849
1988,27860,1780,1928,27590,27125,229,11.8,228,11.8,4551,1506,3045,5.6,16.8,3620,1334,2286,4.9,13.3,931,3.5,26.6,0,164,164,679
1989,27860,1799,1962,28701,28140,231,11.9,194,10,4464,1900,2564,6.8,15.9,3341,1004,2337,3.6,11.9,1123,4,23.8,0,142,144,621
1990,27860,1835,2005,29925,29450,237,11.9,175,8.8,4402,1391,3011,4.7,14.9,3451,1194,2257,4.1,11.7,951,3.2,23.4,0,128,128,919
1991,27860,1850,2038,29738,29896,243,12,217,10.7,4517,2044,2473,6.8,15.1,4832,1690,3142,5.7,16.2,-315,-1.1,30.2,0,146,147,920
1992,27860,1917,2115,30574,30131,270,13,188,9,5095,1556,3539,5.2,16.9,4208,1519,2689,5,14,887,2.9,28,0,132,133,765
1993,27860,1920,2122,31145,30841,243,11.5,223,10.5,4379,1132,3247,3.7,14.2,3771,1317,2454,4.3,12.2,608,2,24.4,0,147,149,621
1994,27860,2007,2224,32008,31511,311,14.3,215,9.9,5341,2196,3145,7,16.9,4347,1687,2660,5.4,13.8,994,3.1,27.6,0,158,158,884
1995,27860,2093,2311,35006,33567,306,13.5,209,9.2,6115,1845,4270,5.5,18.2,3237,926,2311,2.8,9.6,2878,8.6,19.2,0,154,154,621
1996,27860,2100,2337,34871,34908,292,12.6,260,11.2,5325,2145,3180,6.1,15.3,5398,1569,3829,4.5,15.5,-73,-0.2,30.6,0,186,186,932
1997,27860,2153,2416,36588,35759,312,13.1,243,10.2,6139,2904,3235,8.1,17.2,4481,1317,3164,3.7,12.5,1658,4.7,25,0,164,164,926
1998,27860,2148,2418,38020,37306,256,10.6,247,10.2,6216,2521,3695,6.8,16.7,4788,1915,2873,5.1,12.8,1428,3.9,25.6,0,167,167,884
1999,27860,2126,2381,38943,38474,266,11.1,291,12.1,6656,2857,3799,7.4,17.3,5717,3055,2662,7.9,14.9,939,2.4,29.8,0,184,184,1415
2000,27860,2125,2384,39398,39103,269,11.3,269,11.3,6292,2626,3666,6.7,16.1,5702,2434,3268,6.2,14.6,590,1.5,29.2,0,168,168,990
2001,27860,2130,2405,38996,39321,251,10.4,269,11.2,5555,2155,3400,5.5,14.1,6205,1554,4651,4,15.8,-650,-1.7,28.2,0,160,160,864
2002,27860,2148,2440,38539,38623,315,13,267,11.1,6440,2827,3613,7.3,16.7,6607,2241,4366,5.8,17.1,-167,-0.4,33.4,0,154,154,841
2003,27860,2181,2471,38645,38129,301,12.3,216,8.9,5873,2450,3423,6.4,15.4,4840,1561,3279,4.1,12.7,1033,2.7,25.4,0,162,164,778
2004,27860,2207,2489,39579,38998,280,11.3,238,9.6,6375,2783,3592,7.1,16.3,5213,2012,3201,5.2,13.4,1162,2.9,26.8,0,161,161,1009
2005,27860,2229,2543,40225,39848,292,11.6,214,8.5,5621,1965,3656,4.9,14.1,4867,1557,3310,3.9,12.2,754,1.9,24.4,0,172,172,1275
2006,27860,2230,2565,42048,40989,314,12.3,268,10.5,7260,3222,4038,7.9,17.7,5142,2139,3003,5.2,12.5,2118,5.2,25,0,184,187,1198
2007,27860,2248,2604,41328,41503,315,12.2,264,10.3,6318,2809,3509,6.8,15.2,6668,1521,5147,3.7,16.1,-350,-0.9,30.4,0,190,190,1097
2008,27860,2199,2539,40384,40545,237,9.3,257,10.1,4876,1690,3186,4.2,12,5198,1590,3608,3.9,12.8,-322,-0.8,24,0,170,170,985
2009,27860,2201,2541,39853,40062,236,9.3,221,8.7,5363,2514,2849,6.3,13.4,5780,1605,4175,4,14.4,-417,-1,26.8,0,161,164,1226
2010,27860,2186,2537,39293,39616,228,9,209,8.3,4250,1641,2609,4.1,10.7,4896,1279,3617,3.2,12.4,-646,-1.7,21.4,0,149,149,670
2011,27860,2173,2530,39383,39252,204,8.1,201,8,4866,1561,3305,4,12.4,4603,1760,2843,4.5,11.7,263,0.7,23.4,0,137,137,1015
2012,27860,2202,2567,40626,39996,226,8.9,200,7.9,5874,2007,3867,5,14.7,4614,1409,3205,3.5,11.5,1260,3.2,23,0,136,137,887
2013,27860,2225,2606,41983,41299,245,9.5,209,8.1,6072,1998,4074,4.8,14.7,4704,1777,2927,4.3,11.4,1368,3.3,22.8,0,152,152,1065
2014,27860,2201,2577,43442,42554,225,8.7,218,8.5,5816,1706,4110,4,13.7,4039,1315,2724,3.1,9.5,1777,4.2,19,0,170,170,909
1977,27900,2453,2685,36446,35164,443,16.8,338,12.8,7876,3227,4649,9.2,22.4,5312,2933,2379,8.3,15.1,2564,7.3,30.2,0,237,238,1819
1978,27900,2464,2695,37562,37003,364,13.5,351,13,6047,1917,4130,5.2,16.3,4928,1478,3450,4,13.3,1119,3,26.6,0,239,239,865
1979,27900,2528,2775,40719,39128,374,13.7,283,10.3,7634,2331,5303,6,19.5,4451,1988,2463,5.1,11.4,3183,8.1,22.8,0,198,198,1024
1980,27900,2620,2878,41767,41224,419,14.8,301,10.7,6582,2647,3935,6.4,16,5495,1869,3626,4.5,13.3,1087,2.7,26.6,0,236,237,1271
1981,27900,2504,2733,40595,40559,319,11.4,424,15.2,7374,3139,4235,7.7,18.2,7302,3683,3619,9.1,18,72,0.2,36,0,261,262,1104
1982,27900,2461,2709,39987,40144,386,14.2,364,13.4,5897,2862,3035,7.1,14.7,6210,2213,3997,5.5,15.5,-313,-0.8,29.4,0,227,229,1085
1983,27900,2494,2733,39843,39675,329,12.1,321,11.8,6533,3012,3521,7.6,16.5,6197,2092,4105,5.3,15.6,336,0.9,31.2,0,225,225,1241
1984,27900,2557,2799,42364,41094,385,13.9,322,11.6,7845,3170,4675,7.7,19.1,5305,2200,3105,5.4,12.9,2540,6.2,25.8,0,215,216,1479
1985,27900,2658,2889,45791,44463,398,14,318,11.1,7529,2515,5014,5.7,16.9,4872,1785,3087,4,11,2657,5.9,22,0,201,201,873
1986,27900,2793,3023,47487,46624,431,14.6,291,9.8,7715,3113,4602,6.7,16.5,5989,2361,3628,5.1,12.8,1726,3.7,25.6,0,167,170,1002
1987,27900,2884,3150,49701,48757,506,16.4,378,12.2,8798,4165,4633,8.5,18,6910,2893,4017,5.9,14.2,1888,3.8,28.4,0,236,236,1389
1988,27900,2822,3122,51890,50242,391,12.5,364,11.6,10242,3889,6353,7.7,20.4,6945,2850,4095,5.7,13.8,3297,6.6,27.6,0,254,254,1058
1989,27900,2862,3163,53314,52620,388,12.3,338,10.8,7866,2440,5426,4.6,14.9,6478,2248,4230,4.3,12.3,1388,2.6,24.6,0,247,247,1521
1990,27900,2905,3203,52647,52574,360,11.3,303,9.5,6774,1970,4804,3.7,12.9,6627,2487,4140,4.7,12.6,147,0.3,25.2,0,197,197,886
1991,27900,2956,3290,54905,54094,403,12.4,320,9.9,8091,2988,5103,5.5,15,6468,2449,4019,4.5,12,1623,3,24,0,208,209,1501
1992,27900,3024,3383,56319,55551,444,13.3,338,10.1,10272,3429,6843,6.2,18.5,8735,3950,4785,7.1,15.7,1537,2.8,31.4,0,234,235,1818
1993,27900,3064,3439,59431,58015,413,12.1,341,10,9351,3243,6108,5.6,16.1,6519,2447,4072,4.2,11.2,2832,4.9,22.4,0,247,247,1497
1994,27900,3132,3504,62188,60809,432,12.4,371,10.7,10102,3497,6605,5.8,16.6,7344,2977,4367,4.9,12.1,2758,4.5,24.2,0,271,271,1988
1995,27900,3161,3533,64668,63389,422,12,378,10.7,13238,5513,7725,8.7,20.9,10680,2381,8299,3.8,16.8,2558,4.1,33.6,0,267,268,1187
1996,27900,3210,3594,67579,66039,414,11.6,342,9.6,12699,6035,6664,9.1,19.2,9619,4669,4950,7.1,14.6,3080,4.6,29.2,0,245,245,3659
1997,27900,3223,3625,67415,67479,465,12.9,422,11.7,12445,3356,9089,5,18.4,12573,6096,6477,9,18.6,-128,-0.2,36.8,0,278,278,1950
1998,27900,3221,3631,69706,68525,445,12.3,425,11.7,10798,4199,6599,6.1,15.8,8436,2857,5579,4.2,12.3,2362,3.5,24.6,0,293,293,1573
1999,27900,3204,3639,69894,69991,420,11.6,405,11.1,8441,2852,5589,4.1,12.1,8634,2986,5648,4.3,12.3,-193,-0.2,24.2,0,283,283,1323
2000,27900,3196,3647,70684,70354,369,10.1,372,10.2,10097,3302,6795,4.7,14.4,9437,4247,5190,6,13.4,660,1,26.8,0,240,240,1502
2001,27900,3221,3685,71026,70960,401,10.9,398,10.8,8768,3294,5474,4.6,12.4,8635,2973,5662,4.2,12.2,133,0.2,24.4,0,255,255,1439
2002,27900,3305,3786,67514,70317,518,13.9,410,11,9176,4933,4243,7,13,14781,5755,9026,8.2,21,-5605,-8,26,0,253,253,1326
2003,27900,3329,3812,67886,67137,486,12.9,391,10.4,9449,2417,7032,3.6,14.1,7950,2308,5642,3.4,11.8,1499,2.3,23.6,0,295,297,1333
2004,27900,3396,3890,69185,68388,494,12.8,386,10,8521,3458,5063,5.1,12.5,6927,2244,4683,3.3,10.1,1594,2.4,20.2,0,292,292,1122
2005,27900,3480,3993,71067,70016,508,12.9,373,9.5,8826,4285,4541,6.1,12.6,6723,2161,4562,3.1,9.6,2103,3,19.2,0,288,288,1371
2006,27900,3422,3964,73668,72289,459,11.6,448,11.3,9789,3987,5802,5.5,13.5,7030,2401,4629,3.3,9.7,2759,3.8,19.4,0,329,329,1807
2007,27900,3442,4012,75211,74398,463,11.6,408,10.2,9852,3940,5912,5.3,13.2,8225,2073,6152,2.8,11.1,1627,2.1,22.2,0,295,295,1426
2008,27900,3408,3988,77288,76170,395,9.9,378,9.5,10203,3103,7100,4.1,13.4,7967,2814,5153,3.7,10.5,2236,2.9,21,0,293,294,1683
2009,27900,3309,3898,74587,75630,319,8.1,381,9.7,7899,2358,5541,3.1,10.4,9985,2854,7131,3.8,13.2,-2086,-2.8,20.8,0,292,292,1799
2010,27900,3242,3852,75171,74595,323,8.4,341,8.8,9638,5151,4487,6.9,12.9,8486,2044,6442,2.7,11.4,1152,1.5,22.8,0,266,266,1336
2011,27900,3119,3738,73663,74335,293,7.7,387,10.2,7000,2129,4871,2.9,9.4,8344,2113,6231,2.8,11.2,-1344,-1.8,18.8,0,283,283,1503
2012,27900,3127,3777,75324,74462,386,10.3,356,9.5,9037,2332,6705,3.1,12.1,7313,2369,4944,3.2,9.8,1724,2.3,19.6,0,239,240,1134
2013,27900,3118,3776,75370,75177,313,8.3,301,8,7022,2297,4725,3.1,9.3,6635,1912,4723,2.5,8.8,387,0.5,17.6,0,207,209,934
2014,27900,3024,3659,76440,75732,285,7.7,370,10,6789,1491,5298,2,9,5372,1563,3809,2.1,7.1,1417,1.9,14.2,0,283,283,905
1977,28020,4231,4683,86435,83229,703,15.3,532,11.6,16944,5034,11910,6,20.4,10532,3703,6829,4.4,12.7,6412,7.7,25.4,0,321,321,1882
1978,28020,4394,4844,87775,87102,664,13.9,501,10.5,14561,4534,10027,5.2,16.7,13215,3663,9552,4.2,15.2,1346,1.5,30.4,0,328,329,2185
1979,28020,4455,4904,92959,90273,594,12.2,503,10.3,14246,4154,10092,4.6,15.8,8874,3350,5524,3.7,9.8,5372,6,19.6,0,339,339,1590
1980,28020,4465,4966,92648,92749,604,12.2,513,10.4,12781,5134,7647,5.5,13.8,12983,4550,8433,4.9,14,-202,-0.2,27.6,0,381,382,1786
1981,28020,4300,4797,89805,90999,538,11,655,13.4,12342,5055,7287,5.6,13.6,14729,4489,10240,4.9,16.2,-2387,-2.6,27.2,0,370,371,1947
1982,28020,4290,4885,87754,88904,669,13.8,520,10.7,12814,6185,6629,7,14.4,15114,4494,10620,5.1,17,-2300,-2.6,28.8,0,302,302,1687
1983,28020,4393,4980,88334,87967,531,10.8,475,9.6,12353,4296,8057,4.9,14,11619,3008,8611,3.4,13.2,734,0.8,26.4,0,286,286,1312
1984,28020,4527,5158,93553,91040,648,12.8,484,9.5,14162,3472,10690,3.8,15.6,9136,3145,5991,3.5,10,5026,5.6,20,0,318,318,1222
1985,28020,4639,5263,94112,93741,621,11.9,515,9.9,12327,4013,8314,4.3,13.2,11584,4313,7271,4.6,12.4,743,0.8,24.8,0,306,308,1802
1986,28020,4769,5404,99472,96732,650,12.2,486,9.1,15314,5778,9536,6,15.8,9834,3405,6429,3.5,10.2,5480,5.6,20.4,0,312,312,1617
1987,28020,4901,5586,103472,101865,754,13.7,549,10,15974,5640,10334,5.5,15.7,12760,6163,6597,6.1,12.5,3214,3.2,25,0,343,343,2069
1988,28020,4921,5640,104071,103148,645,11.5,565,10.1,16690,5773,10917,5.6,16.2,14844,6043,8801,5.9,14.4,1846,1.8,28.8,0,357,357,1799
1989,28020,5072,5844,107894,105955,691,12,498,8.7,18063,6016,12047,5.7,17,14184,3872,10312,3.7,13.4,3879,3.6,26.8,0,330,331,1928
1990,28020,5167,5970,108760,108740,637,10.8,482,8.2,15218,5430,9788,5,14,15178,3843,11335,3.5,14,40,0,28,0,333,333,2307
1991,28020,5266,6068,108312,108389,640,10.6,524,8.7,16053,5528,10525,5.1,14.8,16206,4817,11389,4.4,15,-153,-0.2,29.6,0,316,319,2101
1992,28020,5319,6157,112283,110317,634,10.4,524,8.6,19624,7453,12171,6.8,17.8,15692,6594,9098,6,14.2,3932,3.6,28.4,0,296,304,4096
1993,28020,5422,6269,115505,114009,637,10.3,508,8.2,17182,5380,11802,4.7,15.1,14190,4131,10059,3.6,12.4,2992,2.7,24.8,0,329,329,2300
1994,28020,5531,6374,119677,117617,609,9.6,497,7.9,16786,5073,11713,4.3,14.3,12665,4441,8224,3.8,10.8,4121,3.5,21.6,0,333,334,1944
1995,28020,5636,6508,123314,121446,637,9.9,480,7.5,17107,5934,11173,4.9,14.1,13370,4424,8946,3.6,11,3737,3.1,22,0,327,327,2530
1996,28020,5710,6573,124042,123846,637,9.7,575,8.8,17862,5864,11998,4.7,14.4,17469,5215,12254,4.2,14.1,393,0.3,28.2,0,373,373,2454
1997,28020,5713,6606,123089,123558,668,10.1,635,9.6,19491,5738,13753,4.6,15.8,20428,5526,14902,4.5,16.5,-937,-0.7,31.6,0,369,369,2603
1998,28020,5704,6583,122916,122989,636,9.6,641,9.7,17904,5364,12540,4.4,14.6,18049,4814,13235,3.9,14.7,-145,-0.1,29.2,0,405,405,2153
1999,28020,5712,6656,125441,124310,593,9,527,8,18230,5554,12676,4.5,14.7,15967,5321,10646,4.3,12.8,2263,1.9,25.6,0,350,350,2858
2000,28020,5724,6628,128484,126996,592,8.9,624,9.4,21517,4582,16935,3.6,16.9,18540,9114,9426,7.2,14.6,2977,2.3,29.2,0,342,342,3623
2001,28020,5710,6658,129962,129413,621,9.3,639,9.6,21444,6175,15269,4.8,16.6,20346,7520,12826,5.8,15.7,1098,0.9,31.4,0,352,352,1761
2002,28020,5730,6699,127044,128414,722,10.8,680,10.2,19628,7058,12570,5.5,15.3,22368,7153,15215,5.6,17.4,-2740,-2.1,30.6,0,327,327,2037
2003,28020,5682,6632,127988,127011,566,8.5,529,8,17188,5007,12181,3.9,13.5,15233,3490,11743,2.7,12,1955,1.5,24,0,333,334,1864
2004,28020,5620,6525,127516,127127,616,9.4,632,9.6,16515,5257,11258,4.1,13,15736,5734,10002,4.5,12.4,779,0.6,24.8,0,365,367,2346
2005,28020,5639,6566,123623,125140,646,9.9,553,8.5,15022,4920,10102,3.9,12,18055,3781,14274,3,14.4,-3033,-2.4,24,0,369,376,2033
2006,28020,5663,6614,124180,123670,668,10.2,576,8.8,15776,5509,10267,4.5,12.8,14755,4460,10295,3.6,11.9,1021,0.9,23.8,0,377,377,2766
2007,28020,5618,6620,126849,125561,616,9.3,599,9.1,18179,5732,12447,4.6,14.5,15603,4841,10762,3.9,12.4,2576,2.1,24.8,0,359,361,2460
2008,28020,5552,6585,120936,123655,555,8.4,528,8,14354,4348,10006,3.5,11.6,19792,5106,14686,4.1,16,-5438,-4.4,23.2,0,363,363,3387
2009,28020,5429,6422,115707,118028,455,7,577,8.9,12161,3655,8506,3.1,10.3,16803,3812,12991,3.2,14.2,-4642,-3.9,20.6,0,355,358,2435
2010,28020,5328,6302,115963,115415,446,7,523,8.2,15617,4447,11170,3.9,13.5,14521,3915,10606,3.4,12.6,1096,0.9,25.2,0,323,323,2236
2011,28020,5233,6215,116953,116236,447,7.2,492,7.9,13046,2719,10327,2.3,11.2,11611,3662,7949,3.2,10,1435,1.2,20,0,304,304,2000
2012,28020,5213,6194,115244,115976,493,8,515,8.3,14126,3774,10352,3.3,12.2,15589,7450,8139,6.4,13.4,-1463,-1.2,24.4,0,290,292,1687
2013,28020,5207,6182,116711,115940,419,6.8,429,7,12919,2932,9987,2.5,11.1,11376,3661,7715,3.2,9.8,1543,1.3,19.6,0,268,268,2107
2014,28020,5183,6143,116842,116499,429,7,416,6.8,11754,4019,7735,3.4,10.1,11067,4289,6778,3.7,9.5,687,0.6,19,0,262,265,1676
1977,28100,1643,1759,29260,28941,235,13.5,198,11.4,3938,1541,2397,5.3,13.6,3300,1369,1931,4.7,11.4,638,2.2,22.8,0,127,127,710
1978,28100,1675,1788,31442,30416,228,12.9,197,11.1,5036,1541,3495,5.1,16.6,2983,1216,1767,4,9.8,2053,6.8,19.6,0,130,130,610
1979,28100,1671,1789,32442,31926,214,12,203,11.4,5403,1821,3582,5.7,16.9,4371,1744,2627,5.5,13.7,1032,3.2,27.4,0,145,145,1015
1980,28100,1653,1779,31454,31881,210,11.8,202,11.3,3809,1198,2611,3.8,11.9,4662,1402,3260,4.4,14.6,-853,-2.7,23.8,0,139,139,886
1981,28100,1566,1693,29729,29924,209,12.1,260,15.1,4403,1400,3003,4.7,14.7,4792,2115,2677,7.1,16,-389,-1.3,29.4,0,154,155,810
1982,28100,1565,1708,27714,28719,230,13.5,202,11.9,3971,2044,1927,7.1,13.8,5980,1486,4494,5.2,20.8,-2009,-7,27.6,0,117,117,696
1983,28100,1502,1631,26419,27001,172,10.3,246,14.7,3890,1162,2728,4.3,14.4,5054,2417,2637,9,18.7,-1164,-4.3,28.8,0,130,130,747
1984,28100,1591,1717,26277,26439,201,12,130,7.8,4083,1621,2462,6.1,15.4,4406,1675,2731,6.3,16.7,-323,-1.3,30.8,0,63,64,347
1985,28100,1620,1734,27151,27351,184,10.6,188,10.9,3593,1178,2415,4.3,13.1,3993,1174,2819,4.3,14.6,-400,-1.5,26.2,0,108,109,594
1986,28100,1616,1732,27632,27393,193,11.1,192,11.1,3955,1501,2454,5.5,14.4,3476,1381,2095,5,12.7,479,1.7,25.4,0,120,120,582
1987,28100,1652,1773,28234,27933,214,12.2,165,9.4,4145,1526,2619,5.5,14.8,3542,1198,2344,4.3,12.7,603,2.1,25.4,0,103,103,561
1988,28100,1642,1769,27345,27082,179,10.2,158,9,4342,1687,2655,6.2,16,3815,1421,2394,5.2,14.1,527,1.9,28.2,0,101,101,545
1989,28100,1638,1771,29008,28147,184,10.4,178,10.1,5663,2234,3429,7.9,20.1,3940,1725,2215,6.1,14,1723,6.1,28,0,108,108,1288
1990,28100,1659,1804,30639,29822,186,10.4,145,8.1,5166,1850,3316,6.2,17.3,3531,1291,2240,4.3,11.8,1635,5.5,23.6,0,105,105,870
1991,28100,1717,1878,34053,32201,236,12.8,160,8.7,8206,2356,5850,7.3,25.5,4501,1874,2627,5.8,14,3705,11.5,28,0,98,98,863
1992,28100,1735,1920,39081,36586,194,10.2,156,8.2,8870,1415,7455,3.9,24.2,3879,1187,2692,3.2,10.6,4991,13.6,21.2,0,90,90,403
1993,28100,1811,2003,47402,43274,236,12,153,7.8,11745,1886,9859,4.4,27.1,3489,929,2560,2.1,8.1,8256,19,16.2,0,109,109,590
1994,28100,1853,2031,52467,49878,229,11.4,188,9.3,9611,1952,7659,3.9,19.3,4433,1886,2547,3.8,8.9,5178,10.4,17.8,0,119,119,996
1995,28100,1852,2026,54174,53300,199,9.8,193,9.5,6185,2122,4063,4,11.6,4437,1426,3011,2.7,8.3,1748,3.3,16.6,0,130,130,652
1996,28100,1878,2045,49820,52008,212,10.4,190,9.3,4957,2326,2631,4.5,9.5,9333,969,8364,1.9,17.9,-4376,-8.4,19,0,123,123,541
1997,28100,1897,2077,48190,49057,234,11.3,197,9.6,5347,2500,2847,5.1,10.9,7081,1525,5556,3.1,14.4,-1734,-3.5,21.8,0,131,131,862
1998,28100,1896,2071,55828,52010,190,9.2,196,9.5,11468,1316,10152,2.5,22,3831,1252,2579,2.4,7.4,7637,14.6,14.8,0,137,137,737
1999,28100,1860,2055,53770,54723,191,9.3,193,9.4,4438,1762,2676,3.2,8.1,6344,1802,4542,3.3,11.6,-1906,-3.5,16.2,0,123,123,895
2000,28100,1854,2055,58600,56231,205,10,205,10,8787,1749,7038,3.1,15.6,4049,1529,2520,2.7,7.2,4738,8.4,14.4,0,119,119,566
2001,28100,1842,2046,62928,60803,154,7.5,180,8.8,9043,1306,7737,2.1,14.9,4792,1507,3285,2.5,7.9,4251,7,15.8,0,101,101,457
2002,28100,1872,2073,37042,49992,225,10.9,197,9.6,5349,1723,3626,3.4,10.7,31249,,3755,,62.5,-25900,-51.8,21.4,1,100,100,467
2003,28100,1870,2077,36004,36420,206,10,172,8.3,4020,1506,2514,4.1,11,4851,990,3861,2.7,13.3,-831,-2.3,22,0,116,116,572
2004,28100,1896,2098,36599,36232,200,9.6,174,8.4,4598,1946,2652,5.4,12.7,3863,1233,2630,3.4,10.7,735,2,21.4,0,122,122,801
2005,28100,1925,2137,36151,36240,211,10,158,7.5,3513,1152,2361,3.2,9.7,3691,784,2907,2.2,10.2,-178,-0.5,19.4,0,115,115,591
2006,28100,1944,2176,36371,36219,228,10.6,172,8,4336,1559,2777,4.3,12,4032,1343,2689,3.7,11.1,304,0.9,22.2,0,121,121,886
2007,28100,1983,2225,37331,36825,233,10.6,185,8.4,5401,2295,3106,6.2,14.7,4389,1285,3104,3.5,11.9,1012,2.8,23.8,0,107,110,886
2008,28100,2002,2260,38418,37777,219,9.8,168,7.5,5331,1792,3539,4.7,14.1,4048,1328,2720,3.5,10.7,1283,3.4,21.4,0,120,120,1202
2009,28100,1934,2193,35920,37070,163,7.3,211,9.5,2699,1084,1615,2.9,7.3,4998,1129,3869,3,13.5,-2299,-6.2,14.6,0,138,138,547
2010,28100,1869,2135,34879,35112,152,7,191,8.9,3334,942,2392,2.7,9.5,3800,1180,2620,3.4,10.8,-466,-1.3,19,0,120,120,944
2011,28100,1849,2139,35332,35037,160,7.5,140,6.6,3294,974,2320,2.8,9.4,2703,621,2082,1.8,7.7,591,1.7,15.4,0,89,89,383
2012,28100,1860,2144,36274,35829,156,7.3,163,7.6,4709,1234,3475,3.4,13.1,3818,1385,2433,3.9,10.7,891,2.4,21.4,0,96,98,913
2013,28100,1855,2129,36545,36314,155,7.3,160,7.5,3730,1054,2676,2.9,10.3,3267,754,2513,2.1,9,463,1.3,18,0,97,97,471
2014,28100,1839,2116,36422,36394,159,7.5,158,7.5,3862,1402,2460,3.9,10.6,3806,1034,2772,2.8,10.5,56,0.1,21,0,105,105,547
1977,28140,24729,29736,520619,505016,4925,16.8,3953,13.5,104742,46319,58423,9.2,20.7,73535,31023,42512,6.1,14.6,31207,6.1,29.2,0,2534,2545,15526
1978,28140,25393,30554,551500,535730,4572,15.2,3730,12.4,110301,36824,73477,6.9,20.6,78761,32645,46116,6.1,14.7,31540,5.9,29.4,0,2482,2491,15330
1979,28140,26040,31372,578879,564704,4604,14.9,3646,11.8,110340,36777,73563,6.5,19.5,81991,33685,48306,6,14.5,28349,5,29,0,2435,2462,14837
1980,28140,25990,31384,577358,577760,4001,12.8,3846,12.3,90503,31524,58979,5.5,15.7,91306,29617,61689,5.1,15.8,-803,-0.1,31.4,0,2578,2584,15881
1981,28140,25355,30508,562965,567027,3995,12.9,4608,14.9,91777,42297,49480,7.5,16.2,99900,35782,64118,6.3,17.6,-8123,-1.4,32.4,0,2609,2627,15272
1982,28140,25325,31014,559650,560496,4582,14.9,3769,12.2,98580,44749,53831,8,17.6,100271,31946,68325,5.7,17.9,-1691,-0.3,35.2,0,2102,2107,14657
1983,28140,26095,31697,548126,550973,3962,12.6,3465,11.1,91913,32851,59062,6,16.7,97607,27350,70257,5,17.7,-5694,-1,33.4,0,2171,2182,12356
1984,28140,26607,32321,603306,577375,4588,14.3,3981,12.4,135637,39582,96055,6.9,23.5,83774,32029,51745,5.5,14.5,51863,9,29,0,2365,2374,13050
1985,28140,27658,33470,617554,614915,4747,14.4,3665,11.1,110317,43085,67232,7,17.9,105038,53917,51121,8.8,17.1,5279,0.8,34.2,0,2300,2310,16476
1986,28140,28726,34819,637023,626788,4971,14.6,3506,10.3,115698,46436,69262,7.4,18.5,95228,32918,62310,5.3,15.2,20470,3.3,30.4,0,2128,2145,14142
1987,28140,29532,36081,660283,653290,5676,16,4343,12.2,128827,57797,71030,8.8,19.7,114840,46858,67982,7.2,17.6,13987,2.1,35.2,0,2671,2698,21548
1988,28140,29661,36495,661901,656648,4993,13.8,4355,12,119981,45378,74603,6.9,18.3,109475,40189,69286,6.1,16.7,10506,1.6,33.4,0,2755,2755,19162
1989,28140,30223,37284,685803,674921,4903,13.3,4138,11.2,129151,46655,82496,6.9,19.1,107386,36890,70496,5.5,15.9,21765,3.2,31.8,0,2702,2721,20154
1990,28140,30715,37882,700875,693096,4730,12.6,3959,10.5,116797,42561,74236,6.1,16.9,101239,32288,68951,4.7,14.6,15558,2.3,29.2,0,2589,2601,18113
1991,28140,31228,38565,698680,699615,4981,13,4333,11.3,118825,49382,69443,7.1,17,120695,40452,80243,5.8,17.3,-1870,-0.3,34,0,2540,2603,22020
1992,28140,31452,38913,700311,699292,4849,12.5,4345,11.2,117094,43109,73985,6.2,16.7,115056,40514,74542,5.8,16.5,2038,0.2,33,0,2707,2764,21202
1993,28140,32109,39391,704317,701967,4494,11.5,3962,10.1,107528,34774,72754,5,15.3,102827,32179,70648,4.6,14.6,4701,0.7,29.2,0,2568,2600,18043
1994,28140,32869,40278,728834,716577,5055,12.7,4085,10.3,122753,43062,79691,6,17.1,98239,36159,62080,5,13.7,24514,3.4,27.4,0,2647,2659,18222
1995,28140,33858,41351,757379,742657,5260,12.9,4017,9.8,122620,43320,79300,5.8,16.5,93176,31518,61658,4.2,12.5,29444,4,25,0,2637,2648,15359
1996,28140,34498,42144,777824,768118,5114,12.3,4269,10.2,128725,49286,79439,6.4,16.8,109313,37444,71869,4.9,14.2,19412,2.6,28.4,0,2812,2812,18932
1997,28140,34940,42813,802469,790492,5576,13.1,4911,11.5,140794,53156,87638,6.7,17.8,116839,39771,77068,5,14.8,23955,3,29.6,0,3009,3009,17518
1998,28140,35097,43220,822810,812206,5235,12.2,4717,11,135680,48473,87207,6,16.7,114471,42668,71803,5.3,14.1,21209,2.6,28.2,0,3091,3091,20266
1999,28140,35398,43840,872928,849576,5418,12.4,4759,10.9,160422,58541,101881,6.9,18.9,113718,44847,68871,5.3,13.4,46704,5.5,26.8,0,2997,2997,18358
2000,28140,35599,44377,899362,884086,5459,12.4,4941,11.2,153337,63669,89668,7.2,17.3,122784,43590,79194,4.9,13.9,30553,3.4,27.8,0,2947,2947,19764
2001,28140,35538,44549,899429,900667,5052,11.4,5188,11.7,128995,52472,76523,5.8,14.3,131470,42528,88942,4.7,14.6,-2475,-0.3,28.6,0,3022,3023,19132
2002,28140,35766,44692,885826,891408,5804,13,5588,12.5,145699,62104,83595,7,16.3,156862,51801,105061,5.8,17.6,-11163,-1.3,32.6,0,2835,2836,19057
2003,28140,36228,45238,880831,875614,5714,12.8,4373,9.8,128727,48071,80656,5.5,14.7,118292,39068,79224,4.5,13.5,10435,1.2,27,0,2905,2911,20109
2004,28140,36911,46050,894189,886664,5683,12.5,4355,9.6,138650,54745,83905,6.2,15.6,123602,44648,78954,5,13.9,15048,1.7,27.8,0,2844,2845,18971
2005,28140,37702,47012,894869,892649,5758,12.4,4373,9.4,125132,52240,72892,5.9,14,120693,34931,85762,3.9,13.5,4439,0.5,27,0,2984,2986,20160
2006,28140,37546,47264,914906,902035,5699,12.1,4996,10.6,137558,51935,85623,5.8,15.2,111816,33979,77837,3.8,12.4,25742,2.8,24.8,0,3353,3353,20536
2007,28140,37595,47508,918717,913749,5460,11.5,5067,10.7,138151,51528,86623,5.6,15.1,128214,40558,87656,4.4,14,9937,1.1,28,0,3097,3133,19528
2008,28140,37265,47271,924949,918135,4688,9.9,4402,9.3,124675,43574,81101,4.7,13.6,111046,29484,81562,3.2,12.1,13629,1.5,24.2,0,3076,3080,17663
2009,28140,35999,45883,888409,903288,3989,8.6,4961,10.7,103029,39267,63762,4.3,11.4,132786,33575,99211,3.7,14.7,-29757,-3.3,22.8,0,3303,3308,20760
2010,28140,35304,45095,861982,873187,3966,8.8,4363,9.6,96480,32912,63568,3.8,11,118889,35217,83672,4,13.6,-22409,-2.6,22,0,2814,2829,18222
2011,28140,34800,44844,858905,858703,4206,9.4,4151,9.3,105631,39782,65849,4.6,12.3,105227,33900,71327,3.9,12.3,404,0,24.6,0,2732,2736,20469
2012,28140,35301,45380,882671,870153,4773,10.6,4224,9.4,123235,42935,80300,4.9,14.2,98199,31700,66499,3.6,11.3,25036,2.9,22.6,0,2441,2463,15324
2013,28140,35423,45517,896876,887598,4357,9.6,4094,9,114474,35519,78955,4,12.9,95918,28376,67542,3.2,10.8,18556,2.1,21.6,0,2543,2558,16189
2014,28140,36200,46616,917278,903881,5238,11.4,3742,8.2,123368,38178,85190,4.2,13.6,96574,27142,69432,3,10.7,26794,2.9,21.4,0,2550,2569,15473
1977,28420,2153,2348,35074,33484,544,24.3,318,14.2,8034,4014,4020,12,24,4854,2503,2351,7.5,14.5,3180,9.5,29,0,195,198,1649
1978,28420,2266,2480,41646,38325,469,19.4,337,14,10775,3409,7366,8.9,28.1,4133,1943,2190,5.1,10.8,6642,17.3,21.6,0,228,229,1265
1979,28420,2383,2602,47623,44605,485,19.1,346,13.6,11806,4480,7326,10,26.5,5769,2136,3633,4.8,12.9,6037,13.6,25.8,0,226,226,1229
1980,28420,2400,2637,48866,48205,443,16.9,391,14.9,8160,3058,5102,6.3,16.9,6838,2458,4380,5.1,14.2,1322,2.7,28.4,0,255,255,1484
1981,28420,2319,2554,48390,48185,378,14.6,431,16.7,8158,2748,5410,5.7,16.9,7748,2497,5251,5.2,16.1,410,0.8,32.2,0,252,253,1421
1982,28420,2387,2666,46579,47474,475,18.2,328,12.6,8034,3770,4264,7.9,16.9,9823,1929,7894,4.1,20.7,-1789,-3.8,33.8,0,171,171,781
1983,28420,2373,2652,42736,44712,335,12.6,374,14.1,6371,2429,3942,5.4,14.2,10322,3374,6948,7.5,23.1,-3951,-8.9,28.4,0,243,243,2494
1984,28420,2463,2749,42349,42529,413,15.3,310,11.5,5987,1922,4065,4.5,14.1,6347,1881,4466,4.4,14.9,-360,-0.8,28.2,0,205,205,1022
1985,28420,2485,2755,44181,43675,408,14.8,412,14.9,6682,2063,4619,4.7,15.3,5669,2453,3216,5.6,13,1013,2.3,26,0,252,253,1271
1986,28420,2514,2792,45725,44918,371,13.4,318,11.5,6572,2036,4536,4.5,14.6,4958,1647,3311,3.7,11,1614,3.6,22,0,201,201,901
1987,28420,2573,2855,45221,45439,430,15.2,358,12.7,7518,2502,5016,5.5,16.5,7954,3848,4106,8.5,17.5,-436,-1,33,0,209,211,1049
1988,28420,2476,2773,46736,45119,333,11.9,387,13.8,15530,2119,13411,4.7,34.4,12295,7690,4605,17,27.3,3235,7.1,54.6,0,248,248,1111
1989,28420,2070,2354,43454,45433,274,10.7,697,27.2,7164,2680,4484,5.9,15.8,11121,7608,3513,16.7,24.5,-3957,-8.7,31.6,0,181,183,4443
1990,28420,2599,2917,48890,46157,768,29.1,199,7.6,9834,4727,5107,10.2,21.3,4368,2180,2188,4.7,9.5,5466,11.8,19,0,115,115,594
1991,28420,2735,3064,52227,50572,451,15.1,302,10.1,8708,3080,5628,6.1,17.2,5397,1702,3695,3.4,10.7,3311,6.5,21.4,0,170,171,1104
1992,28420,2835,3178,54106,52942,453,14.5,320,10.2,7947,2559,5388,4.8,15,5618,1999,3619,3.8,10.6,2329,4.4,21.2,0,200,200,1039
1993,28420,2960,3289,58107,56096,405,12.5,292,9,9158,2380,6778,4.2,16.3,5135,1549,3586,2.8,9.2,4023,7.1,18.4,0,189,191,914
1994,28420,3092,3420,62484,60286,457,13.6,316,9.4,10496,3353,7143,5.6,17.4,6099,1810,4289,3,10.1,4397,7.3,20.2,0,213,213,939
1995,28420,3186,3509,63771,62970,447,12.9,341,9.8,8875,4342,4533,6.9,14.1,7272,2721,4551,4.3,11.5,1603,2.6,23,0,231,231,1612
1996,28420,3236,3570,60643,62262,476,13.4,400,11.3,8427,3874,4553,6.2,13.5,11665,2138,9527,3.4,18.7,-3238,-5.2,27,0,251,251,1022
1997,28420,3318,3680,58064,59383,544,15,433,11.9,15758,11128,4630,18.7,26.5,18395,6608,11787,11.1,31,-2637,-4.5,53,0,225,225,1448
1998,28420,3380,3732,59345,58644,495,13.4,423,11.4,9660,3532,6128,6,16.5,8258,2252,6006,3.8,14.1,1402,2.4,28.2,0,270,270,1386
1999,28420,3426,3802,61684,60716,473,12.6,399,10.6,9330,3169,6161,5.2,15.4,7394,1849,5545,3,12.2,1936,3.2,24.4,0,254,254,1019
2000,28420,3446,3811,64360,63023,460,12.1,451,11.9,10991,4244,6747,6.7,17.4,8317,4298,4019,6.8,13.2,2674,4.2,26.4,0,254,254,1369
2001,28420,3495,3894,66332,65436,504,13.1,460,11.9,9481,3766,5715,5.8,14.5,7688,2748,4940,4.2,11.7,1793,2.8,23.4,0,253,254,1359
2002,28420,3600,3999,67340,66770,574,14.6,465,11.8,10517,3767,6750,5.6,15.8,9377,3591,5786,5.4,14,1140,1.8,28,0,246,246,2126
2003,28420,3684,4104,68415,67659,522,12.9,366,9.1,9156,3511,5645,5.2,13.5,7643,2028,5615,3,11.3,1513,2.2,22.6,0,256,256,1305
2004,28420,3749,4204,68077,67908,553,13.3,400,9.7,9234,3894,5340,5.7,13.6,8895,3438,5457,5.1,13.1,339,0.5,26.2,0,258,258,1256
2005,28420,3846,4338,70566,69106,574,13.5,392,9.2,10943,5253,5690,7.6,15.8,8022,2004,6018,2.9,11.6,2921,4.2,23.2,0,268,268,1145
2006,28420,3913,4436,71636,70883,609,13.9,455,10.4,11014,5023,5991,7.1,15.5,9508,2432,7076,3.4,13.4,1506,2.1,26.8,0,323,323,1427
2007,28420,4015,4569,73619,72633,612,13.6,499,11.1,11181,4542,6639,6.3,15.4,9209,2971,6238,4.1,12.7,1972,2.7,25.4,0,307,310,1416
2008,28420,4128,4717,76795,75024,595,12.9,403,8.7,14025,5658,8367,7.5,18.7,10483,3704,6779,4.9,14,3542,4.7,28,0,274,274,1533
2009,28420,4057,4677,73317,74973,491,10.5,521,11.1,10151,4564,5587,6.1,13.5,13462,2922,10540,3.9,18,-3311,-4.5,27,0,352,352,1367
2010,28420,4090,4720,76438,74656,488,10.4,418,8.9,12467,5612,6855,7.5,16.7,8903,3512,5391,4.7,11.9,3564,4.8,23.8,0,278,278,1376
2011,28420,4066,4710,77509,76962,477,10.1,445,9.5,9055,2379,6676,3.1,11.8,7960,2018,5942,2.6,10.3,1095,1.5,20.6,0,287,287,1240
2012,28420,4171,4820,76657,77098,533,11.2,450,9.4,9785,3078,6707,4,12.7,10666,3309,7357,4.3,13.8,-881,-1.1,25.4,0,263,263,1199
2013,28420,4207,4873,78309,77265,502,10.4,452,9.4,9993,3673,6320,4.8,12.9,7904,2336,5568,3,10.2,2089,2.7,20.4,0,297,310,1731
2014,28420,4238,4906,77431,77708,480,9.8,418,8.6,8209,2505,5704,3.2,10.6,8763,2595,6168,3.3,11.3,-554,-0.7,21.2,0,294,294,1341
1977,28660,2728,3069,36455,34780,666,22.6,408,13.9,8743,4715,4028,13.6,25.1,5393,2415,2978,6.9,15.5,3350,9.6,31,0,307,308,1797
1978,28660,2548,2884,38888,37500,436,14.6,577,19.4,9089,2911,6178,7.8,24.2,6312,3257,3055,8.7,16.8,2777,7.4,33.6,0,323,323,1525
1979,28660,2880,3220,43196,41168,607,19.9,299,9.8,11031,5032,5999,12.2,26.8,6975,2606,4369,6.3,16.9,4056,9.9,33.8,0,7,8,61
1980,28660,2053,2403,39924,40651,139,4.9,648,23,7037,1608,5429,4,17.3,8491,3418,5073,8.4,20.9,-1454,-3.6,34.6,0,497,499,2402
1981,28660,2688,3054,42288,41101,579,21.3,345,12.7,8725,5138,3587,12.5,21.2,6353,3106,3247,7.6,15.5,2372,5.7,31,0,172,172,818
1982,28660,2745,3203,45384,43793,569,18.2,385,12.3,9762,4776,4986,10.9,22.3,6580,2023,4557,4.6,15,3182,7.3,30,0,241,241,1204
1983,28660,2873,3326,47424,46384,509,15.6,417,12.8,12572,6742,5830,14.5,27.1,10491,3215,7276,6.9,22.6,2081,4.5,45.2,0,279,280,1905
1984,28660,2995,3465,50229,48842,581,17.1,442,13,10134,4355,5779,8.9,20.7,7359,3028,4331,6.2,15.1,2775,5.6,30.2,0,285,285,1506
1985,28660,3127,3598,52681,51947,543,15.4,415,11.7,9898,3874,6024,7.5,19.1,8429,3672,4757,7.1,16.2,1469,2.9,32.4,0,279,279,1539
1986,28660,3286,3773,55683,54163,638,17.3,447,12.1,11570,4556,7014,8.4,21.4,8529,3744,4785,6.9,15.7,3041,5.7,31.4,0,312,312,2570
1987,28660,3332,3851,56718,57030,582,15.2,494,12.9,9641,3726,5915,6.5,16.9,10264,4577,5687,8,18,-623,-1.1,33.8,0,330,332,2002
1988,28660,3245,3773,58420,57593,492,12.9,533,14,10637,4810,5827,8.4,18.5,8983,3646,5337,6.3,15.6,1654,2.9,31.2,0,362,362,1757
1989,28660,3191,3748,59576,58995,480,12.8,504,13.4,9602,3308,6294,5.6,16.3,8439,2753,5686,4.7,14.3,1163,2,28.6,0,341,342,1956
1990,28660,3169,3738,60457,59953,437,11.7,414,11.1,9346,4084,5262,6.8,15.6,8338,2601,5737,4.3,13.9,1008,1.7,27.8,0,289,290,1466
1991,28660,3173,3748,59636,59967,461,12.3,450,12,8634,3728,4906,6.2,14.4,9296,2821,6475,4.7,15.5,-662,-1.1,28.8,0,275,275,1732
1992,28660,3240,3814,58709,57886,499,13.2,420,11.1,10581,2878,7703,5,18.3,8935,4438,4497,7.7,15.4,1646,2.9,30.8,0,250,257,1789
1993,28660,3412,3965,62602,60599,513,13.2,338,8.7,10935,3738,7197,6.2,18,6928,2835,4093,4.7,11.4,4007,6.6,22.8,0,224,227,1404
1994,28660,3536,4092,66517,64475,554,13.8,414,10.3,11243,4284,6959,6.6,17.4,7159,2535,4624,3.9,11.1,4084,6.3,22.2,0,286,287,1369
1995,28660,3666,4245,70797,68730,528,12.7,365,8.8,11793,4133,7660,6,17.2,7659,2538,5121,3.7,11.1,4134,6.1,22.2,0,236,239,1425
1996,28660,3762,4349,72970,71935,571,13.3,456,10.6,11526,4773,6753,6.6,16,9456,3824,5632,5.3,13.1,2070,2.9,26.2,0,302,302,1831
1997,28660,3815,4448,77040,75018,614,13.9,523,11.9,15002,4786,10216,6.4,20,10957,3413,7544,4.5,14.6,4045,5.4,29.2,0,329,329,1444
1998,28660,3825,4488,80425,78567,547,12.2,497,11.1,12307,4316,7991,5.5,15.7,8590,3498,5092,4.5,10.9,3717,4.8,21.8,0,349,349,1910
1999,28660,3830,4555,81903,81290,553,12.2,487,10.8,13357,5835,7522,7.2,16.4,12130,6408,5722,7.9,14.9,1227,1.5,29.8,0,321,321,1571
2000,28660,3861,4620,86149,85015,553,12.1,490,10.7,12864,5158,7706,6.1,15.1,10597,4099,6498,4.8,12.5,2267,2.6,25,0,309,309,1876
2001,28660,3951,4730,88356,87316,576,12.3,499,10.7,13406,4775,8631,5.5,15.4,11325,3303,8022,3.8,13,2081,2.4,26,0,294,294,1601
2002,28660,4021,4788,85385,85746,627,13.2,568,11.9,14279,6283,7996,7.3,16.7,15000,4087,10913,4.8,17.5,-721,-0.8,33.4,0,300,300,1528
2003,28660,4085,4860,85878,85021,577,12,406,8.5,15579,6922,8657,8.1,18.3,13864,3305,10559,3.9,16.3,1715,2,32.6,0,284,284,1532
2004,28660,4132,4942,90787,87996,568,11.6,443,9.1,16460,7730,8730,8.8,18.7,10878,3186,7692,3.6,12.4,5582,6.3,24.8,0,293,293,2081
2005,28660,4172,5035,90273,90347,603,12.1,465,9.3,14288,4892,9396,5.4,15.8,14436,3410,11026,3.8,16,-148,-0.2,31.6,0,342,342,1926
2006,28660,4241,5174,91613,90817,643,12.6,475,9.3,13067,5512,7555,6.1,14.4,11474,3906,7568,4.3,12.6,1593,1.8,25.2,0,328,328,2998
2007,28660,4308,5292,91210,91262,688,13.2,563,10.8,14739,5656,9083,6.2,16.2,14842,4937,9905,5.4,16.3,-103,-0.1,32.4,0,375,379,2016
2008,28660,4344,5345,96328,93183,644,12.2,500,9.5,17344,5552,11792,6,18.6,11053,4730,6323,5.1,11.9,6291,6.7,23.8,0,349,349,2563
2009,28660,4274,5284,94139,95044,551,10.4,557,10.5,14239,6311,7928,6.6,15,16048,5616,10432,5.9,16.9,-1809,-1.9,30,0,373,373,1853
2010,28660,4331,5387,94005,93831,606,11.4,467,8.8,12700,5121,7579,5.5,13.5,12351,4003,8348,4.3,13.2,349,0.3,26.4,0,303,303,1882
2011,28660,4330,5401,96146,94812,554,10.3,481,8.9,14095,5246,8849,5.5,14.9,11426,2995,8431,3.2,12.1,2669,2.8,24.2,0,323,323,1932
2012,28660,4376,5420,96429,96211,532,9.8,532,9.8,14074,4418,9656,4.6,14.6,13638,5846,7792,6.1,14.2,436,0.4,28.4,0,324,327,2737
2013,28660,4389,5467,98790,97379,512,9.4,469,8.6,12962,5220,7742,5.4,13.3,10140,3311,6829,3.4,10.4,2822,2.9,20.8,0,325,328,2207
2014,28660,4351,5510,99554,98614,574,10.5,478,8.8,13547,6036,7511,6.1,13.7,11666,5166,6500,5.2,11.8,1881,1.9,23.6,0,342,342,1658
1977,28700,3729,4170,78684,76734,674,16.5,487,11.9,13120,7025,6095,9.2,17.1,9219,2994,6225,3.9,12,3901,5.1,24,0,321,323,1326
1978,28700,3893,4326,84573,81622,620,14.6,463,10.9,14392,3979,10413,4.9,17.6,8490,3842,4648,4.7,10.4,5902,7.2,20.8,0,313,314,2451
1979,28700,3936,4407,87082,85795,622,14.2,521,11.9,11706,4452,7254,5.2,13.6,9131,3100,6031,3.6,10.6,2575,3,21.2,0,379,379,1821
1980,28700,3934,4414,85357,86164,589,13.4,565,12.8,10231,3984,6247,4.6,11.9,11844,4872,6972,5.7,13.7,-1613,-1.8,23.8,0,402,403,2761
1981,28700,3779,4241,83838,84022,502,11.6,602,14,9379,4583,4796,5.5,11.2,9747,3069,6678,3.7,11.6,-368,-0.4,22.4,0,369,371,1550
1982,28700,3759,4267,84202,83997,580,13.6,518,12.2,10762,5338,5424,6.4,12.8,10351,3080,7271,3.7,12.3,411,0.5,24.6,0,294,294,1730
1983,28700,3836,4367,82330,83260,539,12.5,478,11.1,10265,4731,5534,5.7,12.3,12125,2648,9477,3.2,14.6,-1860,-2.3,24.6,0,317,318,1554
1984,28700,3944,4489,86459,84368,661,14.9,530,12,12371,4645,7726,5.5,14.7,8189,2865,5324,3.4,9.7,4182,5,19.4,0,333,333,1654
1985,28700,4110,4661,87893,87370,589,12.9,441,9.6,11961,4458,7503,5.1,13.7,10915,4595,6320,5.3,12.5,1046,1.2,25,0,217,222,1252
1986,28700,4243,4808,90602,89055,656,13.9,487,10.3,16169,9389,6780,10.5,18.2,13075,5593,7482,6.3,14.7,3094,3.5,29.4,0,327,327,3918
1987,28700,4311,4928,92613,91598,656,13.5,517,10.6,13183,4641,8542,5.1,14.4,11153,3600,7553,3.9,12.2,2030,2.2,24.4,0,332,332,1950
1988,28700,4365,4996,91737,91829,645,13,553,11.2,13685,5295,8390,5.8,14.9,13869,7229,6640,7.9,15.1,-184,-0.2,29.8,0,349,349,1532
1989,28700,4400,5066,96837,94390,552,11,493,9.8,14014,4815,9199,5.1,14.8,9119,4084,5035,4.3,9.7,4895,5.1,19.4,0,327,328,2246
1990,28700,4432,5115,97287,96874,518,10.2,432,8.5,10664,3517,7147,3.6,11,9838,3662,6176,3.8,10.2,826,0.8,20.4,0,301,301,2006
1991,28700,4476,5207,98769,98090,572,11.1,470,9.1,13271,6152,7119,6.3,13.5,11913,3204,8709,3.3,12.1,1358,1.4,24.2,0,312,313,1942
1992,28700,4544,5289,100864,99810,579,11,481,9.2,13155,3541,9614,3.5,13.2,11047,3823,7224,3.8,11.1,2108,2.1,22.2,0,317,322,1697
1993,28700,4616,5357,102137,101484,522,9.8,442,8.3,15031,3752,11279,3.7,14.8,13724,3257,10467,3.2,13.5,1307,1.3,27,0,305,308,1785
1994,28700,4733,5498,103557,102793,623,11.5,471,8.7,24995,17612,7383,17.1,24.3,23466,12118,11348,11.8,22.8,1529,1.5,45.6,0,321,322,1872
1995,28700,4861,5633,109531,106540,648,11.6,491,8.8,15158,5531,9627,5.2,14.2,9176,3201,5975,3,8.6,5982,5.6,17.2,0,339,340,1988
1996,28700,5012,5795,108774,108680,721,12.6,550,9.6,14173,6445,7728,5.9,13,13984,5660,8324,5.2,12.9,189,0.1,25.8,0,352,352,2728
1997,28700,5058,5891,108407,108586,723,12.4,608,10.4,14648,5382,9266,5,13.5,15005,5168,9837,4.8,13.8,-357,-0.3,27,0,390,390,2247
1998,28700,4998,5829,105987,107325,554,9.5,606,10.3,11666,4420,7246,4.1,10.9,14342,4726,9616,4.4,13.4,-2676,-2.5,21.8,0,406,406,2375
1999,28700,5000,5890,106675,106390,660,11.3,586,10,14356,5797,8559,5.4,13.5,13786,4967,8819,4.7,13,570,0.5,26,0,371,371,2046
2000,28700,4969,5878,108709,107652,576,9.8,591,10,15020,5413,9607,5,14,12906,4638,8268,4.3,12,2114,2,24,0,364,364,2205
2001,28700,4915,5849,108527,108796,568,9.7,636,10.8,15363,6004,9359,5.5,14.1,15900,6320,9580,5.8,14.6,-537,-0.5,28.2,0,364,365,2434
2002,28700,4863,5802,105427,106560,631,10.8,664,11.4,15334,6964,8370,6.5,14.4,17601,6384,11217,6,16.5,-2267,-2.1,28.8,0,372,373,2263
2003,28700,4841,5811,107047,105734,614,10.6,512,8.9,14095,5496,8599,5.2,13.3,11468,4362,7106,4.1,10.8,2627,2.5,21.6,0,371,371,2453
2004,28700,4882,5851,104423,105192,575,9.9,489,8.4,12792,4694,8098,4.5,12.2,14329,4925,9404,4.7,13.6,-1537,-1.4,24.4,0,332,333,2613
2005,28700,4855,5856,106117,105076,542,9.3,489,8.4,14564,4638,9926,4.4,13.9,12481,3753,8728,3.6,11.9,2083,2,23.8,0,337,337,2584
2006,28700,4832,5830,113850,109514,551,9.5,519,8.9,17822,5765,12057,5.3,16.3,9150,2993,6157,2.7,8.4,8672,7.9,16.8,0,350,350,1799
2007,28700,4854,5899,113740,113519,596,10.2,524,8.9,14628,5410,9218,4.8,12.9,14185,4732,9453,4.2,12.5,443,0.4,25,0,335,340,2278
2008,28700,4821,5903,114484,113913,523,8.9,475,8.1,14330,5044,9286,4.4,12.6,13188,3171,10017,2.8,11.6,1142,1,23.2,0,337,337,1904
2009,28700,4704,5770,109154,110799,407,7,467,8,11840,4320,7520,3.9,10.7,15130,4024,11106,3.6,13.7,-3290,-3,21.4,0,326,326,2593
2010,28700,4567,5673,102523,105391,416,7.3,472,8.3,11697,4519,7178,4.3,11.1,17432,4013,13419,3.8,16.5,-5735,-5.4,22.2,0,324,324,2868
2011,28700,4461,5572,103502,102715,379,6.8,421,7.5,12365,3512,8853,3.4,12,10791,4423,6368,4.3,10.5,1574,1.5,21,0,288,288,3297
2012,28700,4488,5606,104191,103912,436,7.8,431,7.7,11653,3168,8485,3,11.2,11095,4138,6957,4,10.7,558,0.5,21.4,0,266,267,2655
2013,28700,4469,5584,105228,104574,380,6.8,401,7.2,10720,3695,7025,3.5,10.3,9412,2306,7106,2.2,9,1308,1.3,18,0,262,262,1323
2014,28700,4434,5555,105478,105029,395,7.1,376,6.8,11494,4044,7450,3.9,10.9,10596,2249,8347,2.1,10.1,898,0.8,20.2,0,273,273,1034
1977,28740,2527,2678,33949,33596,374,13.9,380,14.2,5778,1765,4013,5.3,17.2,5072,2504,2568,7.5,15.1,706,2.1,30.2,0,252,252,1216
1978,28740,2569,2733,34642,34283,360,13.3,297,11,6078,2064,4014,6,17.7,5360,3250,2110,9.5,15.6,718,2.1,31.2,0,212,212,2640
1979,28740,2582,2741,34844,34711,342,12.5,322,11.8,5976,1606,4370,4.6,17.2,5709,1357,4352,3.9,16.4,267,0.8,32.8,0,226,226,792
1980,28740,2588,2756,35628,35244,347,12.6,329,12,5326,1906,3420,5.4,15.1,4557,1893,2664,5.4,12.9,769,2.2,25.8,0,229,230,1089
1981,28740,2513,2678,34360,34599,313,11.5,370,13.6,5000,2196,2804,6.3,14.5,5477,2991,2486,8.6,15.8,-477,-1.3,29,0,215,215,1337
1982,28740,2582,2781,37163,35778,415,15.2,292,10.7,9421,2433,6988,6.8,26.3,6650,3432,3218,9.6,18.6,2771,7.7,37.2,0,178,178,839
1983,28740,2685,2897,35788,36505,378,13.3,279,9.8,6807,2442,4365,6.7,18.6,8240,1556,6684,4.3,22.6,-1433,-4,37.2,0,192,193,996
1984,28740,2783,2995,41796,38836,398,13.5,299,10.2,11098,6955,4143,17.9,28.6,5178,1370,3808,3.5,13.3,5920,15.3,26.6,0,216,216,878
1985,28740,2930,3142,42512,42499,414,13.5,274,8.9,6431,2021,4410,4.8,15.1,6404,3244,3160,7.6,15.1,27,0,30.2,0,194,194,1026
1986,28740,3003,3229,45412,43947,419,13.2,324,10.2,7695,2988,4707,6.8,17.5,4765,1483,3282,3.4,10.8,2930,6.7,21.6,0,200,200,790
1987,28740,3204,3445,41776,43581,534,16,303,9.1,7339,2404,4935,5.5,16.8,10948,1666,9282,3.8,25.1,-3609,-8.3,33.6,0,195,195,942
1988,28740,3239,3502,42225,41486,519,15,432,12.4,8005,3397,4608,8.2,19.3,6526,1995,4531,4.8,15.7,1479,3.6,31.4,0,306,306,1356
1989,28740,3367,3645,43633,42676,518,14.5,381,10.7,8051,3378,4673,7.9,18.9,6137,2306,3831,5.4,14.4,1914,4.5,28.8,0,281,281,1330
1990,28740,3392,3686,43988,43781,437,11.9,378,10.3,6225,2432,3793,5.6,14.2,5811,1982,3829,4.5,13.3,414,0.9,26.6,0,272,272,1304
1991,28740,3351,3666,43432,43715,407,11.1,426,11.6,6427,3597,2830,8.2,14.7,6992,2414,4578,5.5,16,-565,-1.3,29.4,0,289,289,1427
1992,28740,3312,3634,43930,43622,384,10.5,399,10.9,7081,3230,3851,7.4,16.2,6464,2121,4343,4.9,14.8,617,1.4,29.6,0,270,271,855
1993,28740,3322,3653,44125,44210,366,10,344,9.4,5193,1735,3458,3.9,11.7,5362,1625,3737,3.7,12.1,-169,-0.4,23.4,0,250,250,1008
1994,28740,3275,3613,42720,43410,370,10.2,395,10.9,5937,2574,3363,5.9,13.7,7317,3219,4098,7.4,16.9,-1380,-3.2,27.4,0,273,273,1084
1995,28740,3317,3642,43064,42871,428,11.8,393,10.8,6382,2193,4189,5.1,14.9,5996,2270,3726,5.3,14,386,0.9,28,0,264,265,1296
1996,28740,3315,3648,43492,43269,363,10,350,9.6,6604,2983,3621,6.9,15.3,6158,1806,4352,4.2,14.2,446,1.1,28.4,0,248,248,1063
1997,28740,3363,3699,44489,43979,414,11.3,349,9.5,6792,2236,4556,5.1,15.4,5772,1937,3835,4.4,13.1,1020,2.3,26.2,0,226,226,981
1998,28740,3416,3757,47053,45823,415,11.1,360,9.7,7983,3203,4780,7,17.4,5522,1950,3572,4.3,12.1,2461,5.3,24.2,0,246,246,1396
1999,28740,3466,3810,47141,47087,392,10.4,333,8.8,6351,2332,4019,5,13.5,6242,1338,4904,2.8,13.3,109,0.2,26.6,0,234,234,1001
2000,28740,3498,3844,47141,47158,395,10.3,366,9.6,6490,2177,4313,4.6,13.8,6524,2477,4047,5.3,13.8,-34,0,27.6,0,245,245,799
2001,28740,3558,3890,47647,47484,413,10.6,412,10.6,6633,2701,3932,5.7,14,6307,2964,3343,6.2,13.3,326,0.7,26.6,0,262,262,1757
2002,28740,3595,3930,48070,47765,469,12,423,10.8,7097,2490,4607,5.2,14.9,6487,2084,4403,4.4,13.6,610,1.3,27.2,0,237,237,989
2003,28740,3669,4008,48891,48416,449,11.3,331,8.4,6190,1935,4255,4,12.8,5240,1653,3587,3.4,10.8,950,2,21.6,0,233,233,943
2004,28740,3762,4105,48405,48465,450,11.1,325,8,6225,2171,4054,4.5,12.8,6344,1333,5011,2.8,13.1,-119,-0.3,25.6,0,222,222,886
2005,28740,3817,4178,50045,49122,492,11.9,400,9.7,7759,4580,3179,9.3,15.8,5913,1985,3928,4,12,1846,3.8,24,0,282,282,1168
2006,28740,3872,4236,47996,48936,496,11.8,411,9.8,7558,2818,4740,5.8,15.4,9437,2253,7184,4.6,19.3,-1879,-3.9,30.8,0,296,296,1421
2007,28740,3922,4305,47506,47707,501,11.7,419,9.8,6863,3065,3798,6.4,14.4,7265,1690,5575,3.5,15.2,-402,-0.8,28.8,0,287,288,1141
2008,28740,3873,4258,47192,47085,396,9.3,409,9.6,6442,2696,3746,5.7,13.7,6227,2180,4047,4.6,13.2,215,0.5,26.4,0,280,280,1508
2009,28740,3740,4126,44829,45854,338,8.1,422,10.1,4682,1789,2893,3.9,10.2,6731,2034,4697,4.4,14.7,-2049,-4.5,20.4,0,270,270,1382
2010,28740,3738,4127,44965,44870,367,8.9,353,8.6,4959,1832,3127,4.1,11.1,4768,1197,3571,2.7,10.6,191,0.5,21.2,0,215,215,785
2011,28740,3693,4078,44240,44650,350,8.5,402,9.8,5110,1821,3289,4.1,11.4,5929,1636,4293,3.7,13.3,-819,-1.9,22.8,0,251,251,977
2012,28740,3739,4128,44460,44253,415,10.1,364,8.9,5595,1715,3880,3.9,12.6,5180,1702,3478,3.8,11.7,415,0.9,23.4,0,225,227,999
2013,28740,3696,4077,44194,44386,354,8.6,417,10.2,5204,1687,3517,3.8,11.7,5587,2103,3484,4.7,12.6,-383,-0.9,23.4,0,248,249,1089
2014,28740,3713,4090,44863,44462,395,9.7,370,9.1,5663,2342,3321,5.3,12.7,4861,1745,3116,3.9,10.9,802,1.8,21.8,0,231,231,1237
1977,28940,8015,9167,135788,133963,1517,16.9,1113,12.4,23878,10688,13190,8,17.8,20228,8223,12005,6.1,15.1,3650,2.7,30.2,0,765,768,4987
1978,28940,8421,9618,149878,142827,1521,16.2,1077,11.5,30013,11055,18958,7.7,21,15911,6697,9214,4.7,11.1,14102,9.9,22.2,0,780,781,3972
1979,28940,8512,9756,161128,155400,1392,14.4,1184,12.2,30995,14646,16349,9.4,19.9,19538,6699,12839,4.3,12.6,11457,7.3,25.2,0,841,843,3981
1980,28940,8655,9900,160699,160771,1313,13.4,1137,11.6,24040,9684,14356,6,15,24183,7879,16304,4.9,15,-143,0,30,0,786,786,4124
1981,28940,8425,9652,157112,157993,1199,12.3,1342,13.8,24115,10010,14105,6.3,15.3,25876,11278,14598,7.1,16.4,-1761,-1.1,30.6,0,858,861,4742
1982,28940,8629,10009,162712,159935,1603,16.3,1161,11.8,30081,14866,15215,9.3,18.8,24527,9516,15011,5.9,15.3,5554,3.5,30.6,0,710,710,5671
1983,28940,8876,10283,168358,165499,1384,13.6,1161,11.4,32509,17414,15095,10.5,19.6,26791,9072,17719,5.5,16.2,5718,3.4,32.4,0,793,793,5171
1984,28940,9239,10730,173131,170776,1650,15.7,1201,11.4,30075,11023,19052,6.5,17.6,25364,8174,17190,4.8,14.9,4711,2.7,29.8,0,833,843,5141
1985,28940,9553,11089,178929,176693,1581,14.5,1235,11.3,29569,12025,17544,6.8,16.7,25097,8927,16170,5.1,14.2,4472,2.5,28.4,0,796,798,4235
1986,28940,9874,11477,183622,181200,1607,14.2,1175,10.4,29510,11353,18157,6.3,16.3,24666,8524,16142,4.7,13.6,4844,2.7,27.2,0,759,759,4817
1987,28940,10263,11980,195243,191145,1889,16.1,1336,11.4,35963,15828,20135,8.3,18.8,27766,10800,16966,5.7,14.5,8197,4.3,29,0,868,872,5301
1988,28940,10311,12109,203499,198530,1582,13.2,1374,11.4,39249,13880,25369,7,19.8,29311,12753,16558,6.4,14.8,9938,5,29.6,0,944,944,5166
1989,28940,10542,12424,209938,207041,1572,12.8,1275,10.4,37908,14822,23086,7.2,18.3,32113,10162,21951,4.9,15.5,5795,2.8,31,0,879,884,5645
1990,28940,10621,12558,215715,212698,1508,12.1,1305,10.5,35884,13838,22046,6.5,16.9,29850,10208,19642,4.8,14,6034,2.9,28,0,896,899,5752
1991,28940,10865,12883,214952,215415,1565,12.3,1242,9.8,30607,12050,18557,5.6,14.2,31532,11655,19877,5.4,14.6,-925,-0.4,28.4,0,785,808,5401
1992,28940,10932,13070,221130,218024,1573,12.1,1354,10.4,36834,13210,23624,6.1,16.9,30622,11239,19383,5.2,14,6212,2.9,28,0,891,900,6873
1993,28940,11109,13241,228774,224830,1458,11.1,1229,9.3,37119,11186,25933,5,16.5,29230,9803,19427,4.4,13,7889,3.5,26,0,817,820,5184
1994,28940,11305,13429,236797,232660,1489,11.2,1257,9.4,37218,13753,23465,5.9,16,28943,10516,18427,4.5,12.4,8275,3.6,24.8,0,813,813,4800
1995,28940,11628,13857,249145,242831,1712,12.6,1249,9.2,39708,13449,26259,5.5,16.4,27080,9132,17948,3.8,11.2,12628,5.2,22.4,0,874,878,5839
1996,28940,11842,14110,254560,252092,1610,11.5,1332,9.5,41642,16310,25332,6.5,16.5,36706,13900,22806,5.5,14.6,4936,1.9,29.2,0,873,873,5500
1997,28940,12000,14415,251769,253606,1825,12.8,1571,11,41849,16683,25166,6.6,16.5,45523,13291,32232,5.2,18,-3674,-1.5,33,0,1024,1024,7861
1998,28940,11924,14399,264114,257827,1587,11,1546,10.7,46523,14602,31921,5.7,18,33949,14270,19679,5.5,13.2,12574,4.8,26.4,0,1042,1042,7286
1999,28940,11834,14430,270988,267549,1624,11.3,1571,10.9,44785,17523,27262,6.5,16.7,37906,14921,22985,5.6,14.2,6879,2.5,28.4,0,1050,1050,5887
2000,28940,11772,14523,276591,273894,1554,10.7,1494,10.3,44581,19068,25513,7,16.3,39186,14862,24324,5.4,14.3,5395,2,28.6,0,899,899,5706
2001,28940,11776,14615,278226,277739,1522,10.4,1521,10.4,38863,13244,25619,4.8,14,37888,11858,26030,4.3,13.6,975,0.4,27.2,0,913,913,5931
2002,28940,11699,14528,277474,276524,1642,11.3,1712,11.8,47422,19176,28246,6.9,17.1,45522,15486,30036,5.6,16.5,1900,0.6,33,0,854,855,5060
2003,28940,11759,14638,282110,277921,1570,10.8,1202,8.3,44507,16334,28173,5.9,16,36128,10361,25767,3.7,13,8379,3,26,0,836,836,5032
2004,28940,11896,14765,290347,285316,1509,10.3,1261,8.6,42960,12929,30031,4.5,15.1,32898,9493,23405,3.3,11.5,10062,3.6,23,0,803,803,4954
2005,28940,12022,14980,292633,290698,1650,11.1,1293,8.7,40567,12763,27804,4.4,14,36696,12010,24686,4.1,12.6,3871,1.4,25.2,0,889,889,6410
2006,28940,12115,15199,307828,299852,1658,11,1309,8.7,50536,15618,34918,5.2,16.9,34584,12644,21940,4.2,11.5,15952,5.4,23,0,853,858,6296
2007,28940,12367,15515,306859,306578,1716,11.2,1347,8.8,48678,15151,33527,4.9,15.9,48116,14665,33451,4.8,15.7,562,0.2,31.4,0,824,831,5896
2008,28940,12417,15636,313047,311014,1502,9.7,1250,8.1,45182,14663,30519,4.7,14.5,41116,11293,29823,3.6,13.2,4066,1.3,26.4,0,893,893,7718
2009,28940,11862,15102,290667,300888,1225,8,1586,10.4,33873,12511,21362,4.2,11.3,54315,14502,39813,4.8,18.1,-20442,-6.8,22.6,0,1077,1082,9064
2010,28940,11573,14843,288979,288458,1234,8.3,1379,9.2,35464,12671,22793,4.4,12.3,34421,10242,24179,3.6,11.9,1043,0.4,23.8,0,952,952,6827
2011,28940,11384,14682,292941,290439,1194,8.1,1268,8.6,37450,9962,27488,3.4,12.9,32446,11489,20957,4,11.2,5004,1.7,22.4,0,892,901,9012
2012,28940,11418,14739,299969,295432,1314,8.9,1283,8.7,43159,10879,32280,3.7,14.6,34084,12987,21097,4.4,11.5,9075,3.1,23,0,780,781,5051
2013,28940,11355,14716,312487,305641,1180,8,1197,8.2,44765,10264,34501,3.4,14.6,31073,10245,20828,3.4,10.2,13692,4.4,20.4,0,835,842,6729
2014,28940,11240,14636,312954,311022,1218,8.3,1170,8,37985,12428,25557,4,12.2,34120,10400,23720,3.3,11,3865,1.2,22,0,815,819,4496
1977,29020,1656,1795,43605,41416,286,16.3,215,12.2,7672,3922,3750,9.5,18.5,3294,1235,2059,3,8,4378,10.5,16,0,128,129,703
1978,29020,1684,1831,43386,43483,228,12.6,191,10.5,4130,1357,2773,3.1,9.5,4323,1470,2853,3.4,9.9,-193,-0.4,19,0,140,140,1003
1979,29020,1692,1846,44691,44006,224,12.2,197,10.7,4973,1357,3616,3.1,11.3,3602,921,2681,2.1,8.2,1371,3.1,16.4,0,132,132,588
1980,29020,1689,1849,40667,42671,213,11.5,203,11,4199,1875,2324,4.4,9.8,8206,3656,4550,8.6,19.2,-4007,-9.4,19.6,0,138,139,482
1981,29020,1604,1755,37364,38242,182,10.1,246,13.7,3771,1387,2384,3.6,9.9,5527,2024,3503,5.3,14.5,-1756,-4.6,19.8,0,149,149,739
1982,29020,1595,1755,35196,36262,197,11.2,179,10.2,3597,1691,1906,4.7,9.9,5728,1196,4532,3.3,15.8,-2131,-5.9,19.8,0,101,101,599
1983,29020,1507,1657,33934,34537,161,9.4,238,14,2784,897,1887,2.6,8.1,3990,1205,2785,3.5,11.6,-1206,-3.5,16.2,0,132,134,728
1984,29020,1631,1788,37442,35808,201,11.7,109,6.3,5119,1016,4103,2.8,14.3,1850,721,1129,2,5.2,3269,9.1,10.4,1,1,1,
1985,29020,1665,1823,39873,39234,207,11.4,186,10.3,3819,1216,2603,3.1,9.7,2540,940,1600,2.4,6.5,1279,3.2,13,0,126,126,492
1986,29020,1706,1860,40379,40102,226,12.3,184,10,4755,1678,3077,4.2,11.9,4201,2160,2041,5.4,10.5,554,1.4,21,0,123,123,597
1987,29020,1715,1868,38914,39553,224,12,212,11.4,3996,1282,2714,3.2,10.1,5273,2081,3192,5.3,13.3,-1277,-3.2,20.2,0,126,126,736
1988,29020,1751,1905,37512,37638,250,13.3,200,10.6,4253,2287,1966,6.1,11.3,4505,1675,2830,4.5,12,-252,-0.7,22.6,0,124,124,577
1989,29020,1747,1929,40306,38944,222,11.6,202,10.5,6029,1806,4223,4.6,15.5,3304,1484,1820,3.8,8.5,2725,7,17,0,130,130,646
1990,29020,1747,1934,40065,40141,195,10.1,179,9.3,3636,1138,2498,2.8,9.1,3787,1248,2539,3.1,9.4,-151,-0.3,18.2,0,119,119,579
1991,29020,1763,1946,39269,39636,186,9.6,176,9.1,3449,1518,1931,3.8,8.7,4183,958,3225,2.4,10.6,-734,-1.9,17.4,0,121,121,538
1992,29020,1761,1949,40198,37439,189,9.7,175,9,8640,6214,2426,16.6,23.1,3121,947,2174,2.5,8.3,5519,14.8,16.6,0,116,116,533
1993,29020,1816,2002,41196,40699,214,10.8,156,7.9,4776,1401,3375,3.4,11.7,3781,1174,2607,2.9,9.3,995,2.4,18.6,0,100,101,408
1994,29020,1805,1995,43394,42302,190,9.5,188,9.4,5704,2107,3597,5,13.5,3519,1492,2027,3.5,8.3,2185,5.2,16.6,0,133,133,925
1995,29020,1867,2066,44690,44030,210,10.3,141,6.9,5211,2004,3207,4.6,11.8,3891,1119,2772,2.5,8.8,1320,3,17.6,0,87,87,412
1996,29020,1888,2090,47311,50084,189,9.1,164,7.9,4993,1866,3127,3.7,10,10539,7864,2675,15.7,21,-5546,-11,20,0,108,108,663
1997,29020,1910,2123,47049,47176,231,11,193,9.2,4771,1766,3005,3.7,10.1,5025,1408,3617,3,10.7,-254,-0.6,20.2,0,116,116,675
1998,29020,1889,2104,46123,46558,190,9,206,9.7,4299,1508,2791,3.2,9.2,5169,1299,3870,2.8,11.1,-870,-1.9,18.4,0,140,140,695
1999,29020,1906,2135,46816,47121,201,9.5,176,8.3,4794,1511,3283,3.2,10.2,5403,1026,4377,2.2,11.5,-609,-1.3,20.4,0,115,115,575
2000,29020,1874,2098,48910,47782,170,8,204,9.6,6495,2581,3914,5.4,13.6,4238,1152,3086,2.4,8.9,2257,4.7,17.8,0,122,122,569
2001,29020,1878,2112,44270,46608,195,9.3,191,9.1,4381,1461,2920,3.1,9.4,9057,1750,7307,3.8,19.4,-4676,-10,18.8,0,107,107,882
2002,29020,1885,2120,41560,43188,227,10.7,218,10.3,4674,1708,2966,4,10.8,7929,1819,6110,4.2,18.4,-3255,-7.6,21.6,0,105,105,482
2003,29020,1897,2131,41613,41475,208,9.8,168,7.9,4479,1467,3012,3.5,10.8,4202,850,3352,2,10.1,277,0.7,20.2,0,107,107,492
2004,29020,1907,2141,42694,42118,185,8.7,157,7.4,6437,1082,5355,2.6,15.3,5285,1615,3670,3.8,12.5,1152,2.8,25,0,96,96,497
2005,29020,1917,2150,43889,43192,202,9.5,165,7.7,5703,2130,3573,4.9,13.2,4309,1140,3169,2.6,10,1394,3.2,20,0,114,114,841
2006,29020,1861,2097,42402,42959,181,8.6,198,9.4,4336,1176,3160,2.7,10.1,5449,1285,4164,3,12.7,-1113,-2.6,20.2,0,136,136,814
2007,29020,1833,2083,41938,42180,176,8.4,197,9.4,4742,1456,3286,3.5,11.2,5225,1590,3635,3.8,12.4,-483,-1.2,22.4,0,125,125,1045
2008,29020,1808,2060,37532,39659,174,8.4,185,9,3751,1481,2270,3.7,9.5,8004,2954,5050,7.4,20.2,-4253,-10.7,19,0,128,130,2621
2009,29020,1750,1983,33331,35197,123,6.1,184,9.1,2983,1269,1714,3.6,8.5,6715,1847,4868,5.2,19.1,-3732,-10.6,17,0,113,114,1341
2010,29020,1689,1924,31950,32720,128,6.6,184,9.4,3042,837,2205,2.6,9.3,4582,874,3708,2.7,14,-1540,-4.7,18.6,0,121,121,525
2011,29020,1673,1916,32397,32120,135,7.1,132,6.9,3268,661,2607,2.1,10.2,2714,495,2219,1.5,8.4,554,1.8,16.8,0,92,93,403
2012,29020,1672,1920,32343,32329,157,8.2,152,7.9,3601,894,2707,2.8,11.1,3572,1006,2566,3.1,11,29,0.1,22,0,79,80,414
2013,29020,1658,1895,33416,32834,129,6.8,146,7.7,4165,865,3300,2.6,12.7,3001,846,2155,2.6,9.1,1164,3.6,18.2,0,80,80,470
2014,29020,1631,1861,34149,33748,127,6.8,143,7.7,3507,717,2790,2.1,10.4,2705,832,1873,2.5,8,802,2.4,16,0,96,96,490
1977,29100,2020,2169,34606,33156,348,16.5,216,10.3,6617,3296,3321,9.9,20,3717,1554,2163,4.7,11.2,2900,8.8,22.4,0,139,139,1098
1978,29100,2086,2239,38583,36596,297,13.5,227,10.3,7448,2247,5201,6.1,20.4,3473,1415,2058,3.9,9.5,3975,10.9,19,0,162,162,1032
1979,29100,2149,2307,39852,39163,311,13.7,232,10.2,6006,2163,3843,5.5,15.3,4627,2014,2613,5.1,11.8,1379,3.5,23.6,0,166,167,1121
1980,29100,2162,2329,39972,39885,294,12.7,263,11.3,5579,2511,3068,6.3,14,5405,1851,3554,4.6,13.6,174,0.4,27.2,0,199,199,1167
1981,29100,2146,2317,41216,40298,307,13.2,296,12.8,7394,3692,3702,9.2,18.3,5557,2231,3326,5.5,13.8,1837,4.5,27.6,0,173,173,1240
1982,29100,2158,2364,39550,40322,330,14.1,259,11.1,4585,2130,2455,5.3,11.4,6129,2214,3915,5.5,15.2,-1544,-3.8,22.8,0,151,152,952
1983,29100,2230,2445,40743,40180,283,11.8,226,9.4,6005,2192,3813,5.5,14.9,4879,1416,3463,3.5,12.1,1126,2.8,24.2,0,142,142,789
1984,29100,2277,2486,41646,41192,305,12.4,263,10.7,9374,3780,5594,9.2,22.8,8466,3251,5215,7.9,20.6,908,2.2,41.2,0,164,165,903
1985,29100,2323,2526,40837,41330,308,12.3,254,10.1,5810,2393,3417,5.8,14.1,6795,2504,4291,6.1,16.4,-985,-2.3,28.2,0,172,174,1552
1986,29100,2204,2420,41895,41295,263,10.6,340,13.8,7963,2082,5881,5,19.3,6763,3434,3329,8.3,16.4,1200,2.9,32.8,0,193,194,1716
1987,29100,2336,2580,45523,43747,344,13.8,198,7.9,8193,3002,5191,6.9,18.7,4640,1448,3192,3.3,10.6,3553,8.1,21.2,0,68,72,599
1988,29100,2359,2611,47214,46165,266,10.3,228,8.8,6998,1793,5205,3.9,15.2,4899,1190,3709,2.6,10.6,2099,4.6,21.2,0,159,159,817
1989,29100,2383,2643,47837,47524,260,9.9,234,8.9,6948,2240,4708,4.7,14.6,6322,1867,4455,3.9,13.3,626,1.3,26.6,0,155,155,1062
1990,29100,2437,2712,50232,48996,301,11.2,220,8.2,7585,2636,4949,5.4,15.5,5112,1685,3427,3.4,10.4,2473,5.1,20.8,0,143,144,849
1991,29100,2500,2792,52007,51108,313,11.4,233,8.5,8045,3056,4989,6,15.7,6246,1651,4595,3.2,12.2,1799,3.5,24.4,0,157,158,1009
1992,29100,2502,2811,52226,52168,285,10.2,255,9.1,6771,2523,4248,4.8,13,6655,1995,4660,3.8,12.8,116,0.2,25.6,0,171,172,1211
1993,29100,2537,2839,53854,53051,258,9.1,222,7.9,7119,1681,5438,3.2,13.4,5512,1990,3522,3.8,10.4,1607,3,20.8,0,147,147,685
1994,29100,2588,2908,54844,54359,295,10.3,229,8,7009,2446,4563,4.5,12.9,6038,1250,4788,2.3,11.1,971,1.8,22.2,0,164,164,824
1995,29100,2625,2947,56266,55460,282,9.6,231,7.9,6356,1961,4395,3.5,11.5,4743,1350,3393,2.4,8.6,1613,2.9,17.2,0,165,165,853
1996,29100,2614,2936,56037,56115,272,9.3,277,9.4,5741,1446,4295,2.6,10.2,5896,1727,4169,3.1,10.5,-155,-0.3,20.4,0,192,192,843
1997,29100,2673,3007,58068,57109,302,10.1,236,7.9,8697,3401,5296,6,15.2,6778,2705,4073,4.7,11.9,1919,3.3,23.8,0,139,139,727
1998,29100,2661,3022,59202,58596,280,9.3,258,8.6,7062,2602,4460,4.4,12.1,5849,1617,4232,2.8,10,1213,2.1,20,0,182,182,1077
1999,29100,2672,3030,60239,59714,256,8.5,245,8.1,6320,1793,4527,3,10.6,5269,1374,3895,2.3,8.8,1051,1.8,17.6,0,166,166,679
2000,29100,2659,3018,60549,60413,243,8,258,8.5,7270,1828,5442,3,12,6998,2364,4634,3.9,11.6,272,0.4,23.2,0,157,157,870
2001,29100,2661,3047,60464,60559,245,8.1,240,7.9,8991,5169,3822,8.5,14.8,9181,4024,5157,6.6,15.2,-190,-0.4,29.6,0,142,142,3167
2002,29100,2663,3057,60418,60435,301,9.9,287,9.4,8214,3280,4934,5.4,13.6,8247,2334,5913,3.9,13.6,-33,0,27.2,0,154,154,767
2003,29100,2684,3079,61314,60489,283,9.3,217,7.1,8747,3832,4915,6.3,14.5,7097,1662,5435,2.7,11.7,1650,2.8,23.4,0,146,146,843
2004,29100,2727,3128,62388,61789,285,9.2,218,7,8148,2640,5508,4.3,13.2,6950,2787,4163,4.5,11.2,1198,2,22.4,0,138,138,1012
2005,29100,2786,3194,63008,62640,295,9.4,220,7,8296,2889,5407,4.6,13.2,7560,2674,4886,4.3,12.1,736,1.1,24.2,0,162,162,975
2006,29100,2773,3206,63975,63244,309,9.7,268,8.4,8018,3054,4964,4.8,12.7,6555,2187,4368,3.5,10.4,1463,2.3,20.8,0,171,171,1283
2007,29100,2771,3201,61546,62743,287,9,284,8.9,7344,2029,5315,3.2,11.7,9737,2322,7415,3.7,15.5,-2393,-3.8,23.4,0,168,168,1412
2008,29100,2726,3175,62366,61905,241,7.6,245,7.7,7021,1882,5139,3,11.3,6099,1401,4698,2.3,9.9,922,1.4,19.8,0,161,161,936
2009,29100,2682,3138,60986,61669,208,6.6,228,7.2,5585,1952,3633,3.2,9.1,6951,1791,5160,2.9,11.3,-1366,-2.2,18.2,0,156,156,1095
2010,29100,2640,3108,61235,61055,216,6.9,231,7.4,5804,2295,3509,3.8,9.5,5444,1517,3927,2.5,8.9,360,0.6,17.8,0,149,149,915
2011,29100,2629,3105,62180,61664,211,6.8,200,6.4,5807,1715,4092,2.8,9.4,4774,1054,3720,1.7,7.7,1033,1.7,15.4,0,127,127,724
2012,29100,2649,3130,62863,62486,233,7.5,213,6.8,7293,2004,5289,3.2,11.7,6539,1523,5016,2.4,10.5,754,1.2,21,0,120,122,724
2013,29100,2636,3122,65556,63977,209,6.7,211,6.8,10233,2337,7896,3.7,16,7075,1424,5651,2.2,11.1,3158,4.9,22.2,0,132,132,1004
2014,29100,2638,3133,65089,65287,249,8,225,7.2,8800,3089,5711,4.7,13.5,9195,2043,7152,3.1,14.1,-395,-0.6,27,0,148,148,865
1977,29140,2282,2510,38024,37674,368,14.9,294,11.9,5393,2342,3051,6.2,14.3,4692,1973,2719,5.2,12.5,701,1.8,25,0,181,181,1051
1978,29140,2343,2576,42435,40231,334,13.1,268,10.5,7578,2264,5314,5.6,18.8,3170,1340,1830,3.3,7.9,4408,10.9,15.8,0,177,177,754
1979,29140,2368,2611,45020,43695,324,12.5,271,10.4,7273,2449,4824,5.6,16.6,4623,1688,2935,3.9,10.6,2650,6,21.2,0,196,196,1113
1980,29140,2408,2648,43926,44466,317,12.1,275,10.5,5249,2315,2934,5.2,11.8,6328,2043,4285,4.6,14.2,-1079,-2.4,23.6,0,184,184,851
1981,29140,2310,2544,41822,42511,245,9.5,309,11.9,5308,2190,3118,5.2,12.5,6685,2595,4090,6.1,15.7,-1377,-3.2,25,0,197,197,1183
1982,29140,2322,2588,42151,41986,350,13.6,291,11.3,6627,2684,3943,6.4,15.8,6297,2102,4195,5,15,330,0.8,30,0,184,184,1089
1983,29140,2237,2495,39605,40854,254,10,326,12.8,4673,1897,2776,4.6,11.4,7170,2283,4887,5.6,17.6,-2497,-6.2,22.8,0,171,171,799
1984,29140,2405,2667,43035,41333,297,11.5,169,6.5,7403,2177,5226,5.3,17.9,3999,1167,2832,2.8,9.7,3404,8.2,19.4,1,4,4,
1985,29140,2432,2704,44555,44181,339,12.6,316,11.7,6666,2258,4408,5.1,15.1,5918,2289,3629,5.2,13.4,748,1.7,26.8,0,210,210,1363
1986,29140,2507,2774,45521,44970,364,13.3,278,10.2,6919,3133,3786,7,15.4,5817,2110,3707,4.7,12.9,1102,2.5,25.8,0,172,172,854
1987,29140,2549,2846,48390,47061,362,12.9,280,10,8230,3323,4907,7.1,17.5,5572,2054,3518,4.4,11.8,2658,5.7,23.6,0,186,191,1247
1988,29140,2536,2838,49534,48502,307,10.8,292,10.3,8591,3026,5565,6.2,17.7,6526,2288,4238,4.7,13.5,2065,4.2,27,0,177,177,804
1989,29140,2601,2921,52162,51088,315,10.9,240,8.3,8500,2879,5621,5.6,16.6,6352,2184,4168,4.3,12.4,2148,4.2,24.8,0,156,156,609
1990,29140,2660,2994,53708,52531,345,11.7,249,8.4,7714,2242,5472,4.3,14.7,5359,1908,3451,3.6,10.2,2355,4.5,20.4,0,180,180,1187
1991,29140,2728,3087,55211,54500,338,11.1,248,8.2,8329,2866,5463,5.3,15.3,6907,2219,4688,4.1,12.7,1422,2.6,25.4,0,158,158,1201
1992,29140,2744,3121,55766,55497,343,11,301,9.7,7558,2452,5106,4.4,13.6,7020,2329,4691,4.2,12.6,538,1,25.2,0,186,186,1107
1993,29140,2816,3177,57008,56393,326,10.4,270,8.6,7076,1582,5494,2.8,12.5,5845,1780,4065,3.2,10.4,1231,2.1,20.8,0,192,196,935
1994,29140,2865,3222,58891,57963,348,10.9,295,9.2,8160,2550,5610,4.4,14.1,6304,2178,4126,3.8,10.9,1856,3.2,21.8,0,199,199,983
1995,29140,2907,3278,62164,60515,343,10.6,282,8.7,9976,3778,6198,6.2,16.5,6678,2259,4419,3.7,11,3298,5.5,22,0,195,195,1172
1996,29140,2951,3320,65057,63643,366,11.1,313,9.5,9343,3530,5813,5.5,14.7,6515,2285,4230,3.6,10.2,2828,4.5,20.4,0,194,194,996
1997,29140,2985,3399,66198,65676,426,12.7,351,10.4,10115,4345,5770,6.6,15.4,9071,3341,5730,5.1,13.8,1044,1.6,27.6,0,221,221,1053
1998,29140,3009,3419,67933,66971,331,9.7,297,8.7,8796,2737,6059,4.1,13.1,6872,1912,4960,2.9,10.3,1924,2.8,20.6,0,194,194,891
1999,29140,3033,3459,70649,69339,322,9.4,283,8.2,9292,2726,6566,3.9,13.4,6672,1456,5216,2.1,9.6,2620,3.8,19.2,0,182,182,880
2000,29140,3072,3521,73233,71950,367,10.5,309,8.9,10408,4361,6047,6.1,14.5,7841,2273,5568,3.2,10.9,2567,3.6,21.8,0,202,202,1311
2001,29140,3050,3507,69732,71726,317,9,362,10.3,7272,2187,5085,3,10.1,11259,2970,8289,4.1,15.7,-3987,-5.6,20.2,0,214,214,1015
2002,29140,3044,3491,67361,68566,377,10.8,395,11.3,7405,3048,4357,4.4,10.8,9814,3417,6397,5,14.3,-2409,-3.5,21.6,0,209,209,1268
2003,29140,3060,3529,65856,66406,332,9.5,247,7.1,6990,2305,4685,3.5,10.5,8090,1383,6707,2.1,12.2,-1100,-1.7,21,0,173,174,716
2004,29140,3065,3530,66484,65886,329,9.4,295,8.4,8032,2934,5098,4.5,12.2,6835,2332,4503,3.5,10.4,1197,1.8,20.8,0,197,197,1399
2005,29140,3099,3579,67491,66863,358,10.1,282,8,8119,2620,5499,3.9,12.1,6862,2229,4633,3.3,10.3,1257,1.8,20.6,0,201,201,1545
2006,29140,3111,3613,69938,68484,381,10.6,310,8.6,9673,3268,6405,4.8,14.1,6765,1969,4796,2.9,9.9,2908,4.2,19.8,0,199,199,1317
2007,29140,3143,3652,70855,70369,380,10.5,335,9.3,9937,3914,6023,5.6,14.1,8964,2563,6401,3.6,12.7,973,1.4,25.4,0,200,201,1264
2008,29140,3158,3665,67850,68987,336,9.2,278,7.6,7100,2422,4678,3.5,10.3,9374,2236,7138,3.2,13.6,-2274,-3.3,20.6,0,203,203,1576
2009,29140,3081,3589,65469,66481,263,7.3,307,8.5,6591,2623,3968,3.9,9.9,8615,1908,6707,2.9,13,-2024,-3.1,19.8,0,214,215,948
2010,29140,3052,3606,63905,64638,287,8,252,7,6948,2503,4445,3.9,10.7,8414,1734,6680,2.7,13,-1466,-2.3,21.4,0,172,172,1301
2011,29140,3031,3598,65475,64524,281,7.8,249,6.9,7178,1623,5555,2.5,11.1,5275,1183,4092,1.8,8.2,1903,2.9,16.4,0,164,164,805
2012,29140,3033,3619,69192,67340,323,9,311,8.6,10353,2462,7891,3.7,15.4,6649,2387,4262,3.5,9.9,3704,5.5,19.8,0,188,188,1266
2013,29140,3058,3631,70336,69647,282,7.8,264,7.3,7209,1943,5266,2.8,10.4,5831,1486,4345,2.1,8.4,1378,2,16.8,0,172,172,1081
2014,29140,3040,3615,70250,70172,288,8,268,7.4,7805,2798,5007,4,11.1,7649,1509,6140,2.2,10.9,156,0.2,21.8,0,178,178,858
1977,29180,3442,3726,52891,51617,688,19.2,415,11.6,13226,6127,7099,11.9,25.6,10678,3803,6875,7.4,20.7,2548,4.9,41.4,0,309,310,2676
1978,29180,3465,3770,60777,56742,614,16.4,530,14.1,16190,4487,11703,7.9,28.5,8120,3520,4600,6.2,14.3,8070,14.2,28.6,0,316,316,1791
1979,29180,3976,4332,75331,69594,811,20,278,6.9,18688,6660,12028,9.6,26.9,7214,2252,4962,3.2,10.4,11474,16.5,20.8,0,4,5,118
1980,29180,4246,4636,78332,76830,813,18.1,497,11.1,17696,7179,10517,9.3,23,14692,4540,10152,5.9,19.1,3004,3.9,38.2,0,351,351,2624
1981,29180,4517,4929,89074,83435,896,18.8,573,12,22917,8824,14093,10.6,27.5,11639,4830,6809,5.8,13.9,11278,13.6,27.8,0,363,363,2089
1982,29180,5047,5535,99580,94165,1198,22.9,554,10.6,27836,11381,16455,12.1,29.6,17006,6349,10657,6.7,18.1,10830,11.5,36.2,0,317,317,2376
1983,29180,5158,5644,86122,92188,818,14.6,733,13.1,14975,6991,7984,7.6,16.2,27106,7818,19288,8.5,29.4,-12131,-13.2,32.4,0,537,538,4677
1984,29180,5081,5593,84834,85487,771,13.7,820,14.6,15317,5573,9744,6.5,17.9,16623,5858,10765,6.9,19.4,-1306,-1.5,35.8,0,566,567,3523
1985,29180,5140,5648,83414,84127,784,13.9,727,12.9,15528,6209,9319,7.4,18.5,16954,5440,11514,6.5,20.2,-1426,-1.7,37,0,505,509,3129
1986,29180,5049,5534,79848,81558,739,13.2,829,14.8,13742,6490,7252,8,16.8,17161,5936,11225,7.3,21,-3419,-4.2,33.6,0,598,604,3621
1987,29180,4625,5118,68947,74500,673,12.6,1031,19.3,13175,6037,7138,8.1,17.7,24281,9423,14858,12.6,32.6,-11106,-14.9,35.4,0,677,685,4529
1988,29180,4501,5026,71779,70122,670,13.2,718,14.2,15823,4485,11338,6.4,22.6,12508,6065,6443,8.6,17.8,3315,4.8,35.6,0,492,492,2355
1989,29180,4521,5043,76499,74140,600,11.9,597,11.9,15488,6034,9454,8.1,20.9,10769,3752,7017,5.1,14.5,4719,6.4,29,0,410,412,1967
1990,29180,4585,5114,78995,76385,577,11.4,471,9.3,17845,6963,10882,9.1,23.4,12625,4754,7871,6.2,16.5,5220,6.9,33,0,307,309,2293
1991,29180,4731,5290,80971,79928,625,12,468,9,15924,6635,9289,8.3,19.9,13838,4091,9747,5.1,17.3,2086,2.6,34.6,0,305,305,2345
1992,29180,4899,5486,84822,82743,700,13,480,8.9,18795,6159,12636,7.4,22.7,14637,4317,10320,5.2,17.7,4158,5,35.4,0,330,331,2674
1993,29180,4989,5563,83171,83861,650,11.8,559,10.1,14532,5627,8905,6.7,17.3,15911,4368,11543,5.2,19,-1379,-1.7,34.6,0,374,374,2350
1994,29180,5145,5723,87131,85001,676,12,502,8.9,16687,6095,10592,7.2,19.6,12427,4485,7942,5.3,14.6,4260,5,29.2,0,330,331,2326
1995,29180,5282,5855,89928,88171,717,12.4,560,9.7,17760,7314,10446,8.3,20.1,14245,7058,7187,8,16.2,3515,3.9,32.4,0,364,376,4180
1996,29180,5479,6058,93627,91858,710,11.9,506,8.5,16321,5714,10607,6.2,17.8,12782,4554,8228,5,13.9,3539,3.9,27.8,0,340,340,2435
1997,29180,5609,6240,98983,96456,784,12.7,604,9.8,20119,7269,12850,7.5,20.9,15065,5862,9203,6.1,15.6,5054,5.3,31.2,0,395,395,3264
1998,29180,5768,6415,105673,102477,807,12.8,620,9.8,22266,7890,14376,7.7,21.7,15874,6601,9273,6.4,15.5,6392,6.2,31,0,401,401,3507
1999,29180,5847,6534,107408,107026,776,12,657,10.1,19989,8763,11226,8.2,18.7,19225,6913,12312,6.5,18,764,0.7,36,0,412,412,3271
2000,29180,5837,6587,109892,108581,766,11.7,704,10.7,20560,9121,11439,8.4,18.9,17938,6856,11082,6.3,16.5,2622,2.4,33,0,435,435,4151
2001,29180,5892,6704,113495,111922,753,11.3,688,10.3,20707,9173,11534,8.2,18.5,17560,6163,11397,5.5,15.7,3147,2.8,31.4,0,408,408,2633
2002,29180,5995,6802,111376,112283,797,11.8,691,10.2,19107,7934,11173,7.1,17,20921,7110,13811,6.3,18.6,-1814,-1.6,34,0,376,376,2711
2003,29180,6122,6955,112704,111479,796,11.6,547,8,17144,6865,10279,6.2,15.4,14694,4884,9810,4.4,13.2,2450,2.2,26.4,0,388,388,3139
2004,29180,6274,7099,114352,113192,787,11.2,573,8.2,16943,5631,11312,5,15,14622,4955,9667,4.4,12.9,2321,2.1,25.8,0,384,384,2696
2005,29180,6301,7165,118062,115785,738,10.4,612,8.6,18525,5694,12831,4.9,16,13970,4762,9208,4.1,12.1,4555,3.9,24.2,0,420,420,3115
2006,29180,6487,7409,126923,122261,899,12.4,585,8,22831,7864,14967,6.4,18.7,13506,4837,8669,4,11,9325,7.7,22,0,373,373,3109
2007,29180,6743,7713,132914,129749,917,12.1,622,8.2,25065,7763,17302,6,19.3,18734,6260,12474,4.8,14.4,6331,4.9,28.8,0,404,404,3869
2008,29180,6870,7887,133700,132886,839,10.8,605,7.8,22580,8979,13601,6.8,17,20952,6363,14589,4.8,15.8,1628,1.2,31.6,0,434,434,5181
2009,29180,6842,7888,132848,132846,677,8.6,635,8.1,18915,6963,11952,5.2,14.2,18910,4770,14140,3.6,14.2,5,0,28.4,0,429,429,2789
2010,29180,6873,7950,126578,129495,724,9.2,638,8.1,14211,5667,8544,4.4,11,20045,4203,15842,3.2,15.5,-5834,-4.5,22,0,422,422,2594
2011,29180,6873,7968,134180,130305,688,8.7,624,7.9,21006,7077,13929,5.4,16.1,13255,3586,9669,2.8,10.2,7751,5.9,20.4,0,419,422,2117
2012,29180,6997,8171,137506,135768,797,9.9,623,7.7,21877,6875,15002,5.1,16.1,18401,6437,11964,4.7,13.6,3476,2.5,27.2,0,380,382,3259
2013,29180,7088,8259,145596,141447,691,8.4,605,7.4,23653,5324,18329,3.8,16.7,15355,5459,9896,3.9,10.9,8298,5.8,21.8,0,390,391,3574
2014,29180,7233,8431,143245,144076,777,9.3,555,6.7,18466,6687,11779,4.6,12.8,20128,3449,16679,2.4,14,-1662,-1.2,25.6,0,397,398,2190
1977,29340,2748,3077,43541,41588,576,19.4,357,12,9551,4491,5060,10.8,23,5644,2174,3470,5.2,13.6,3907,9.4,27.2,0,258,259,1542
1978,29340,2662,2978,47696,45496,432,14.3,497,16.4,11059,3199,7860,7,24.3,6658,3910,2748,8.6,14.6,4401,9.7,29.2,0,292,294,2013
1979,29340,2953,3296,52981,50465,542,17.3,245,7.8,12360,4316,8044,8.6,24.5,7328,2783,4545,5.5,14.5,5032,10,29,0,4,5,141
1980,29340,2990,3327,55452,54173,463,14,413,12.5,10981,3577,7404,6.6,20.3,8423,2480,5943,4.6,15.5,2558,4.8,31,0,284,284,1568
1981,29340,2981,3311,56585,55712,456,13.8,433,13.1,10629,4011,6618,7.2,19.1,8882,3572,5310,6.4,15.9,1747,3.2,31.8,0,263,265,1336
1982,29340,3084,3447,58076,57448,560,16.6,396,11.7,12465,4716,7749,8.2,21.7,11209,3500,7709,6.1,19.5,1256,2.2,39,0,245,245,1819
1983,29340,3150,3532,50886,54232,485,13.9,417,12,8066,3706,4360,6.8,14.9,14758,5104,9654,9.4,27.2,-6692,-12.3,29.8,0,285,285,3614
1984,29340,3175,3576,50214,50595,510,14.3,467,13.1,8382,3471,4911,6.9,16.6,9143,3078,6065,6.1,18.1,-761,-1.5,33.2,0,319,319,1683
1985,29340,3165,3567,49766,50262,441,12.3,452,12.6,8770,3480,5290,6.9,17.4,9761,3751,6010,7.5,19.4,-991,-2,34.8,0,286,287,1382
1986,29340,3100,3490,47711,48752,380,10.8,444,12.6,7463,3183,4280,6.5,15.3,9545,2879,6666,5.9,19.6,-2082,-4.3,30.6,0,289,289,1692
1987,29340,3070,3451,48701,48346,462,13.3,479,13.8,9133,5079,4054,10.5,18.9,8422,3123,5299,6.5,17.4,711,1.5,34.8,0,293,294,1576
1988,29340,2990,3400,48112,48120,405,11.8,439,12.8,7550,2683,4867,5.6,15.7,7565,3179,4386,6.6,15.7,-15,0,31.4,0,272,272,1502
1989,29340,2945,3370,49872,49088,349,10.3,381,11.3,8395,3070,5325,6.3,17.1,6827,2470,4357,5,13.9,1568,3.2,27.8,0,237,237,1546
1990,29340,3023,3487,53170,51564,400,11.7,285,8.3,8739,2925,5814,5.7,16.9,5526,1838,3688,3.6,10.7,3213,6.2,21.4,0,196,199,1118
1991,29340,3079,3567,55313,54178,422,12,341,9.7,9736,3987,5749,7.4,18,7465,2302,5163,4.2,13.8,2271,4.2,27.6,0,207,207,1308
1992,29340,3129,3621,59219,57233,411,11.4,353,9.8,13056,2683,10373,4.7,22.8,9084,3855,5229,6.7,15.9,3972,6.9,31.8,0,238,243,1645
1993,29340,3188,3694,57402,58222,394,10.8,309,8.4,10222,3162,7060,5.4,17.6,11861,2683,9178,4.6,20.4,-1639,-2.8,35.2,0,218,218,1610
1994,29340,3263,3774,62044,59746,424,11.4,338,9.1,12764,5938,6826,9.9,21.4,8167,2122,6045,3.6,13.7,4597,7.7,27.4,0,226,229,1113
1995,29340,3308,3854,64392,63280,417,10.9,336,8.8,10211,3347,6864,5.3,16.1,7987,2383,5604,3.8,12.6,2224,3.5,25.2,0,241,241,1407
1996,29340,3385,3941,68298,66278,424,10.9,328,8.4,12309,3981,8328,6,18.6,8268,2410,5858,3.6,12.5,4041,6.1,25,0,219,219,976
1997,29340,3472,4044,71091,69793,495,12.4,397,9.9,13791,4220,9571,6,19.8,11195,4436,6759,6.4,16,2596,3.8,32,0,250,250,1847
1998,29340,3481,4046,71559,71288,452,11.2,438,10.8,11889,5020,6869,7,16.7,11347,4855,6492,6.8,15.9,542,0.8,31.8,0,260,260,1996
1999,29340,3445,4016,70898,71854,394,9.8,420,10.4,9958,3514,6444,4.9,13.9,11869,4357,7512,6.1,16.5,-1911,-2.6,27.8,0,259,259,1988
2000,29340,3419,4038,69975,70447,426,10.6,409,10.2,9571,3993,5578,5.7,13.6,10515,3357,7158,4.8,14.9,-944,-1.3,27.2,0,258,258,1946
2001,29340,3386,4006,70476,70350,378,9.4,446,11.1,9463,3232,6231,4.6,13.5,9211,3327,5884,4.7,13.1,252,0.4,26.2,0,249,249,1508
2002,29340,3415,4058,72585,71486,457,11.3,407,10.1,13383,5381,8002,7.5,18.7,11185,3719,7466,5.2,15.6,2198,3.1,31.2,0,212,212,1725
2003,29340,3446,4103,72676,72219,420,10.4,291,7.2,10224,3028,7196,4.2,14.2,9310,1728,7582,2.4,12.9,914,1.3,25.8,0,222,222,1157
2004,29340,3487,4122,72788,72452,403,9.8,345,8.4,9566,2967,6599,4.1,13.2,8894,2267,6627,3.1,12.3,672,0.9,24.6,0,208,209,1129
2005,29340,3463,4129,73297,73025,391,9.5,329,8,10222,2812,7410,3.9,14,9678,3192,6486,4.4,13.3,544,0.7,26.6,0,231,231,2335
2006,29340,3380,4059,73884,73293,396,9.7,423,10.4,13231,3327,9904,4.5,18.1,12049,3926,8123,5.4,16.4,1182,1.7,32.8,0,255,255,2007
2007,29340,3501,4201,73311,73420,432,10.5,295,7.2,9627,2650,6977,3.6,13.1,9844,2303,7541,3.1,13.4,-217,-0.3,26.2,0,180,181,925
2008,29340,3491,4202,73930,73303,371,8.9,330,7.9,9605,2858,6747,3.9,13.1,8350,2396,5954,3.3,11.4,1255,1.7,22.8,0,244,244,1340
2009,29340,3460,4163,72365,73046,287,6.9,298,7.1,7623,1724,5899,2.4,10.4,8984,2207,6777,3,12.3,-1361,-1.9,20.8,0,201,201,1317
2010,29340,3419,4108,69422,70719,305,7.4,324,7.9,7290,2450,4840,3.5,10.3,9883,2788,7095,3.9,14,-2593,-3.7,20.6,0,225,225,1352
2011,29340,3359,4055,70422,69855,315,7.7,347,8.5,7968,2750,5218,3.9,11.4,6834,1776,5058,2.5,9.8,1134,1.6,19.6,0,230,230,1000
2012,29340,3371,4062,70827,70476,332,8.2,319,7.9,8605,2047,6558,2.9,12.2,7902,2249,5653,3.2,11.2,703,1,22.4,0,192,195,1229
2013,29340,3533,4218,71462,71293,396,9.6,257,6.2,10498,4769,5729,6.7,14.7,10159,2195,7964,3.1,14.2,339,0.5,28.4,0,162,162,917
2014,29340,3522,4225,72720,71847,326,7.8,288,6.8,8537,2771,5766,3.9,11.9,6791,1641,5150,2.3,9.5,1746,2.4,19,0,208,208,1120
1977,29420,921,978,7927,7840,241,25.9,140,15.1,1837,966,871,12.3,23.4,1663,634,1029,8.1,21.2,174,2.2,42.4,0,114,114,570
1978,29420,911,964,9404,8627,217,22.3,219,22.6,2938,1240,1698,14.4,34.1,1384,883,501,10.2,16,1554,18.1,32,0,126,131,541
1979,29420,1065,1119,11447,10431,260,25,111,10.7,3565,1812,1753,17.4,34.2,1532,574,958,5.5,14.7,2033,19.5,29.4,1,2,2,
1980,29420,1152,1209,12701,12048,275,23.6,174,15,3775,1569,2206,13,31.3,2469,1216,1253,10.1,20.5,1306,10.8,41,0,130,130,791
1981,29420,1109,1170,12089,12348,212,17.9,231,19.5,2789,1432,1357,11.6,22.6,3307,1237,2070,10,26.8,-518,-4.2,45.2,0,160,161,741
1982,29420,1169,1255,11162,11631,288,23.7,195,16,2702,1691,1011,14.5,23.2,3639,1384,2255,11.9,31.3,-937,-8.1,46.4,0,118,118,686
1983,29420,1200,1284,11164,11199,233,18.4,205,16.1,2285,1300,985,11.6,20.4,2354,1033,1321,9.2,21,-69,-0.6,40.8,0,132,132,646
1984,29420,1303,1391,12476,12128,285,21.3,176,13.2,2985,1362,1623,11.2,24.6,2288,834,1454,6.9,18.9,697,5.7,37.8,0,123,124,621
1985,29420,1376,1472,14295,13445,280,19.6,198,13.8,3863,1644,2219,12.2,28.7,2163,1045,1118,7.8,16.1,1700,12.6,32.2,0,143,143,738
1986,29420,1477,1573,15643,14916,333,21.9,214,14.1,4279,2410,1869,16.2,28.7,2825,1047,1778,7,18.9,1454,9.8,37.8,0,143,143,705
1987,29420,1636,1750,16613,16209,388,23.3,215,12.9,4611,2504,2107,15.4,28.4,3803,1638,2165,10.1,23.5,808,4.9,47,0,153,153,894
1988,29420,1708,1830,18720,17616,319,17.8,218,12.2,5446,2151,3295,12.2,30.9,3238,1417,1821,8,18.4,2208,12.5,36.8,0,163,163,867
1989,29420,1810,1947,20134,19460,375,19.9,255,13.5,5070,2599,2471,13.4,26.1,3721,1301,2420,6.7,19.1,1349,7,38.2,0,187,187,1038
1990,29420,2004,2148,22940,21512,460,22.5,244,11.9,6833,3428,3405,15.9,31.8,3976,1578,2398,7.3,18.5,2857,13.3,37,0,176,177,1047
1991,29420,2208,2386,23875,23403,486,21.4,241,10.6,5835,2949,2886,12.6,24.9,4890,1627,3263,7,20.9,945,4,41.8,0,171,171,1026
1992,29420,2238,2426,23521,23692,398,16.5,338,14,5846,2613,3233,11,24.7,6187,2190,3997,9.2,26.1,-341,-1.4,49.4,0,243,243,1387
1993,29420,2297,2492,24870,24133,409,16.6,321,13.1,5618,2323,3295,9.6,23.3,4143,1741,2402,7.2,17.2,1475,6.1,34.4,0,241,242,1105
1994,29420,2359,2569,26428,25648,418,16.5,336,13.3,6154,2890,3264,11.3,24,4594,1900,2694,7.4,17.9,1560,6.1,35.8,0,263,263,1314
1995,29420,2370,2585,27902,27119,389,15.1,354,13.7,5694,2229,3465,8.2,21,4128,1648,2480,6.1,15.2,1566,5.8,30.4,0,270,270,1069
1996,29420,2450,2674,28425,28178,414,15.7,309,11.8,5460,2359,3101,8.4,19.4,4965,1669,3296,5.9,17.6,495,1.8,35.2,0,210,210,920
1997,29420,2515,2753,29185,28822,455,16.8,369,13.6,6215,2831,3384,9.8,21.6,5489,1915,3574,6.6,19,726,2.6,38,0,257,257,1155
1998,29420,2516,2758,29941,29546,385,14,368,13.4,6294,2728,3566,9.2,21.3,5504,2289,3215,7.7,18.6,790,2.7,37.2,0,257,257,1476
1999,29420,2570,2829,35888,33252,429,15.3,367,13.1,9480,5663,3817,17,28.5,4207,2025,2182,6.1,12.7,5273,15.8,25.4,0,252,252,1209
2000,29420,2678,2960,37066,36193,452,15.6,327,11.3,7473,3112,4361,8.6,20.6,5726,2150,3576,5.9,15.8,1747,4.8,31.6,0,204,204,1057
2001,29420,2768,3064,38107,37629,432,14.3,359,11.9,7514,3738,3776,9.9,20,6557,2473,4084,6.6,17.4,957,2.6,34.8,0,233,233,1278
2002,29420,2848,3152,37978,37961,491,15.9,379,12.2,7705,3488,4217,9.2,20.3,7670,2421,5249,6.4,20.2,35,0.1,40.4,0,234,236,1370
2003,29420,2968,3282,39259,38460,517,16.1,338,10.5,8520,3565,4955,9.3,22.2,6922,3718,3204,9.7,18,1598,4.2,36,0,247,247,1270
2004,29420,3086,3417,41817,40405,513,15.4,343,10.3,8658,3138,5520,7.8,21.4,5833,2361,3472,5.8,14.4,2825,7,28.8,0,230,230,1212
2005,29420,3335,3702,46705,44162,612,17.2,308,8.7,10812,5228,5584,11.8,24.5,5725,1600,4125,3.6,13,5087,11.5,26,0,236,236,1225
2006,29420,3478,3889,50218,48346,590,15.6,365,9.6,10137,4148,5989,8.6,21,6393,2278,4115,4.7,13.2,3744,7.8,26.4,0,271,271,1665
2007,29420,3472,3920,48015,48559,547,14,508,13,8887,4402,4485,9.1,18.3,9974,3328,6646,6.9,20.5,-1087,-2.2,36.6,0,347,347,2424
2008,29420,3300,3761,44414,45798,451,11.8,569,14.9,6385,3095,3290,6.8,13.9,9153,2710,6443,5.9,20,-2768,-6.1,27.8,0,450,450,1937
2009,29420,3017,3468,41751,42943,328,9.1,566,15.7,6163,1932,4231,4.5,14.4,8547,2788,5759,6.5,19.9,-2384,-5.5,28.8,0,423,424,2094
2010,29420,2858,3312,39182,40137,316,9.4,434,12.9,5323,1781,3542,4.4,13.3,7233,2006,5227,5,18,-1910,-4.7,26.6,0,331,331,1299
2011,29420,2771,3230,39907,39443,331,10.1,395,12.1,5594,2732,2862,6.9,14.2,4665,1627,3038,4.1,11.8,929,2.4,23.6,0,272,275,1095
2012,29420,2751,3215,39140,39552,317,9.9,359,11.2,5219,1787,3432,4.5,13.2,6042,3106,2936,7.9,15.3,-823,-2.1,26.4,0,232,233,1852
2013,29420,2776,3232,39219,39101,305,9.5,292,9.1,5133,1612,3521,4.1,13.1,4896,2125,2771,5.4,12.5,237,0.6,25,0,193,193,1625
2014,29420,2795,3250,39888,39458,326,10.1,291,9,5010,1683,3327,4.3,12.7,4149,1697,2452,4.3,10.5,861,2.2,21,0,219,219,1078
1977,29460,4934,5668,110866,94978,1066,19.3,781,14.1,47084,39862,7222,42,49.6,15307,6856,8451,7.2,16.1,31777,33.5,32.2,0,540,542,4198
1978,29460,5143,5883,90330,100473,956,16.6,741,12.8,19780,6575,13205,6.5,19.7,40066,4318,35748,4.3,39.9,-20286,-20.2,39.4,0,520,521,2691
1979,29460,5270,6043,96726,93395,954,16,745,12.5,18131,5993,12138,6.4,19.4,11468,4779,6689,5.1,12.3,6663,7.1,24.6,0,531,533,2947
1980,29460,5454,6277,103717,100775,984,16,731,11.9,19559,7891,11668,7.8,19.4,13674,4653,9021,4.6,13.6,5885,5.8,27.2,0,529,532,2576
1981,29460,5444,6269,108781,106119,888,14.2,853,13.6,22222,7418,14804,7,20.9,16898,6295,10603,5.9,15.9,5324,5,31.8,0,579,579,2867
1982,29460,5555,6452,105046,106984,1036,16.3,797,12.5,19202,9219,9983,8.6,17.9,23077,7604,15473,7.1,21.6,-3875,-3.7,35.8,0,470,471,2906
1983,29460,5633,6535,96546,100735,886,13.7,837,12.9,15058,5706,9352,5.7,14.9,23436,5846,17590,5.8,23.3,-8378,-8.4,29.8,0,514,516,2607
1984,29460,5953,6873,105307,100777,1067,15.9,736,11,22475,8147,14328,8.1,22.3,13414,5616,7798,5.6,13.3,9061,9,26.6,0,498,501,2605
1985,29460,6224,7175,112786,109093,1123,16,820,11.7,22485,8948,13537,8.2,20.6,15099,5866,9233,5.4,13.8,7386,6.8,27.6,0,532,535,2638
1986,29460,6421,7417,114719,113654,1172,16.1,896,12.3,20697,9157,11540,8.1,18.2,18566,7012,11554,6.2,16.3,2131,1.9,32.6,0,627,627,3243
1987,29460,6610,7699,118932,116940,1264,16.7,949,12.5,23342,10071,13271,8.6,20,19357,7889,11468,6.7,16.6,3985,3.4,33.2,0,621,625,3324
1988,29460,6680,7838,127383,122708,1095,14.1,951,12.2,26448,11303,15145,9.2,21.6,17099,6475,10624,5.3,13.9,9349,7.7,27.8,0,688,688,3334
1989,29460,6657,7863,129591,128930,981,12.5,970,12.4,22527,8110,14417,6.3,17.5,21204,7788,13416,6,16.4,1323,1.1,32.8,0,681,683,5013
1990,29460,6722,8005,129819,129480,1035,13.1,826,10.4,21899,8806,13093,6.8,16.9,21221,6722,14499,5.2,16.4,678,0.5,32.8,0,576,577,3581
1991,29460,6868,8145,128110,128646,1092,13.5,934,11.6,21602,8579,13023,6.7,16.8,22674,7976,14698,6.2,17.6,-1072,-0.8,33.6,0,557,563,4177
1992,29460,6928,8190,129263,128819,1059,13,974,11.9,20637,7763,12874,6,16,19748,7495,12253,5.8,15.3,889,0.7,30.6,0,629,638,3882
1993,29460,7004,8201,130860,130042,1018,12.4,976,11.9,23822,9224,14598,7.1,18.3,22187,7977,14210,6.1,17.1,1635,1.2,34.2,0,665,667,4124
1994,29460,7122,8329,135140,132887,1050,12.7,893,10.8,23107,8344,14763,6.3,17.4,18600,6042,12558,4.5,14,4507,3.4,28,0,640,650,3631
1995,29460,7195,8400,147420,141347,1008,12.1,909,10.9,30666,14336,16330,10.1,21.7,18520,6816,11704,4.8,13.1,12146,8.6,26.2,0,654,658,3968
1996,29460,7229,8466,145551,146423,1039,12.3,923,10.9,21690,8556,13134,5.8,14.8,23434,8451,14983,5.8,16,-1744,-1.2,29.6,0,626,626,3409
1997,29460,7317,8598,146030,145914,1099,12.9,993,11.6,25557,10090,15467,6.9,17.5,25325,8568,16757,5.9,17.4,232,0.1,34.8,0,627,627,3984
1998,29460,7366,8617,142813,143797,1006,11.7,964,11.2,23371,7365,16006,5.1,16.3,25338,9861,15477,6.9,17.6,-1967,-1.3,32.6,0,614,614,3293
1999,29460,7314,8595,149357,145879,992,11.5,993,11.5,27243,8065,19178,5.5,18.7,20287,7735,12552,5.3,13.9,6956,4.8,27.8,0,655,655,3477
2000,29460,7295,8602,158981,155287,1022,11.9,1027,11.9,30853,10465,20388,6.7,19.9,23464,9119,14345,5.9,15.1,7389,4.8,30.2,0,634,634,3703
2001,29460,7265,8655,165176,162905,1043,12.1,1085,12.5,31659,13817,17842,8.5,19.4,27116,9523,17593,5.8,16.6,4543,2.8,33.2,0,642,642,3624
2002,29460,7261,8636,164903,164120,1171,13.6,1177,13.6,29150,10317,18833,6.3,17.8,27583,11798,15785,7.2,16.8,1567,1,33.6,0,637,639,3284
2003,29460,7461,8776,169855,166425,1158,13.4,859,9.9,29647,11882,17765,7.1,17.8,22787,6791,15996,4.1,13.7,6860,4.1,27.4,0,583,585,2859
2004,29460,7892,9255,168198,168439,1462,16.3,894,9.9,27497,10762,16735,6.4,16.3,27978,8020,19958,4.8,16.6,-481,-0.3,32.6,0,621,627,3440
2005,29460,8405,9858,179842,176233,1592,16.7,906,9.5,30901,13840,17061,7.9,17.5,23682,11512,12170,6.5,13.4,7219,4.1,26.8,0,642,642,4664
2006,29460,8794,10320,187357,182583,1587,15.8,1018,10.1,31494,11918,19576,6.5,17.2,21946,6860,15086,3.8,12,9548,5.2,24,0,724,724,3743
2007,29460,8909,10493,181485,183893,1443,13.9,1253,12.1,31533,15670,15863,8.5,17.1,36349,8614,27735,4.7,19.8,-4816,-2.7,34.2,0,874,877,4020
2008,29460,8611,10193,181503,181138,1099,10.7,1254,12.2,26470,10097,16373,5.6,14.6,25739,7475,18264,4.1,14.2,731,0.4,28.4,0,957,962,4902
2009,29460,8205,9807,166772,173381,987,9.9,1275,12.8,18398,8586,9812,5,10.6,31616,10343,21273,6,18.2,-13218,-7.6,21.2,0,921,921,4067
2010,29460,8112,9705,163138,164434,1020,10.5,1044,10.7,20617,8913,11704,5.4,12.5,23208,6039,17169,3.7,14.1,-2591,-1.6,25,0,722,722,3074
2011,29460,8045,9620,162564,163298,1022,10.6,1039,10.8,17455,6831,10624,4.2,10.7,18923,7844,11079,4.8,11.6,-1468,-0.9,21.4,0,735,739,4890
2012,29460,8078,9687,165815,164094,997,10.3,931,9.7,21859,7609,14250,4.6,13.3,18416,5569,12847,3.4,11.2,3443,2.1,22.4,0,614,615,2643
2013,29460,8142,9782,173780,169603,924,9.5,835,8.6,24045,9131,14914,5.4,14.2,15691,4882,10809,2.9,9.3,8354,4.9,18.6,0,552,553,3269
2014,29460,8215,9873,175382,173549,1097,11.2,941,9.6,22973,6822,16151,3.9,13.2,19306,7212,12094,4.2,11.1,3667,2.1,22.2,0,684,688,4161
1977,29540,6156,6808,121790,119741,935,14,696,10.4,18508,6890,11618,5.8,15.5,14410,5876,8534,4.9,12,4098,3.5,24,0,471,474,3523
1978,29540,6342,7010,131862,126828,861,12.5,662,9.6,20857,6789,14068,5.4,16.4,10788,4207,6581,3.3,8.5,10069,7.9,17,0,469,471,2205
1979,29540,6431,7126,139141,135440,827,11.7,683,9.7,20016,5142,14874,3.8,14.8,12614,4590,8024,3.4,9.3,7402,5.5,18.6,0,476,476,2452
1980,29540,6441,7131,141266,140149,747,10.5,708,9.9,19150,5300,13850,3.8,13.7,16915,6468,10447,4.6,12.1,2235,1.6,24.2,0,511,513,3181
1981,29540,6195,6907,140258,140578,674,9.6,820,11.7,16884,7224,9660,5.1,12,17523,5707,11816,4.1,12.5,-639,-0.5,24,0,529,536,2946
1982,29540,6179,6980,141045,140552,846,12.2,668,9.6,19695,7076,12619,5,14,18708,5910,12798,4.2,13.3,987,0.7,26.6,0,397,397,1840
1983,29540,6350,7172,138808,139954,695,9.8,575,8.1,17275,6182,11093,4.4,12.3,19567,5849,13718,4.2,14,-2292,-1.7,24.6,0,376,376,2600
1984,29540,6593,7403,156038,147374,871,12,656,9,33646,6266,27380,4.3,22.8,16318,6617,9701,4.5,11.1,17328,11.7,22.2,0,413,413,3446
1985,29540,6725,7522,149496,152812,857,11.5,738,9.9,20206,5913,14293,3.9,13.2,26837,5216,21621,3.4,17.6,-6631,-4.4,26.4,0,458,459,2330
1986,29540,7071,7904,156384,152846,1018,13.2,604,7.8,24016,8414,15602,5.5,15.7,16939,5304,11635,3.5,11.1,7077,4.6,22.2,0,422,422,3414
1987,29540,7335,8299,162302,159282,1138,14,726,8.9,25446,9679,15767,6.1,16,19406,8380,11026,5.3,12.2,6040,3.8,24.4,0,493,497,3325
1988,29540,7575,8569,170293,166058,1060,12.6,779,9.2,28520,9516,19004,5.7,17.2,20049,6290,13759,3.8,12.1,8471,5.1,24.2,0,490,490,2805
1989,29540,7752,8791,180390,175781,1033,11.9,806,9.3,27951,8081,19870,4.6,15.9,18733,7712,11021,4.4,10.7,9218,5.2,21.4,0,563,567,6013
1990,29540,7978,9037,182728,181569,1026,11.5,746,8.4,23220,7890,15330,4.3,12.8,20902,5938,14964,3.3,11.5,2318,1.3,23,0,510,515,3457
1991,29540,8096,9221,175809,179167,976,10.7,781,8.6,20889,8601,12288,4.8,11.7,27604,9806,17798,5.5,15.4,-6715,-3.7,23.4,0,518,520,3243
1992,29540,8124,9321,177590,176704,935,10.1,816,8.8,22719,7230,15489,4.1,12.9,20946,5028,15918,2.8,11.9,1773,1,23.8,0,578,580,3400
1993,29540,8139,9337,178710,178244,835,9,794,8.5,21199,6440,14759,3.6,11.9,20267,6332,13935,3.6,11.4,932,0.5,22.8,0,551,552,3639
1994,29540,8193,9419,181143,179707,844,9,715,7.6,22703,6573,16130,3.7,12.6,19830,5794,14036,3.2,11,2873,1.6,22,0,490,497,2639
1995,29540,8394,9642,186397,183723,923,9.7,672,7.1,23653,7622,16031,4.1,12.9,18305,4304,14001,2.3,10,5348,2.9,20,0,482,482,2458
1996,29540,8470,9767,185154,185975,899,9.3,769,7.9,20879,7567,13312,4.1,11.2,22521,7442,15079,4,12.1,-1642,-0.9,22.4,0,530,530,4005
1997,29540,8622,9954,190082,187685,1057,10.7,890,9,25697,7718,17979,4.1,13.7,20902,7263,13639,3.9,11.1,4795,2.6,22.2,0,563,563,3964
1998,29540,8756,10140,198155,193911,963,9.6,761,7.6,28082,10086,17996,5.2,14.5,19593,7202,12391,3.7,10.1,8489,4.4,20.2,0,503,503,3490
1999,29540,8835,10193,202002,200039,924,9.1,855,8.4,26198,9533,16665,4.8,13.1,22272,7276,14996,3.6,11.1,3926,2,22.2,0,540,540,3215
2000,29540,8877,10256,203477,202769,902,8.8,840,8.2,26310,9339,16971,4.6,13,24893,8168,16725,4,12.3,1417,0.7,24.6,0,526,526,3606
2001,29540,9089,10563,211820,208844,1034,9.9,826,7.9,30616,14040,16576,6.7,14.7,24664,6831,17833,3.3,11.8,5952,2.9,23.6,0,492,492,3515
2002,29540,9145,10608,211145,210923,1088,10.3,1018,9.6,27726,10728,16998,5.1,13.1,27281,9547,17734,4.5,12.9,445,0.2,25.8,0,542,542,3596
2003,29540,9207,10697,212791,211690,1017,9.6,782,7.4,26290,8262,18028,3.9,12.4,24087,5978,18109,2.8,11.4,2203,1,22.8,0,516,516,2658
2004,29540,9300,10794,216425,214066,972,9.1,785,7.3,28047,7887,20160,3.7,13.1,23329,6631,16698,3.1,10.9,4718,2.2,21.8,0,551,551,3924
2005,29540,9417,10971,216748,216051,1005,9.2,787,7.2,24694,7471,17223,3.5,11.4,23299,6916,16383,3.2,10.8,1395,0.6,21.6,0,556,559,4379
2006,29540,9462,11064,218523,217027,1048,9.5,878,8,25109,8223,16886,3.8,11.6,22117,6641,15476,3.1,10.2,2992,1.4,20.4,0,605,612,4453
2007,29540,9588,11243,220264,218995,1080,9.7,878,7.9,28893,8640,20253,3.9,13.2,26354,7276,19078,3.3,12,2539,1.2,24,0,548,550,3548
2008,29540,9629,11317,219813,219320,923,8.2,759,6.8,24099,6802,17297,3.1,11,23112,6333,16779,2.9,10.5,987,0.5,21,0,554,556,4205
2009,29540,9467,11156,211784,215065,778,6.9,866,7.7,20108,6590,13518,3.1,9.3,26669,6855,19814,3.2,12.4,-6561,-3.1,18.6,0,577,578,3472
2010,29540,9387,11121,209459,210245,778,7,744,6.7,21301,6693,14608,3.2,10.1,22873,5291,17582,2.5,10.9,-1572,-0.8,20.2,0,462,463,2556
2011,29540,9361,11123,212818,210903,809,7.3,726,6.5,22706,5434,17272,2.6,10.8,18876,4345,14531,2.1,9,3830,1.8,18,0,481,481,2787
2012,29540,9512,11267,211652,212001,892,8,766,6.9,22451,6568,15883,3.1,10.6,23148,7906,15242,3.7,10.9,-697,-0.3,21.2,0,463,463,3110
2013,29540,9594,11358,210931,211112,793,7,691,6.1,19771,4468,15303,2.1,9.4,20132,5010,15122,2.4,9.5,-361,-0.1,18.8,0,453,457,3511
2014,29540,9697,11453,217714,214064,893,7.9,726,6.4,25717,8006,17711,3.7,12,18417,4747,13670,2.2,8.6,7300,3.4,17.2,0,504,510,3270
1977,29620,5361,6169,108261,104670,968,16,750,12.4,20396,7677,12719,7.3,19.5,13213,5708,7505,5.5,12.6,7183,6.9,25.2,0,454,454,3235
1978,29620,5549,6307,116917,112575,862,13.8,724,11.6,20916,6909,14007,6.1,18.6,12231,5374,6857,4.8,10.9,8685,7.7,21.8,0,439,440,2613
1979,29620,5682,6502,128887,122788,917,14.3,683,10.7,24513,8953,15560,7.3,20,12315,4847,7468,3.9,10,12198,10,20,0,449,451,2592
1980,29620,5748,6601,124439,126613,822,12.5,709,10.8,14374,5545,8829,4.4,11.4,18722,4509,14213,3.6,14.8,-4348,-3.4,22.8,0,495,496,2768
1981,29620,5645,6445,120441,122327,744,11.4,874,13.4,15453,6788,8665,5.5,12.6,19224,6644,12580,5.4,15.7,-3771,-3.1,25.2,0,464,465,3015
1982,29620,5656,6578,121080,120675,944,14.5,749,11.5,17938,9061,8877,7.5,14.9,17127,5468,11659,4.5,14.2,811,0.7,28.4,0,410,410,2438
1983,29620,5856,6777,121332,121139,764,11.4,621,9.3,14795,5213,9582,4.3,12.2,14408,4870,9538,4,11.9,387,0.3,23.8,0,352,353,1934
1984,29620,6082,6996,130439,126009,878,12.8,672,9.8,19823,5599,14224,4.4,15.7,10962,4806,6156,3.8,8.7,8861,7,17.4,0,390,400,1948
1985,29620,6322,7248,135395,133169,886,12.4,636,8.9,42680,32056,10624,24.1,32,38227,29873,8354,22.4,28.7,4453,3.3,57.4,0,381,381,3007
1986,29620,6519,7487,142682,138951,1000,13.6,738,10,24060,8039,16021,5.8,17.3,16597,6537,10060,4.7,11.9,7463,5.4,23.8,0,478,478,3652
1987,29620,6682,7734,146788,145409,1043,13.7,772,10.1,23944,9797,14147,6.7,16.5,21186,7066,14120,4.9,14.6,2758,1.9,29.2,0,487,488,3677
1988,29620,6750,7840,143771,143493,942,12.1,793,10.2,22220,8449,13771,5.9,15.5,21663,6692,14971,4.7,15.1,557,0.4,30.2,0,505,505,2786
1989,29620,6872,8042,142894,143293,930,11.7,738,9.3,20857,7898,12959,5.5,14.6,21655,6066,15589,4.2,15.1,-798,-0.5,29.2,0,469,469,3042
1990,29620,6985,8173,146904,144156,873,10.8,700,8.6,22997,7014,15983,4.9,16,17500,5715,11785,4,12.1,5497,3.9,24.2,0,467,467,3162
1991,29620,7154,8402,147479,147232,939,11.3,721,8.7,19213,7340,11873,5,13,18718,5684,13034,3.9,12.7,495,0.3,25.4,0,456,462,3521
1992,29620,7263,8555,148114,147760,950,11.2,763,9,20253,6655,13598,4.5,13.7,19545,6433,13112,4.4,13.2,708,0.5,26.4,0,446,448,3310
1993,29620,7373,8639,152556,150510,832,9.7,715,8.3,24058,8405,15653,5.6,16,19965,4545,15420,3,13.3,4093,2.7,26.6,0,450,450,2302
1994,29620,7450,8693,150770,151575,885,10.2,805,9.3,18380,6309,12071,4.2,12.1,19989,7513,12476,5,13.2,-1609,-1.1,24.2,0,506,514,2813
1995,29620,7666,8923,158648,154665,954,10.8,705,8,22783,7474,15309,4.8,14.7,14817,4692,10125,3,9.6,7966,5.1,19.2,0,475,477,2072
1996,29620,7842,9133,161405,160166,955,10.6,728,8.1,21792,7963,13829,5,13.6,19314,4671,14643,2.9,12.1,2478,1.5,24.2,0,484,484,2422
1997,29620,7986,9259,165417,163327,1028,11.2,897,9.7,26549,8223,18326,5,16.3,22368,8157,14211,5,13.7,4181,2.6,27.4,0,534,534,3672
1998,29620,8005,9300,168599,166870,931,10,855,9.2,23845,9331,14514,5.6,14.3,20387,5703,14684,3.4,12.2,3458,2.1,24.4,0,536,536,2819
1999,29620,7931,9264,172181,170379,846,9.1,881,9.5,26060,7770,18290,4.6,15.3,22456,6103,16353,3.6,13.2,3604,2.1,26.4,0,563,563,3431
2000,29620,7954,9287,176607,174379,907,9.8,890,9.6,34016,16497,17519,9.5,19.5,29559,17937,11622,10.3,17,4457,2.5,34,0,527,527,4227
2001,29620,7923,9318,171163,173573,950,10.2,995,10.7,22253,8997,13256,5.2,12.8,27072,9598,17474,5.5,15.6,-4819,-2.8,25.6,0,584,584,4710
2002,29620,7894,9300,174020,172499,1085,11.7,1084,11.7,30468,12864,17604,7.5,17.7,27426,10255,17171,5.9,15.9,3042,1.8,31.8,0,539,540,3405
2003,29620,7870,9353,171840,170320,966,10.4,763,8.2,25667,9180,16487,5.4,15.1,22626,6677,15949,3.9,13.3,3041,1.8,26.6,0,512,515,3682
2004,29620,7875,9326,169463,169946,928,10,873,9.4,23244,7401,15843,4.4,13.7,24209,8206,16003,4.8,14.2,-965,-0.5,27.4,0,504,504,3136
2005,29620,7884,9348,166366,167173,923,9.9,808,8.7,22452,8436,14016,5,13.4,24065,6906,17159,4.1,14.4,-1613,-1,26.8,0,526,529,3789
2006,29620,7793,9291,163710,162402,904,9.7,864,9.3,22059,8270,13789,5.1,13.6,19443,6095,13348,3.8,12,2616,1.6,24,0,570,570,3795
2007,29620,7791,9340,163437,162446,929,10,840,9,24929,8750,16179,5.4,15.3,22946,6799,16147,4.2,14.1,1983,1.2,28.2,0,539,546,2670
2008,29620,7613,9148,161399,161736,751,8.2,856,9.3,19593,6025,13568,3.7,12.1,20266,6488,13778,4,12.5,-673,-0.4,24.2,0,588,589,3926
2009,29620,7408,8854,149688,155063,683,7.6,868,9.7,16089,6269,9820,4,10.4,26839,5754,21085,3.7,17.3,-10750,-6.9,20.8,0,586,587,3793
2010,29620,7199,8601,149062,149104,599,6.9,800,9.2,18842,4578,14264,3.1,12.6,18926,5503,13423,3.7,12.7,-84,-0.1,25.2,0,505,505,3054
2011,29620,7107,8527,150885,149502,711,8.3,717,8.4,17469,5490,11979,3.7,11.7,14703,4531,10172,3,9.8,2766,1.9,19.6,0,456,457,2888
2012,29620,7189,8601,152520,151721,778,9.1,718,8.4,19350,6347,13003,4.2,12.8,17751,6136,11615,4,11.7,1599,1.1,23.4,0,414,429,3099
2013,29620,7208,8602,155644,153743,649,7.6,647,7.5,17636,5170,12466,3.4,11.5,13833,3266,10567,2.1,9,3803,2.5,18,0,397,398,2224
2014,29620,7174,8581,159653,157329,658,7.7,627,7.3,16998,5331,11667,3.4,10.8,12350,3486,8864,2.2,7.8,4648,3,15.6,0,426,426,1928
1977,29700,1491,1638,17536,17375,344,22.1,175,11.3,3957,2288,1669,13.2,22.8,3635,1377,2258,7.9,20.9,322,1.9,41.8,0,133,133,1169
1978,29700,1442,1592,19988,18721,243,15,262,16.2,5155,1877,3278,10,27.5,2620,1571,1049,8.4,14,2535,13.5,28,0,144,152,780
1979,29700,1572,1755,21348,20687,283,16.9,129,7.7,5032,2491,2541,12,24.3,3710,1240,2470,6,17.9,1322,6.4,35.8,0,,,
1980,29700,1267,1462,21678,21038,69,4.3,223,13.9,4271,1342,2929,6.4,20.3,2991,1352,1639,6.4,14.2,1280,6.1,28.4,0,180,180,1105
1981,29700,1703,1904,26705,24952,362,21.5,161,9.6,6178,2808,3370,11.3,24.8,2671,1003,1668,4,10.7,3507,14.1,21.4,0,75,77,394
1982,29700,1828,2071,27745,27251,392,19.7,203,10.2,5774,2758,3016,10.1,21.2,4785,1868,2917,6.9,17.6,989,3.6,35.2,0,118,118,629
1983,29700,1779,2005,21592,24406,245,12,306,15,3363,2032,1331,8.3,13.8,8991,2291,6700,9.4,36.8,-5628,-23,27.6,0,209,211,1353
1984,29700,1728,1940,22392,21974,241,12.2,297,15.1,4667,2053,2614,9.3,21.2,3831,1587,2244,7.2,17.4,836,3.8,34.8,0,193,193,1106
1985,29700,1779,2007,25583,23979,265,13.4,197,10,6057,1667,4390,7,25.3,2848,1356,1492,5.7,11.9,3209,13.4,23.8,0,130,130,799
1986,29700,1845,2075,27885,26721,308,15.1,223,10.9,5945,2307,3638,8.6,22.2,3616,1438,2178,5.4,13.5,2329,8.7,27,0,140,140,697
1987,29700,1863,2098,26258,27068,344,16.5,301,14.4,4450,2112,2338,7.8,16.4,6069,2793,3276,10.3,22.4,-1619,-6,32.8,0,174,174,1540
1988,29700,1926,2144,27525,26755,321,15.1,271,12.8,6561,2737,3824,10.2,24.5,5021,1989,3032,7.4,18.8,1540,5.7,37.6,0,153,153,930
1989,29700,2062,2292,30765,29209,361,16.3,217,9.8,7127,2196,4931,7.5,24.4,4015,1346,2669,4.6,13.7,3112,10.7,27.4,0,141,141,746
1990,29700,2221,2461,33258,31959,401,16.9,215,9.1,6612,2206,4406,6.9,20.7,4014,1258,2756,3.9,12.6,2598,8.1,25.2,0,146,146,743
1991,29700,2440,2696,36562,34916,462,17.9,231,9,8291,4282,4009,12.3,23.7,4999,1722,3277,4.9,14.3,3292,9.4,28.6,0,161,162,1161
1992,29700,2631,2920,37357,36959,543,19.3,315,11.2,7994,3969,4025,10.7,21.6,7198,4266,2932,11.5,19.5,796,2.1,39,0,219,219,2337
1993,29700,2822,3123,40862,39078,541,17.9,322,10.7,9134,3940,5194,10.1,23.4,5566,1729,3837,4.4,14.2,3568,9.2,28.4,0,238,238,1152
1994,29700,2967,3290,42990,41879,548,17.1,370,11.5,8425,3448,4977,8.2,20.1,6202,2069,4133,4.9,14.8,2223,5.3,29.6,0,277,277,1390
1995,29700,3023,3348,41446,42147,506,15.2,424,12.8,6837,3495,3342,8.3,16.2,8238,2804,5434,6.7,19.5,-1401,-3.3,32.4,0,315,321,1849
1996,29700,2954,3294,39782,40564,459,13.8,491,14.8,6373,2859,3514,7,15.7,7936,2692,5244,6.6,19.6,-1563,-3.9,31.4,0,350,350,1650
1997,29700,3022,3362,43167,41567,500,15,446,13.4,9612,4375,5237,10.5,23.1,6412,2544,3868,6.1,15.4,3200,7.7,30.8,0,299,299,1201
1998,29700,3152,3482,46985,45082,488,14.3,376,11,10037,3811,6226,8.5,22.3,6231,2355,3876,5.2,13.8,3806,8.5,27.6,0,247,247,1376
1999,29700,3218,3579,47657,47304,508,14.4,404,11.4,9311,4417,4894,9.3,19.7,8604,3455,5149,7.3,18.2,707,1.5,36.4,0,290,290,1663
2000,29700,3231,3600,51459,49539,438,12.2,410,11.4,10526,3751,6775,7.6,21.2,6685,2121,4564,4.3,13.5,3841,7.7,27,0,283,283,1220
2001,29700,3348,3745,53530,52596,520,14.1,417,11.3,10848,5525,5323,10.5,20.6,8979,4228,4751,8,17.1,1869,3.5,34.2,0,244,244,1419
2002,29700,3395,3813,56756,55148,578,15.3,505,13.4,11763,5372,6391,9.7,21.3,8547,2823,5724,5.1,15.5,3216,5.8,31,0,308,308,1606
2003,29700,3547,3984,59481,57821,582,15,338,8.7,11982,4538,7444,7.8,20.7,8661,2981,5680,5.2,15,3321,5.7,30,0,264,264,1881
2004,29700,3575,4054,61654,60421,513,12.8,413,10.3,10433,4111,6322,6.8,17.3,7966,2356,5610,3.9,13.2,2467,4.1,26.4,0,313,313,1373
2005,29700,3677,4166,62865,62089,566,13.8,403,9.8,11530,5426,6104,8.7,18.6,9978,2533,7445,4.1,16.1,1552,2.5,32.2,0,309,309,1865
2006,29700,3789,4306,65104,63717,572,13.5,400,9.5,11100,4628,6472,7.3,17.4,8326,2495,5831,3.9,13.1,2774,4.3,26.2,0,312,312,1867
2007,29700,3859,4408,67478,66187,567,13,447,10.3,12203,4839,7364,7.3,18.4,9621,2862,6759,4.3,14.5,2582,3.9,29,0,314,315,1721
2008,29700,3923,4489,67264,67285,486,10.9,395,8.9,9268,2593,6675,3.9,13.8,9310,2348,6962,3.5,13.8,-42,0,27.6,0,318,318,1783
2009,29700,3783,4357,63587,65289,373,8.5,452,10.2,7327,2815,4512,4.3,11.2,10730,2732,7998,4.2,16.4,-3403,-5.2,22.4,0,349,349,1724
2010,29700,3711,4302,62393,62861,396,9.2,426,9.9,8197,3076,5121,4.9,13,9133,2771,6362,4.4,14.5,-936,-1.5,26,0,320,323,1814
2011,29700,3763,4366,66188,64157,447,10.3,361,8.3,10585,2793,7792,4.4,16.5,6523,1666,4857,2.6,10.2,4062,6.3,20.4,0,251,253,1027
2012,29700,3927,4554,69558,67909,515,11.5,348,7.8,11811,3847,7964,5.7,17.4,8513,2416,6097,3.6,12.5,3298,4.9,25,0,235,236,1332
2013,29700,4071,4721,71343,70286,511,11.1,350,7.6,9731,3241,6490,4.6,13.8,7617,1726,5891,2.5,10.8,2114,3,21.6,0,256,256,1166
2014,29700,4087,4746,73807,72495,448,9.5,402,8.5,10248,3658,6590,5,14.1,7623,2002,5621,2.8,10.5,2625,3.6,21,0,314,314,1272
1977,29740,1285,1389,15849,15265,294,22.2,169,12.7,4144,2243,1901,14.7,27.1,2975,1450,1525,9.5,19.5,1169,7.6,39,0,113,114,881
1978,29740,1260,1365,15063,15408,242,17.6,242,17.6,4486,1526,2960,9.9,29.1,5176,4241,935,27.5,33.6,-690,-4.5,58.2,0,136,137,3544
1979,29740,1396,1502,16582,15858,256,17.9,128,8.9,3895,1504,2391,9.5,24.6,2447,989,1458,6.2,15.4,1448,9.2,30.8,1,1,1,
1980,29740,1412,1525,15984,16236,259,17.1,221,14.6,3151,1511,1640,9.3,19.4,3654,1428,2226,8.8,22.5,-503,-3.1,38.8,0,151,151,860
1981,29740,1384,1483,15531,15759,221,14.7,249,16.6,3032,1427,1605,9.1,19.2,3487,1506,1981,9.6,22.1,-455,-2.9,38.4,0,142,142,972
1982,29740,1426,1561,17270,16355,296,19.4,194,12.7,4416,2413,2003,14.8,27,2586,1084,1502,6.6,15.8,1830,11.2,31.6,0,119,119,668
1983,29740,1525,1664,18437,17824,287,17.8,199,12.3,5215,2713,2502,15.2,29.3,3989,1841,2148,10.3,22.4,1226,6.9,44.8,0,123,123,882
1984,29740,1617,1763,20429,19584,313,18.3,214,12.5,5120,2164,2956,11,26.1,3429,1244,2185,6.4,17.5,1691,8.6,35,0,144,144,883
1985,29740,1670,1815,21286,20703,297,16.6,238,13.3,4562,2194,2368,10.6,22,3395,1483,1912,7.2,16.4,1167,5.6,32.8,0,146,147,841
1986,29740,1746,1894,21194,21237,304,16.4,216,11.6,4284,2104,2180,9.9,20.2,4369,1401,2968,6.6,20.6,-85,-0.4,40.4,0,143,143,863
1987,29740,1832,1995,23266,22208,352,18.1,243,12.5,6149,2900,3249,13.1,27.7,4032,2043,1989,9.2,18.2,2117,9.5,36.4,0,171,171,1201
1988,29740,1888,2059,24319,23734,346,17.1,271,13.4,5446,2728,2718,11.5,22.9,4276,1672,2604,7,18,1170,4.9,36,0,171,171,960
1989,29740,1981,2170,25405,24879,370,17.5,257,12.2,5379,2684,2695,10.8,21.6,4326,1548,2778,6.2,17.4,1053,4.2,34.8,0,163,163,976
1990,29740,2038,2234,25434,25246,326,14.8,234,10.6,4917,2002,2915,7.9,19.5,4541,1782,2759,7.1,18,376,1.5,36,0,170,170,1144
1991,29740,2099,2330,26403,25930,361,15.8,261,11.4,6018,3496,2522,13.5,23.2,5072,2518,2554,9.7,19.6,946,3.6,39.2,0,167,167,1812
1992,29740,2140,2392,26920,26410,349,14.8,277,11.7,6247,2747,3500,10.4,23.7,5227,2193,3034,8.3,19.8,1020,3.9,39.6,0,169,170,986
1993,29740,2233,2471,27015,26829,314,12.9,232,9.5,4729,1645,3084,6.1,17.6,4357,1649,2708,6.1,16.2,372,1.4,32.4,0,149,149,594
1994,29740,2327,2571,28162,27746,364,14.4,263,10.4,5523,2199,3324,7.9,19.9,4690,1971,2719,7.1,16.9,833,3,33.8,0,184,184,1046
1995,29740,2377,2625,29272,28711,349,13.4,293,11.3,5780,2150,3630,7.5,20.1,4658,2203,2455,7.7,16.2,1122,3.9,32.4,0,189,189,823
1996,29740,2420,2671,30450,29765,367,13.9,308,11.6,5770,2368,3402,8,19.4,4400,1705,2695,5.7,14.8,1370,4.6,29.6,0,229,229,1222
1997,29740,2475,2722,30676,30554,383,14.2,331,12.3,6187,2681,3506,8.8,20.2,5942,1950,3992,6.4,19.4,245,0.8,38.8,0,209,209,996
1998,29740,2502,2775,32451,31551,385,14,325,11.8,7214,3788,3426,12,22.9,5414,2663,2751,8.4,17.2,1800,5.7,34.4,0,206,206,1368
1999,29740,2498,2804,35142,34454,368,13.2,334,12,6884,3255,3629,9.4,20,5507,2085,3422,6.1,16,1377,4,32,0,200,200,1024
2000,29740,2488,2796,36457,35793,358,12.8,364,13,7265,3176,4089,8.9,20.3,5937,2268,3669,6.3,16.6,1328,3.7,33.2,0,217,217,1048
2001,29740,2537,2843,37261,36951,382,13.5,371,13.1,6861,2772,4089,7.5,18.6,6241,2364,3877,6.4,16.9,620,1.7,33.8,0,200,200,1101
2002,29740,2579,2888,39020,38163,402,14,355,12.4,8459,3442,5017,9,22.2,6744,2728,4016,7.1,17.7,1715,4.5,35.4,0,203,203,1130
2003,29740,2591,2893,40969,39653,344,11.9,288,10,8205,3464,4741,8.7,20.7,5572,2038,3534,5.1,14.1,2633,6.6,28.2,0,183,185,1407
2004,29740,2681,2996,42319,41248,381,12.9,255,8.7,8235,3151,5084,7.6,20,6093,2021,4072,4.9,14.8,2142,5.2,29.6,0,170,170,1244
2005,29740,2813,3140,44868,43530,434,14.2,269,8.8,9078,4613,4465,10.6,20.9,6402,2948,3454,6.8,14.7,2676,6.2,29.4,0,181,182,2345
2006,29740,2918,3260,46102,45328,472,14.8,316,9.9,8322,3467,4855,7.6,18.4,6773,3153,3620,7,14.9,1549,3.5,29.8,0,191,192,2468
2007,29740,2985,3365,47269,46627,431,13,336,10.1,8585,3895,4690,8.4,18.4,7300,2002,5298,4.3,15.7,1285,2.7,31.4,0,216,216,1094
2008,29740,3036,3408,48729,47994,384,11.4,339,10,7727,2852,4875,5.9,16.1,6257,2091,4166,4.4,13,1470,3.1,26,0,240,240,1225
2009,29740,2966,3352,49312,48839,314,9.3,340,10.1,8002,3107,4895,6.4,16.4,7055,1931,5124,4,14.4,947,2,28.8,0,241,241,1351
2010,29740,2862,3269,49387,49299,297,9,352,10.7,6917,2879,4038,5.8,14,6740,2319,4421,4.7,13.7,177,0.3,27.4,0,253,253,1383
2011,29740,2856,3277,48808,49056,318,9.7,287,8.8,5977,2189,3788,4.5,12.2,6473,1725,4748,3.5,13.2,-496,-1,24.4,0,201,205,937
2012,29740,2859,3257,48986,48725,322,9.9,345,10.6,7037,2189,4848,4.5,14.4,6515,2437,4078,5,13.4,522,1,26.8,0,211,213,951
2013,29740,2864,3275,48775,48843,291,8.9,273,8.4,5784,2087,3697,4.3,11.8,5920,1485,4435,3,12.1,-136,-0.3,23.6,0,191,191,1122
2014,29740,2824,3243,50479,49468,281,8.7,285,8.8,7762,3008,4754,6.1,15.7,5740,1493,4247,3,11.6,2022,4.1,23.2,0,196,196,779
1977,29820,6419,7255,131617,126447,1580,22.7,977,14,29835,12741,17094,10.1,23.6,19494,7672,11822,6.1,15.4,10341,8.2,30.8,0,714,715,4974
1978,29820,6213,7113,150637,140807,1363,19,1412,19.7,39376,12582,26794,8.9,28,19716,11977,7739,8.5,14,19660,14,28,0,820,822,5802
1979,29820,7300,8338,180974,166150,1799,23.3,633,8.2,48647,19830,28817,11.9,29.3,18999,6336,12663,3.8,11.4,29648,17.9,22.8,0,39,40,356
1980,29820,7758,8865,192931,186851,1763,20.5,1190,13.8,46069,19469,26600,10.4,24.7,33909,14021,19888,7.5,18.1,12160,6.6,36.2,0,845,850,9843
1981,29820,7820,8987,189285,191357,1694,19,1482,16.6,38706,15969,22737,8.3,20.2,42849,18026,24823,9.4,22.4,-4143,-2.2,40.4,0,943,943,6816
1982,29820,8185,9572,194519,192042,1916,20.6,1263,13.6,44858,21682,23176,11.3,23.4,39903,13077,26826,6.8,20.8,4955,2.6,41.6,0,699,699,5892
1983,29820,8357,9739,188692,191660,1533,15.9,1404,14.5,32641,13744,18897,7.2,17,38576,12659,25917,6.6,20.1,-5935,-3.1,34,0,937,941,6080
1984,29820,8879,10349,207813,198150,1831,18.2,1212,12.1,44520,16408,28112,8.3,22.5,25194,8586,16608,4.3,12.7,19326,9.8,25.4,0,817,817,4831
1985,29820,9116,10626,213593,210539,1761,16.8,1478,14.1,41956,17883,24073,8.5,19.9,35847,18305,17542,8.7,17,6109,2.9,34,0,1006,1006,8821
1986,29820,9422,10970,227666,220310,1899,17.6,1505,13.9,50900,22239,28661,10.1,23.1,36189,16582,19607,7.5,16.4,14711,6.7,32.8,0,986,986,8164
1987,29820,9977,11627,253539,240547,2268,20.1,1558,13.8,58723,20999,37724,8.7,24.4,32739,15381,17358,6.4,13.6,25984,10.8,27.2,0,955,964,7318
1988,29820,10315,12166,268673,260685,2163,18.2,1577,13.3,64809,25944,38865,10,24.9,48832,21766,27066,8.3,18.7,15977,6.2,37.4,0,1065,1065,8950
1989,29820,11036,13024,302746,286080,2376,18.9,1511,12,78201,26861,51340,9.4,27.3,44868,19594,25274,6.8,15.7,33333,11.6,31.4,0,1009,1015,11040
1990,29820,11887,13991,336094,319133,2543,18.8,1485,11,77981,24165,53816,7.6,24.4,44058,14405,29653,4.5,13.8,33923,10.6,27.6,0,1056,1064,10305
1991,29820,12678,15037,346079,341901,2686,18.5,1617,11.2,67241,26222,41019,7.7,19.7,58884,16400,42484,4.8,17.2,8357,2.5,34.4,0,1090,1097,11041
1992,29820,13029,15662,347791,347079,2774,18,2097,13.6,61716,27110,34606,7.8,17.8,60292,20706,39586,6,17.4,1424,0.4,34.8,0,1413,1430,11541
1993,29820,13578,16233,369173,358403,2738,17.2,2080,13,71535,31347,40188,8.7,20,49995,20315,29680,5.7,13.9,21540,6.1,27.8,0,1414,1428,12761
1994,29820,14391,17172,410524,389720,3023,18.1,2026,12.1,97267,35546,61721,9.1,25,55659,24825,30834,6.4,14.3,41608,10.7,28.6,0,1433,1435,17739
1995,29820,15312,18256,441557,425666,3294,18.6,2126,12,84865,34591,50274,8.1,19.9,53083,17814,35269,4.2,12.5,31782,7.4,25,0,1479,1482,10435
1996,29820,16040,19193,475596,458290,3480,18.6,2457,13.1,103056,47579,55477,10.4,22.5,68444,30579,37865,6.7,14.9,34612,7.6,29.8,0,1643,1643,15452
1997,29820,17205,20829,512027,494072,4290,21.4,2706,13.5,111380,48017,63363,9.7,22.5,75470,26104,49366,5.3,15.3,35910,7.2,30.6,0,1716,1716,12203
1998,29820,18155,22123,535344,523056,4114,19.2,2762,12.9,103663,46197,57466,8.8,19.8,79087,26314,52773,5,15.1,24576,4.7,30.2,0,1858,1858,13408
1999,29820,19304,23869,591149,564813,4593,20,2830,12.3,131832,57714,74118,10.2,23.3,79160,29487,49673,5.2,14,52672,9.3,28,0,1860,1860,15785
2000,29820,20134,24967,637260,614208,4447,18.2,3317,13.6,132066,53230,78836,8.7,21.5,85963,30991,54972,5,14,46103,7.5,28,0,2038,2038,15810
2001,29820,20764,25938,650535,644637,4513,17.7,3744,14.7,117596,50411,67185,7.8,18.2,105799,37329,68470,5.8,16.4,11797,1.8,32.8,0,2287,2287,18746
2002,29820,21646,27152,664545,660373,5061,19.1,3821,14.4,131149,59978,71171,9.1,19.9,122804,38004,84800,5.8,18.6,8345,1.3,37.2,0,2178,2180,16151
2003,29820,22825,28586,696858,677978,5258,19,3202,11.6,131765,54514,77251,8,19.4,94004,30603,63401,4.5,13.9,37761,5.5,27.8,0,2241,2242,16793
2004,29820,24209,30128,737326,713676,5405,18.5,3473,11.9,143536,53023,90513,7.4,20.1,96236,38573,57663,5.4,13.5,47300,6.6,27,0,2345,2360,19767
2005,29820,25738,32064,780180,756690,5898,19,3605,11.6,155320,62463,92857,8.3,20.5,108340,48858,59482,6.5,14.3,46980,6.2,28.6,0,2591,2592,28550
2006,29820,27116,34002,850771,813598,6141,18.6,3890,11.8,174041,69143,104898,8.5,21.4,99694,38722,60972,4.8,12.3,74347,9.1,24.6,0,2806,2807,24613
2007,29820,28118,35500,873334,857694,6157,17.7,4587,13.2,174740,69803,104937,8.1,20.4,143459,45260,98199,5.3,16.7,31281,3.7,33.4,0,3040,3058,21699
2008,29820,28091,35801,851647,859011,5497,15.5,4795,13.5,133754,57557,76197,6.7,15.6,148481,42283,106198,4.9,17.3,-14727,-1.7,31.2,0,3643,3644,26786
2009,29820,26999,34759,770169,807640,4710,13.4,5252,15,107121,45223,61898,5.6,13.3,182062,40270,141792,5,22.5,-74941,-9.2,26.6,0,3763,3793,24378
2010,29820,26357,34210,738954,751474,4556,13.3,4717,13.7,114703,55296,59407,7.4,15.3,139743,37249,102494,5,18.6,-25040,-3.3,30.6,0,3290,3294,24628
2011,29820,26416,34376,736496,736464,4621,13.5,4204,12.3,99844,35408,64436,4.8,13.6,99781,34278,65503,4.7,13.5,63,0.1,27,0,2917,2939,24497
2012,29820,26914,34871,752401,743305,4697,13.6,4070,11.8,112261,40570,71691,5.5,15.1,94069,36806,57263,5,12.7,18192,2.4,25.4,0,2576,2609,20427
2013,29820,27506,35486,773770,761890,4587,13.1,3930,11.2,117840,42930,74910,5.6,15.5,94080,36769,57311,4.8,12.3,23760,3.2,24.6,0,2607,2640,22701
2014,29820,28340,36453,801485,784111,5173,14.4,3904,10.9,123102,48379,74723,6.2,15.7,88354,36891,51463,4.7,11.3,34748,4.4,22.6,0,2667,2680,17447
1977,29940,1082,1137,14059,13496,205,18.5,145,13.1,2930,1570,1360,11.6,21.7,1803,807,996,6,13.4,1127,8.3,26.8,0,97,97,435
1978,29940,1147,1205,15669,14866,191,16.3,123,10.5,3289,1393,1896,9.4,22.1,1682,633,1049,4.3,11.3,1607,10.8,22.6,0,84,84,434
1979,29940,1181,1247,16972,16313,185,15.1,137,11.2,3349,1070,2279,6.6,20.5,2031,738,1293,4.5,12.5,1318,8,25,0,94,94,400
1980,29940,1174,1239,17562,17257,159,12.8,161,13,3040,991,2049,5.7,17.6,2430,967,1463,5.6,14.1,610,3.5,28.2,0,110,110,644
1981,29940,1158,1222,17141,17202,166,13.5,165,13.4,2628,1202,1426,7,15.3,2750,1013,1737,5.9,16,-122,-0.7,30.6,0,90,90,459
1982,29940,1195,1270,16831,16995,207,16.6,149,11.9,2738,1404,1334,8.3,16.1,3066,1003,2063,5.9,18,-328,-1.9,32.2,0,81,81,426
1983,29940,1228,1307,16995,16869,180,14,149,11.6,2890,1572,1318,9.3,17.1,2637,908,1729,5.4,15.6,253,1.5,31.2,0,102,103,579
1984,29940,1249,1335,17102,17056,205,15.5,178,13.5,2894,1037,1857,6.1,17,2802,1446,1356,8.5,16.4,92,0.6,32.8,0,103,103,512
1985,29940,1337,1421,17990,17694,221,16,139,10.1,3192,1198,1994,6.8,18,2600,1228,1372,6.9,14.7,592,3.3,29.4,0,85,85,599
1986,29940,1403,1484,18970,18468,217,15,150,10.3,3420,1600,1820,8.7,18.5,2416,674,1742,3.6,13.1,1004,5.4,26.2,0,98,98,456
1987,29940,1470,1558,20918,19947,242,15.9,168,11,4683,2334,2349,11.7,23.5,2740,1220,1520,6.1,13.7,1943,9.8,27.4,0,122,122,804
1988,29940,1478,1563,21170,20827,234,15,210,13.5,3929,1480,2449,7.1,18.9,3242,1313,1929,6.3,15.6,687,3.3,31.2,0,145,145,640
1989,29940,1567,1666,22829,22081,261,16.2,163,10.1,4171,1936,2235,8.8,18.9,2675,1166,1509,5.3,12.1,1496,6.8,24.2,0,110,110,757
1990,29940,1553,1649,24247,23496,212,12.8,207,12.5,4973,1774,3199,7.6,21.2,3471,1788,1683,7.6,14.8,1502,6.4,29.6,0,151,152,989
1991,29940,1629,1723,25715,24980,210,12.5,137,8.1,4690,2098,2592,8.4,18.8,3220,986,2234,3.9,12.9,1470,5.9,25.8,0,86,86,494
1992,29940,1693,1799,25561,25660,220,12.5,143,8.1,3779,1186,2593,4.6,14.7,3977,790,3187,3.1,15.5,-198,-0.8,29.4,0,95,95,468
1993,29940,1742,1860,26704,26096,226,12.4,161,8.8,4190,1572,2618,6,16.1,2973,890,2083,3.4,11.4,1217,4.7,22.8,0,116,116,588
1994,29940,1829,1948,28316,27480,287,15.1,189,9.9,4507,1687,2820,6.1,16.4,2834,1039,1795,3.8,10.3,1673,6.1,20.6,0,123,124,738
1995,29940,1910,2039,29149,28523,301,15.1,205,10.3,4844,2000,2844,7,17,3591,1418,2173,5,12.6,1253,4.4,25.2,0,146,146,890
1996,29940,1962,2093,31002,30281,288,13.9,228,11,5343,2418,2925,8,17.6,3900,1552,2348,5.1,12.9,1443,4.7,25.8,0,155,155,833
1997,29940,2046,2187,32997,32002,320,14.9,220,10.3,6215,3157,3058,9.9,19.4,4224,1215,3009,3.8,13.2,1991,6.2,26.4,0,143,143,602
1998,29940,2077,2211,34458,33728,278,12.6,252,11.5,5986,2185,3801,6.5,17.7,4525,1705,2820,5.1,13.4,1461,4.3,26.8,0,145,145,791
1999,29940,2129,2263,35594,35493,305,13.6,251,11.2,6331,2540,3791,7.2,17.8,6129,2155,3974,6.1,17.3,202,0.5,34.6,0,170,170,775
2000,29940,2161,2299,36596,36096,287,12.6,251,11,5959,2328,3631,6.4,16.5,4958,1778,3180,4.9,13.7,1001,2.8,27.4,0,139,139,659
2001,29940,2174,2304,35140,35902,271,11.7,290,12.6,4857,1993,2864,5.6,13.5,6380,2823,3557,7.9,17.8,-1523,-4.3,27,0,169,169,1237
2002,29940,2244,2382,37038,36089,352,15,273,11.7,7265,3092,4173,8.6,20.1,5367,1697,3670,4.7,14.9,1898,5.2,29.8,0,157,157,836
2003,29940,2244,2395,35901,36351,275,11.5,235,9.9,4249,1406,2843,3.9,11.7,5148,1632,3516,4.5,14.2,-899,-2.5,23.4,0,174,175,970
2004,29940,2308,2459,35583,35376,267,11,184,7.6,4620,1816,2804,5.1,13.1,4206,1204,3002,3.4,11.9,414,1.2,23.8,0,135,135,853
2005,29940,2329,2490,37397,36410,251,10.2,195,7.9,5369,1573,3796,4.3,14.7,3394,1051,2343,2.9,9.3,1975,5.4,18.6,0,145,145,880
2006,29940,2346,2520,38052,37682,257,10.3,215,8.6,5776,1768,4008,4.7,15.3,5036,2485,2551,6.6,13.4,740,1.9,26.8,0,156,156,955
2007,29940,2352,2523,37855,37892,264,10.5,253,10,4938,1685,3253,4.4,13,5012,2279,2733,6,13.2,-74,-0.2,26,0,173,174,1314
2008,29940,2314,2478,38339,37969,218,8.7,240,9.6,4770,1082,3688,2.8,12.6,4029,1366,2663,3.6,10.6,741,2,21.2,0,186,186,1114
2009,29940,2262,2426,36968,37663,196,8,224,9.2,3661,1084,2577,2.9,9.7,5050,1108,3942,2.9,13.4,-1389,-3.7,19.4,0,165,165,794
2010,29940,2226,2384,36512,36696,190,7.9,219,9.1,4048,1476,2572,4,11,4416,1293,3123,3.5,12,-368,-1,22,0,155,155,957
2011,29940,2181,2360,36033,36214,211,8.9,225,9.5,3920,1301,2619,3.6,10.8,4282,1083,3199,3,11.8,-362,-1,21.6,0,154,154,825
2012,29940,2238,2404,36330,36102,249,10.5,205,8.6,4493,1802,2691,5,12.4,4037,1174,2863,3.3,11.2,456,1.2,22.4,0,120,122,712
2013,29940,2216,2388,36967,36838,168,7,192,8,4186,901,3285,2.4,11.4,3928,949,2979,2.6,10.7,258,0.7,21.4,0,124,124,511
2014,29940,2240,2402,39440,38088,210,8.8,174,7.3,5579,1328,4251,3.5,14.6,2875,902,1973,2.4,7.5,2704,7.1,15,0,108,108,562
1977,30020,1507,1620,14982,14513,286,18,220,13.8,3717,1594,2123,11,25.6,2778,1414,1364,9.7,19.1,939,6.5,38.2,0,144,145,912
1978,30020,1392,1507,15476,15131,221,14.1,310,19.8,3388,1333,2055,8.8,22.4,2698,1619,1079,10.7,17.8,690,4.6,35.6,0,191,191,991
1979,30020,1546,1659,16651,16082,273,17.2,134,8.5,4005,1614,2391,10,24.9,2867,1347,1520,8.4,17.8,1138,7.1,35.6,1,1,1,
1980,30020,1566,1685,18396,17495,272,16.3,231,13.8,5318,3149,2169,18,30.4,3516,1393,2123,8,20.1,1802,10.3,40.2,0,169,169,775
1981,30020,1547,1664,17997,17817,241,14.4,242,14.5,3525,1603,1922,9,19.8,3165,1155,2010,6.5,17.8,360,2,35.6,0,164,164,649
1982,30020,1577,1711,19749,18843,273,16.2,203,12,4478,2532,1946,13.4,23.8,2666,1064,1602,5.6,14.1,1812,9.7,28.2,0,124,124,572
1983,30020,1647,1780,19490,19383,243,13.9,189,10.8,3964,1785,2179,9.2,20.5,3749,1558,2191,8,19.3,215,1.2,38.6,0,134,134,1143
1984,30020,1705,1844,20702,20131,284,15.7,221,12.2,4392,1881,2511,9.3,21.8,3249,1047,2202,5.2,16.1,1143,5.7,32.2,0,152,152,648
1985,30020,1697,1830,23523,23598,230,12.5,251,13.6,3364,1356,2008,5.7,14.3,3514,1543,1971,6.5,14.9,-150,-0.6,28.6,0,165,167,866
1986,30020,1709,1843,23765,23635,241,13.1,220,12,3778,1490,2288,6.3,16,3517,1224,2293,5.2,14.9,261,1.1,29.8,0,148,148,741
1987,30020,1712,1861,24873,24850,252,13.6,232,12.5,3748,1468,2280,5.9,15.1,3701,1546,2155,6.2,14.9,47,0.2,29.8,0,142,143,946
1988,30020,1629,1781,22380,22114,213,11.7,261,14.4,3891,1646,2245,7.4,17.6,3358,1387,1971,6.3,15.2,533,2.4,30.4,0,169,169,902
1989,30020,1639,1787,23199,22810,224,12.6,215,12.1,4228,2033,2195,8.9,18.5,3450,1449,2001,6.4,15.1,778,3.4,30.2,0,146,147,895
1990,30020,1630,1783,23042,23073,206,11.5,191,10.7,3940,1918,2022,8.3,17.1,4002,2049,1953,8.9,17.3,-62,-0.2,34.2,0,136,136,1060
1991,30020,1615,1790,23542,23273,216,12.1,196,11,4087,1694,2393,7.3,17.6,3549,1594,1955,6.8,15.2,538,2.4,30.4,0,133,133,754
1992,30020,1693,1878,24097,23811,256,14,164,8.9,4180,1520,2660,6.4,17.6,3607,1456,2151,6.1,15.1,573,2.5,30.2,0,120,120,988
1993,30020,1739,1917,24599,24333,233,12.3,181,9.5,4725,1830,2895,7.5,19.4,4192,1937,2255,8,17.2,533,2.2,34.4,0,121,124,734
1994,30020,1746,1923,24911,24729,225,11.7,209,10.9,4029,1635,2394,6.6,16.3,3665,1587,2078,6.4,14.8,364,1.5,29.6,0,140,140,1115
1995,30020,1729,1905,25227,25004,208,10.9,216,11.3,4256,1561,2695,6.2,17,3810,1843,1967,7.4,15.2,446,1.8,30.4,0,163,163,1156
1996,30020,1727,1903,25176,25223,200,10.5,200,10.5,3544,814,2730,3.2,14.1,3638,1659,1979,6.6,14.4,-94,-0.3,28.2,0,148,148,638
1997,30020,1777,1959,25956,25622,262,13.6,212,11,4979,2636,2343,10.3,19.4,4311,1107,3204,4.3,16.8,668,2.6,33.6,0,126,126,652
1998,30020,1726,1912,25989,25939,192,9.9,232,12,4150,1103,3047,4.3,16,4050,1760,2290,6.8,15.6,100,0.4,31.2,0,159,159,885
1999,30020,1775,1967,27448,27425,237,12.2,184,9.5,4141,1893,2248,6.9,15.1,4094,1347,2747,4.9,14.9,47,0.2,29.8,0,120,120,628
2000,30020,1771,1962,27786,27629,199,10.1,207,10.5,4161,1624,2537,5.9,15.1,3846,1511,2335,5.5,13.9,315,1.2,27.8,0,137,137,665
2001,30020,1790,1994,27647,27768,217,11,198,10,3625,1383,2242,5,13.1,3867,1341,2526,4.8,13.9,-242,-0.8,26.2,0,126,126,757
2002,30020,1765,1969,28741,28220,210,10.6,238,12,5067,2111,2956,7.5,18,4024,1441,2583,5.1,14.3,1043,3.7,28.6,0,132,132,576
2003,30020,1762,1972,29547,29095,167,8.5,145,7.4,4339,1480,2859,5.1,14.9,3434,957,2477,3.3,11.8,905,3.1,23.6,0,101,101,661
2004,30020,1770,2012,29832,29653,199,10,148,7.4,3879,1607,2272,5.4,13.1,3520,871,2649,2.9,11.9,359,1.2,23.8,0,113,113,717
2005,30020,1800,2032,30992,30370,205,10.2,168,8.3,4071,1271,2800,4.2,13.4,2827,1073,1754,3.5,9.3,1244,4.1,18.6,0,102,102,438
2006,30020,1784,2025,31191,30955,222,11,202,10,4182,1837,2345,5.9,13.5,3709,1404,2305,4.5,12,473,1.5,24,0,134,134,974
2007,30020,1835,2101,32058,31647,242,11.7,180,8.7,5134,1771,3363,5.6,16.2,4312,1517,2795,4.8,13.6,822,2.6,27.2,0,130,130,700
2008,30020,1803,2079,33311,32564,179,8.6,175,8.4,4988,2032,2956,6.2,15.3,3493,1012,2481,3.1,10.7,1495,4.6,21.4,0,135,135,731
2009,30020,1795,2084,33104,33058,185,8.9,163,7.9,3996,1367,2629,4.1,12.1,3903,1085,2818,3.3,11.8,93,0.3,23.6,0,121,121,806
2010,30020,1776,2062,32597,32759,162,7.8,171,8.3,3535,1320,2215,4,10.8,3858,1931,1927,5.9,11.8,-323,-1,21.6,0,109,109,1450
2011,30020,1765,2043,32614,32571,151,7.4,151,7.4,3803,1625,2178,5,11.7,3716,943,2773,2.9,11.4,87,0.3,22.8,0,108,108,441
2012,30020,1784,2049,33369,32927,174,8.5,173,8.5,4665,1517,3148,4.6,14.2,3781,1174,2607,3.6,11.5,884,2.7,23,0,96,96,404
2013,30020,1765,2034,32410,32793,148,7.3,153,7.5,3364,1343,2021,4.1,10.3,4130,1110,3020,3.4,12.6,-766,-2.3,20.6,0,106,106,666
2014,30020,1733,2002,31228,31329,161,8,169,8.4,3651,1331,2320,4.2,11.7,3853,1830,2023,5.8,12.3,-202,-0.6,23.4,0,129,129,1112
1977,30140,1787,1893,30294,30180,253,13.6,198,10.6,4429,2110,2319,7,14.7,4201,1686,2515,5.6,13.9,228,0.8,27.8,0,134,134,1005
1978,30140,1805,1907,31474,30880,194,10.2,178,9.4,4454,1121,3333,3.6,14.4,3266,1254,2012,4.1,10.6,1188,3.8,21.2,0,113,115,640
1979,30140,1807,1919,33526,32587,193,10.1,172,9,5162,1554,3608,4.8,15.8,3284,897,2387,2.8,10.1,1878,5.7,20.2,0,135,135,519
1980,30140,1794,1912,32555,33038,195,10.2,200,10.4,3248,1256,1992,3.8,9.8,4213,1264,2949,3.8,12.8,-965,-3,19.6,0,152,152,737
1981,30140,1712,1821,31332,31777,181,9.7,242,13,3854,1471,2383,4.6,12.1,4746,2388,2358,7.5,14.9,-892,-2.8,24.2,0,145,146,605
1982,30140,1689,1809,32064,31645,190,10.5,178,9.8,4926,2831,2095,8.9,15.6,4088,1646,2442,5.2,12.9,838,2.7,25.8,0,118,118,822
1983,30140,1721,1847,29492,30683,172,9.4,154,8.4,3267,1274,1993,4.2,10.6,5648,1646,4002,5.4,18.4,-2381,-7.8,21.2,0,102,102,587
1984,30140,1800,1925,30052,29775,233,12.4,161,8.5,4007,1390,2617,4.7,13.5,3452,964,2488,3.2,11.6,555,1.9,23.2,0,112,112,643
1985,30140,1807,1933,32766,31454,226,11.7,214,11.1,6415,1549,4866,4.9,20.4,3790,1887,1903,6,12,2625,8.4,24,0,130,130,689
1986,30140,1833,1963,29336,31039,231,11.9,193,9.9,4525,1858,2667,6,14.6,7930,5012,2918,16.1,25.5,-3405,-10.9,29.2,0,129,129,3113
1987,30140,1923,2069,32929,31849,273,13.5,162,8,5450,2219,3231,7,17.1,3289,1259,2030,4,10.3,2161,6.8,20.6,0,101,104,582
1988,30140,1929,2082,33832,33329,219,10.6,197,9.5,5146,1746,3400,5.2,15.4,4139,1772,2367,5.3,12.4,1007,3,24.8,0,138,138,1076
1989,30140,1976,2147,35421,34626,245,11.6,179,8.5,5254,2308,2946,6.7,15.2,3663,1387,2276,4,10.6,1591,4.6,21.2,0,130,130,803
1990,30140,2002,2187,35409,35399,222,10.2,167,7.7,4324,1631,2693,4.6,12.2,4303,1186,3117,3.4,12.2,21,0,24.4,0,115,115,607
1991,30140,2047,2249,35159,35260,248,11.2,187,8.4,5270,1515,3755,4.3,14.9,5472,1770,3702,5,15.5,-202,-0.6,29.8,0,128,128,1031
1992,30140,2019,2235,35531,35380,187,8.3,196,8.7,4611,1508,3103,4.3,13,4308,1559,2749,4.4,12.2,303,0.8,24.4,0,139,139,949
1993,30140,1984,2193,35206,35344,141,6.4,168,7.6,3638,1171,2467,3.3,10.3,3913,1228,2685,3.5,11.1,-275,-0.8,20.6,0,118,118,620
1994,30140,1968,2191,35649,35419,145,6.6,146,6.7,4070,1226,2844,3.5,11.5,3610,1174,2436,3.3,10.2,460,1.3,20.4,0,110,110,724
1995,30140,1998,2226,36765,36182,183,8.3,135,6.1,4248,1393,2855,3.8,11.7,3081,981,2100,2.7,8.5,1167,3.2,17,0,95,95,460
1996,30140,2025,2258,36649,36677,208,9.3,177,7.9,4456,1546,2910,4.2,12.1,4512,1641,2871,4.5,12.3,-56,-0.2,24.2,0,114,114,619
1997,30140,2032,2292,36571,36550,230,10.1,196,8.6,5301,1927,3374,5.3,14.5,5259,2264,2995,6.2,14.4,42,0.1,28.8,0,126,126,1230
1998,30140,2032,2291,36735,36698,197,8.6,194,8.5,4210,1450,2760,4,11.5,4136,1287,2849,3.5,11.3,74,0.2,22.6,0,117,117,388
1999,30140,2031,2279,36962,36848,194,8.5,205,9,4457,2108,2349,5.7,12.1,4229,1479,2750,4,11.5,228,0.6,23,0,126,126,803
2000,30140,2036,2286,37200,37070,199,8.7,191,8.4,4450,1929,2521,5.2,12,4190,1739,2451,4.7,11.3,260,0.7,22.6,0,126,126,1057
2001,30140,2078,2346,39343,38321,221,9.5,180,7.8,5857,2705,3152,7.1,15.3,3813,1363,2450,3.6,10,2044,5.3,20,0,115,115,851
2002,30140,2105,2374,38896,39090,249,10.6,211,9,5330,2573,2757,6.6,13.6,5718,2304,3414,5.9,14.6,-388,-1,27.2,0,102,102,568
2003,30140,2076,2339,38850,38642,190,8.1,183,7.8,3992,1052,2940,2.7,10.3,3575,1122,2453,2.9,9.3,417,1,18.6,0,122,122,615
2004,30140,2101,2351,40913,39737,220,9.4,176,7.5,6148,2667,3481,6.7,15.5,3795,1457,2338,3.7,9.6,2353,5.9,19.2,0,117,117,679
2005,30140,2168,2428,41625,41234,261,10.9,177,7.4,4989,1976,3013,4.8,12.1,4207,1753,2454,4.3,10.2,782,1.9,20.4,0,122,122,1100
2006,30140,2185,2462,43260,42375,227,9.3,184,7.5,5519,2435,3084,5.7,13,3749,1221,2528,2.9,8.8,1770,4.2,17.6,0,122,124,919
2007,30140,2186,2457,44273,43748,208,8.5,208,8.5,5468,2282,3186,5.2,12.5,4417,1685,2732,3.9,10.1,1051,2.4,20.2,0,118,120,642
2008,30140,2192,2456,44699,44368,199,8.1,177,7.2,5064,1514,3550,3.4,11.4,4401,1761,2640,4,9.9,663,1.5,19.8,0,132,132,833
2009,30140,2141,2410,41979,43272,161,6.6,182,7.5,2958,726,2232,1.7,6.8,5543,1553,3990,3.6,12.8,-2585,-6,13.6,0,121,121,915
2010,30140,2166,2443,42182,42171,180,7.4,134,5.5,3921,1801,2120,4.3,9.3,3899,871,3028,2.1,9.2,22,0.1,18.4,0,97,97,682
2011,30140,2150,2434,42387,42167,162,6.7,153,6.3,4000,1122,2878,2.7,9.5,3560,846,2714,2,8.4,440,1.1,16.8,0,111,111,645
2012,30140,2175,2461,43619,42970,178,7.3,151,6.2,5106,1687,3419,3.9,11.9,3808,965,2843,2.2,8.9,1298,3,17.8,0,88,88,511
2013,30140,2159,2447,42848,43203,155,6.3,174,7.1,3787,788,2999,1.8,8.8,4497,2017,2480,4.7,10.4,-710,-1.6,17.6,0,102,105,1035
2014,30140,2150,2442,42603,42541,136,5.6,128,5.3,3616,948,2668,2.2,8.5,3491,792,2699,1.9,8.2,125,0.3,16.4,0,93,93,501
1977,30300,1094,1171,13156,12994,218,19.1,146,12.8,2383,1169,1214,9,18.3,2059,800,1259,6.2,15.8,324,2.5,31.6,0,106,106,661
1978,30300,1069,1147,13774,13439,165,14.2,175,15.1,2422,837,1585,6.2,18,1751,945,806,7,13,671,5,26,0,98,98,361
1979,30300,1133,1213,14361,14052,176,14.9,112,9.5,2392,927,1465,6.6,17,1773,629,1144,4.5,12.6,619,4.4,25.2,0,26,26,100
1980,30300,1138,1220,14855,14592,165,13.6,144,11.8,2457,744,1713,5.1,16.8,1930,728,1202,5,13.2,527,3.6,26.4,0,92,93,496
1981,30300,1081,1157,13959,14218,131,11.1,181,15.3,1813,806,1007,5.7,12.8,2331,973,1358,6.8,16.4,-518,-3.6,25.6,0,111,112,547
1982,30300,1084,1166,13299,13619,159,13.7,133,11.4,1715,873,842,6.4,12.6,2355,758,1597,5.6,17.3,-640,-4.7,25.2,0,69,69,377
1983,30300,1130,1214,13366,13331,149,12.5,118,9.9,1792,701,1091,5.3,13.4,1721,596,1125,4.5,12.9,71,0.5,25.8,0,73,73,329
1984,30300,1166,1253,14123,13743,165,13.4,128,10.4,2433,840,1593,6.1,17.7,1673,745,928,5.4,12.2,760,5.5,24.4,0,93,93,396
1985,30300,1151,1239,14153,14347,134,10.7,151,12.1,1920,807,1113,5.6,13.4,2308,815,1493,5.7,16.1,-388,-2.7,26.8,0,92,92,464
1986,30300,1157,1242,14152,14133,158,12.7,150,12.1,2027,964,1063,6.8,14.3,1989,662,1327,4.7,14.1,38,0.2,28.2,0,90,90,373
1987,30300,1172,1258,14876,14548,176,14.1,159,12.7,2669,1018,1651,7,18.3,2013,1017,996,7,13.8,656,4.5,27.6,0,100,100,536
1988,30300,1176,1271,15480,14944,152,12,133,10.5,2940,1212,1728,8.1,19.7,1867,615,1252,4.1,12.5,1073,7.2,25,0,94,94,326
1989,30300,1128,1220,15068,15283,126,10.1,170,13.6,2089,707,1382,4.6,13.7,2518,1005,1513,6.6,16.5,-429,-2.8,27.4,0,83,83,348
1990,30300,1220,1308,15925,15496,187,14.8,98,7.8,2621,1021,1600,6.6,16.9,1762,551,1211,3.6,11.4,859,5.5,22.8,0,75,75,272
1991,30300,1199,1292,16018,15935,133,10.2,145,11.2,2495,955,1540,6,15.7,2328,657,1671,4.1,14.6,167,1.1,29.2,0,89,89,377
1992,30300,1229,1326,16999,16514,154,11.7,122,9.3,2939,1003,1936,6.1,17.8,1968,622,1346,3.8,11.9,971,5.9,23.8,0,83,84,381
1993,30300,1264,1372,17950,17469,164,12.2,113,8.4,2796,777,2019,4.4,16,1834,665,1169,3.8,10.5,962,5.5,21,0,82,82,472
1994,30300,1309,1420,18980,18440,185,13.3,129,9.2,3306,1567,1739,8.5,17.9,2225,751,1474,4.1,12.1,1081,5.8,24.2,0,93,94,309
1995,30300,1332,1441,19432,19191,164,11.5,135,9.4,2587,783,1804,4.1,13.5,2105,744,1361,3.9,11,482,2.5,22,0,93,93,363
1996,30300,1376,1489,19140,19275,184,12.6,131,8.9,2270,969,1301,5,11.8,2540,631,1909,3.3,13.2,-270,-1.4,23.6,0,93,93,491
1997,30300,1381,1490,19569,19402,185,12.4,186,12.4,2950,1017,1933,5.2,15.2,2616,1164,1452,6,13.5,334,1.7,27,0,119,119,504
1998,30300,1382,1493,19892,19692,177,11.9,163,10.9,2972,1203,1769,6.1,15.1,2571,1054,1517,5.4,13.1,401,2,26.2,0,116,116,578
1999,30300,1382,1502,20227,20063,158,10.6,144,9.6,2547,950,1597,4.7,12.7,2218,822,1396,4.1,11.1,329,1.6,22.2,0,100,100,526
2000,30300,1352,1483,20627,20409,136,9.1,154,10.3,2777,957,1820,4.7,13.6,2341,865,1476,4.2,11.5,436,2.1,23,0,91,91,424
2001,30300,1297,1424,19901,20295,127,8.7,201,13.8,2039,632,1407,3.1,10,2827,1113,1714,5.5,13.9,-788,-3.9,20,0,108,108,539
2002,30300,1327,1457,19558,19709,189,13.1,155,10.8,2579,1232,1347,6.3,13.1,2881,821,2060,4.2,14.6,-302,-1.5,26.2,0,93,93,572
2003,30300,1304,1429,20466,19891,153,10.7,143,10,3122,1364,1758,6.9,15.7,1971,714,1257,3.6,9.9,1151,5.8,19.8,0,96,96,438
2004,30300,1342,1460,21497,20932,140,9.7,105,7.3,3259,1630,1629,7.8,15.6,2128,667,1461,3.2,10.2,1131,5.4,20.4,0,64,64,383
2005,30300,1352,1484,21732,21577,160,10.9,120,8.2,2525,794,1731,3.7,11.7,2214,569,1645,2.6,10.3,311,1.4,20.6,0,76,76,343
2006,30300,1353,1481,22265,21980,149,10.1,145,9.8,2683,740,1943,3.4,12.2,2113,643,1470,2.9,9.6,570,2.6,19.2,0,97,97,407
2007,30300,1370,1508,22659,22457,156,10.4,132,8.8,2873,1045,1828,4.7,12.8,2469,1052,1417,4.7,11,404,1.8,22,0,84,86,533
2008,30300,1375,1519,22151,22269,139,9.2,108,7.2,2135,611,1524,2.7,9.6,2371,869,1502,3.9,10.6,-236,-1,19.2,0,73,73,551
2009,30300,1315,1460,21075,21531,110,7.4,153,10.3,1725,743,982,3.5,8,2636,775,1861,3.6,12.2,-911,-4.2,16,0,101,101,590
2010,30300,1311,1454,21207,21076,107,7.4,112,7.7,2116,515,1601,2.4,10,1853,465,1388,2.2,8.8,263,1.2,17.6,0,77,77,322
2011,30300,1285,1431,20816,20970,106,7.4,112,7.8,1859,687,1172,3.3,8.9,2167,700,1467,3.3,10.3,-308,-1.4,17.8,0,69,69,234
2012,30300,1291,1437,21409,21132,127,8.9,131,9.1,2389,828,1561,3.9,11.3,1834,658,1176,3.1,8.7,555,2.6,17.4,0,80,80,327
2013,30300,1266,1415,21876,21476,111,7.8,131,9.2,2896,1175,1721,5.5,13.5,2095,869,1226,4,9.8,801,3.7,19.6,0,96,96,578
2014,30300,1258,1410,22116,21987,121,8.6,117,8.3,2538,894,1644,4.1,11.5,2280,655,1625,3,10.4,258,1.1,20.8,0,77,77,302
1977,30340,1781,1919,31150,29536,290,15.3,230,12.1,6730,3584,3146,12.1,22.8,3501,1626,1875,5.5,11.9,3229,10.9,23.8,0,160,160,1220
1978,30340,1842,1988,33399,32271,259,13.3,188,9.6,5882,1652,4230,5.1,18.2,3626,1009,2617,3.1,11.2,2256,7,22.4,0,141,141,791
1979,30340,1849,1990,33701,33531,243,12.2,231,11.6,4770,1704,3066,5.1,14.2,4430,1735,2695,5.2,13.2,340,1,26.4,0,163,163,789
1980,30340,1874,2017,33433,33556,256,12.8,220,11,4636,1683,2953,5,13.8,4882,1696,3186,5.1,14.5,-246,-0.7,27.6,0,153,153,922
1981,30340,1775,1909,32918,32853,196,10,284,14.5,4701,1539,3162,4.7,14.3,4571,2121,2450,6.5,13.9,130,0.4,27.8,0,162,162,651
1982,30340,1796,1962,32748,32808,277,14.3,205,10.6,5719,2711,3008,8.3,17.4,5838,1725,4113,5.3,17.8,-119,-0.4,34.8,0,122,122,913
1983,30340,1831,1996,32131,32410,207,10.5,188,9.5,4334,1793,2541,5.5,13.4,4891,1422,3469,4.4,15.1,-557,-1.7,26.8,0,119,119,688
1984,30340,1879,2052,33893,32978,247,12.2,189,9.4,5691,1435,4256,4.4,17.3,3860,1374,2486,4.2,11.7,1831,5.6,23.4,0,126,126,796
1985,30340,1942,2112,33777,34106,265,12.7,214,10.3,4706,1696,3010,5,13.8,5364,1901,3463,5.6,15.7,-658,-1.9,27.6,0,126,126,742
1986,30340,1993,2159,35821,34848,290,13.6,239,11.2,6351,3198,3153,9.2,18.2,4404,1758,2646,5,12.6,1947,5.6,25.2,0,141,141,708
1987,30340,2091,2275,36485,36164,351,15.8,230,10.4,5690,2317,3373,6.4,15.7,5048,2489,2559,6.9,14,642,1.7,28,0,142,143,720
1988,30340,2154,2342,38497,37156,330,14.3,244,10.6,7405,2404,5001,6.5,19.9,4723,1809,2914,4.9,12.7,2682,7.2,25.4,0,165,165,862
1989,30340,2177,2389,39722,39079,306,12.9,256,10.8,7607,2533,5074,6.5,19.5,6321,2804,3517,7.2,16.2,1286,3.3,32.4,0,181,181,1483
1990,30340,2152,2371,36705,38159,295,12.4,290,12.2,4634,2400,2234,6.3,12.1,7542,2229,5313,5.8,19.8,-2908,-7.7,24.2,0,195,195,1243
1991,30340,2122,2337,35381,36006,265,11.3,287,12.2,5420,1857,3563,5.2,15.1,6669,2726,3943,7.6,18.5,-1249,-3.4,30.2,0,177,177,1510
1992,30340,2075,2288,34240,34767,238,10.3,273,11.8,4513,2018,2495,5.8,13,5566,1634,3932,4.7,16,-1053,-3,26,0,171,173,824
1993,30340,2074,2278,35883,35045,247,10.8,240,10.5,5590,1717,3873,4.9,16,3913,1822,2091,5.2,11.2,1677,4.8,22.4,0,155,155,1236
1994,30340,2058,2268,37794,36734,237,10.4,224,9.9,5583,1342,4241,3.7,15.2,3463,1293,2170,3.5,9.4,2120,5.8,18.8,0,166,166,876
1995,30340,2075,2279,39300,38580,251,11,238,10.5,5626,1792,3834,4.6,14.6,4185,1868,2317,4.8,10.8,1441,3.8,21.6,0,157,157,1121
1996,30340,2117,2332,39128,39196,275,11.9,210,9.1,4325,1698,2627,4.3,11,4460,1079,3381,2.8,11.4,-135,-0.4,22,0,145,145,561
1997,30340,2179,2410,40029,39631,296,12.5,233,9.8,5674,2165,3509,5.5,14.3,4878,2304,2574,5.8,12.3,796,2,24.6,0,144,144,1114
1998,30340,2184,2416,41220,40612,233,9.7,231,9.6,5165,1402,3763,3.5,12.7,3948,1478,2470,3.6,9.7,1217,3,19.4,0,153,153,906
1999,30340,2185,2420,43611,42836,240,9.9,229,9.5,5415,1499,3916,3.5,12.6,3865,1095,2770,2.6,9,1550,3.6,18,0,158,158,667
2000,30340,2189,2438,45981,44311,229,9.4,206,8.5,7592,3231,4361,7.3,17.1,4252,1147,3105,2.6,9.6,3340,7.5,19.2,0,143,143,723
2001,30340,2213,2474,46392,46185,251,10.2,230,9.4,6484,1910,4574,4.1,14,6069,1391,4678,3,13.1,415,0.9,26.2,0,126,126,816
2002,30340,2247,2510,45353,45839,265,10.6,231,9.3,6018,2100,3918,4.6,13.1,6989,1921,5068,4.2,15.2,-971,-2.1,26.2,0,128,128,815
2003,30340,2224,2487,45159,45096,232,9.3,213,8.6,5543,2415,3128,5.4,12.3,5416,1395,4021,3.1,12,127,0.3,24,0,145,145,826
2004,30340,2250,2516,44794,44872,254,10.2,207,8.3,5085,1574,3511,3.5,11.3,5240,2068,3172,4.6,11.7,-155,-0.4,22.6,0,137,137,992
2005,30340,2281,2562,44089,44430,275,10.8,216,8.5,4277,1655,2622,3.7,9.6,4959,1463,3496,3.3,11.2,-682,-1.6,19.2,0,154,154,1116
2006,30340,2288,2608,45795,44897,288,11.2,221,8.6,5937,2403,3534,5.4,13.2,4141,1242,2899,2.8,9.2,1796,4,18.4,0,168,168,1093
2007,30340,2310,2646,46196,45979,287,10.9,251,9.6,6086,2433,3653,5.3,13.2,5651,1320,4331,2.9,12.3,435,0.9,24.6,0,157,158,651
2008,30340,2261,2602,46106,45854,235,9,254,9.7,5261,1397,3864,3,11.5,4757,1529,3228,3.3,10.4,504,1.1,20.8,0,180,180,862
2009,30340,2160,2496,43655,44812,188,7.4,263,10.4,3492,822,2670,1.8,7.8,5805,1184,4621,2.6,13,-2313,-5.2,15.6,0,176,176,752
2010,30340,2148,2495,43504,43555,209,8.4,203,8.2,4898,1769,3129,4.1,11.2,5000,1332,3668,3.1,11.5,-102,-0.3,22.4,0,133,133,675
2011,30340,2125,2467,42684,43039,206,8.3,208,8.4,4960,1565,3395,3.6,11.5,5670,2176,3494,5.1,13.2,-710,-1.7,23,0,126,127,1632
2012,30340,2110,2436,44414,43453,234,9.6,254,10.4,5985,2271,3714,5.2,13.8,4062,1782,2280,4.1,9.3,1923,4.5,18.6,0,148,148,1124
2013,30340,2096,2419,43637,43920,181,7.5,192,7.9,4415,1859,2556,4.2,10.1,4980,1723,3257,3.9,11.3,-565,-1.2,20.2,0,120,120,985
2014,30340,2094,2408,44373,43704,199,8.3,192,8,5266,2268,2998,5.2,12,3928,1210,2718,2.8,9,1338,3,18,0,124,124,910
1977,30460,5517,6131,100802,99744,1025,17.1,729,12.2,18864,7721,11143,7.7,18.9,16747,6336,10411,6.4,16.8,2117,2.1,33.6,0,486,486,3618
1978,30460,5723,6359,107265,104016,989,15.8,756,12.1,20236,6566,13670,6.3,19.5,13738,4818,8920,4.6,13.2,6498,6.3,26.4,0,503,504,2674
1979,30460,5926,6600,117618,112367,999,15.4,720,11.1,23254,8054,15200,7.2,20.7,12752,5254,7498,4.7,11.3,10502,9.4,22.6,0,520,521,3379
1980,30460,6000,6693,115713,116567,862,13,739,11.1,16887,6944,9943,6,14.5,18595,6207,12388,5.3,16,-1708,-1.5,29,0,520,522,3221
1981,30460,5890,6565,115163,114310,826,12.5,889,13.4,18863,7439,11424,6.5,16.5,17157,6319,10838,5.5,15,1706,1.5,30,0,575,575,3327
1982,30460,6017,6810,112455,113696,1040,15.5,732,10.9,17142,7751,9391,6.8,15.1,19624,5377,14247,4.7,17.3,-2482,-2.2,30.2,0,443,443,2246
1983,30460,6241,7073,111944,112234,921,13.3,700,10.1,18001,7127,10874,6.4,16,18580,5374,13206,4.8,16.6,-579,-0.6,32,0,471,474,3256
1984,30460,6449,7313,120241,115973,1009,14,774,10.8,21844,8786,13058,7.6,18.8,13308,5015,8293,4.3,11.5,8536,7.3,23,0,520,520,2936
1985,30460,6627,7489,131571,126951,950,12.8,803,10.8,23582,7314,16268,5.8,18.6,14341,5819,8522,4.6,11.3,9241,7.3,22.6,0,535,539,3758
1986,30460,6823,7701,139856,135558,1055,13.9,814,10.7,27167,12110,15057,8.9,20,18570,6519,12051,4.8,13.7,8597,6.3,27.4,0,530,530,3108
1987,30460,7132,8049,145300,145852,1253,15.9,884,11.2,24109,10429,13680,7.2,16.5,25213,10986,14227,7.5,17.3,-1104,-0.8,33,0,542,543,4522
1988,30460,7234,8257,154735,148549,1156,14.2,891,11,33196,12325,20871,8.3,22.3,20823,6681,14142,4.5,14,12373,8.3,28,0,622,622,3448
1989,30460,7352,8397,155519,155260,1059,12.7,929,11.2,26576,9782,16794,6.3,17.1,26058,9581,16477,6.2,16.8,518,0.3,33.6,0,625,628,4846
1990,30460,7454,8552,157859,156305,1054,12.4,853,10.1,26597,10530,16067,6.7,17,23488,9319,14169,6,15,3109,2,30,0,586,588,3827
1991,30460,7502,8642,156912,157388,1049,12.2,952,11.1,23526,8312,15214,5.3,14.9,24477,8055,16422,5.1,15.6,-951,-0.7,29.8,0,638,642,4906
1992,30460,7600,8789,157952,157285,1102,12.6,930,10.7,24865,8064,16801,5.1,15.8,23530,8895,14635,5.7,15,1335,0.8,30,0,620,625,5391
1993,30460,7729,8902,166889,162613,1027,11.6,899,10.2,26550,8274,18276,5.1,16.3,17997,6393,11604,3.9,11.1,8553,5.2,22.2,0,626,627,3237
1994,30460,7824,9032,167299,167090,1029,11.5,886,9.9,24244,9414,14830,5.6,14.5,23825,6987,16838,4.2,14.3,419,0.2,28.6,0,623,624,3631
1995,30460,7941,9199,176705,171907,1089,12,889,9.8,28459,9627,18832,5.6,16.6,18862,5993,12869,3.5,11,9597,5.6,22,0,588,588,3295
1996,30460,8077,9349,184649,180770,1046,11.3,890,9.6,28990,10893,18097,6,16,21231,7189,14042,4,11.7,7759,4.3,23.4,0,589,589,4551
1997,30460,8271,9582,190975,187791,1179,12.4,950,10,33234,10089,23145,5.4,17.7,26866,9601,17265,5.1,14.3,6368,3.4,28.6,0,533,533,4064
1998,30460,8291,9669,197449,194102,1070,11.1,956,9.9,32997,12896,20101,6.6,17,26303,9007,17296,4.6,13.6,6694,3.4,27.2,0,638,638,4221
1999,30460,8379,9798,198162,197552,1071,11,926,9.5,30459,12174,18285,6.2,15.4,29238,8855,20383,4.5,14.8,1221,0.6,29.6,0,563,563,3834
2000,30460,8455,9923,206619,202217,1136,11.5,995,10.1,33609,12947,20662,6.4,16.6,24804,10071,14733,5,12.3,8805,4.3,24.6,0,580,580,4978
2001,30460,8449,9984,204092,206072,1045,10.5,1079,10.8,27562,11529,16033,5.6,13.4,31521,9229,22292,4.5,15.3,-3959,-1.9,26.8,0,636,636,3942
2002,30460,8499,10128,199995,201631,1268,12.6,1109,11,30006,12320,17686,6.1,14.9,33277,9900,23377,4.9,16.5,-3271,-1.6,29.8,0,576,576,4064
2003,30460,8563,10241,202135,199976,1127,11.1,820,8.1,26447,8085,18362,4,13.2,22129,5883,16246,2.9,11.1,4318,2.1,22.2,0,590,590,3497
2004,30460,8732,10412,208578,205414,1141,11.1,885,8.6,30872,11770,19102,5.7,15,24544,7829,16715,3.8,11.9,6328,3.1,23.8,0,594,596,3762
2005,30460,8873,10574,207540,207607,1141,10.9,887,8.5,28273,10486,17787,5.1,13.6,28407,11567,16840,5.6,13.7,-134,-0.1,27.2,0,611,611,8346
2006,30460,8952,10745,213501,210203,1168,11,923,8.7,30800,8931,21869,4.2,14.7,24203,8542,15661,4.1,11.5,6597,3.2,23,0,631,631,4907
2007,30460,9068,10926,215951,214525,1184,10.9,968,8.9,32848,11939,20909,5.6,15.3,29995,7815,22180,3.6,14,2853,1.3,28,0,642,645,3906
2008,30460,9057,10950,213108,213771,1056,9.7,933,8.6,28004,10955,17049,5.1,13.1,29330,8780,20550,4.1,13.7,-1326,-0.6,26.2,0,673,673,5231
2009,30460,8910,10813,203121,207135,919,8.5,982,9.1,22839,8038,14801,3.9,11,30866,6853,24013,3.3,14.9,-8027,-3.9,22,0,692,697,4044
2010,30460,8804,10728,198546,200372,940,8.8,951,8.9,22207,7484,14723,3.7,11.1,25859,7101,18758,3.5,12.9,-3652,-1.8,22.2,0,636,636,3677
2011,30460,8652,10561,193889,195808,827,7.8,905,8.5,21064,6849,14215,3.5,10.8,24902,8500,16402,4.3,12.7,-3838,-1.9,21.6,0,610,610,3623
2012,30460,8720,10666,203320,198457,980,9.2,885,8.4,30186,7759,22427,3.9,15.2,20460,5771,14689,2.9,10.3,9726,4.9,20.6,0,538,541,2801
2013,30460,8938,10897,210296,206591,1017,9.5,768,7.1,26762,9650,17112,4.7,13,19352,4769,14583,2.3,9.4,7410,3.6,18.8,0,490,490,2795
2014,30460,9034,11037,216255,212863,1091,10,862,7.9,32545,11194,21351,5.3,15.3,25760,6807,18953,3.2,12.1,6785,3.2,24.2,0,594,594,3441
1977,30620,2044,2284,41102,40121,322,14.3,259,11.5,6755,4027,2728,10,16.8,4792,1906,2886,4.8,11.9,1963,4.9,23.8,0,170,170,1170
1978,30620,2060,2310,42957,42026,259,11.3,231,10.1,6527,1702,4825,4,15.5,4665,1502,3163,3.6,11.1,1862,4.4,22.2,0,165,166,840
1979,30620,2090,2336,46588,44758,260,11.2,227,9.8,8087,1981,6106,4.4,18.1,4426,1993,2433,4.5,9.9,3661,8.2,19.8,0,148,149,601
1980,30620,2093,2354,43578,45174,259,11,239,10.2,4679,1649,3030,3.7,10.4,7871,1584,6287,3.5,17.4,-3192,-7,20.8,0,161,162,955
1981,30620,2022,2266,39891,41089,207,9,271,11.8,5342,1600,3742,3.9,13,7737,3464,4273,8.4,18.8,-2395,-5.8,26,0,143,143,709
1982,30620,2014,2281,36222,38028,269,11.8,224,9.8,3893,2204,1689,5.8,10.2,7505,1490,6015,3.9,19.7,-3612,-9.5,20.4,0,117,117,599
1983,30620,1994,2231,37578,36912,166,7.4,245,10.9,6429,3844,2585,10.4,17.4,5097,1504,3593,4.1,13.8,1332,3.6,27.6,0,143,146,770
1984,30620,2053,2306,40305,38924,240,10.6,164,7.2,5804,1586,4218,4.1,14.9,3041,857,2184,2.2,7.8,2763,7.1,15.6,0,97,97,454
1985,30620,2085,2323,43478,41899,227,9.8,213,9.2,7311,1679,5632,4,17.4,4152,1555,2597,3.7,9.9,3159,7.5,19.8,0,120,120,719
1986,30620,2123,2356,44504,43971,246,10.5,205,8.8,6229,1829,4400,4.2,14.2,5163,1379,3784,3.1,11.7,1066,2.5,23.4,0,107,107,422
1987,30620,2198,2443,45493,45105,316,13.2,224,9.3,6266,2222,4044,4.9,13.9,5489,1707,3782,3.8,12.2,777,1.7,24.4,0,135,137,626
1988,30620,2188,2439,46153,45723,248,10.2,253,10.4,6811,2540,4271,5.6,14.9,5950,2085,3865,4.6,13,861,1.9,26,0,151,151,668
1989,30620,2219,2498,48549,47429,257,10.4,202,8.2,7697,2517,5180,5.3,16.2,5456,1698,3758,3.6,11.5,2241,4.7,23,0,143,143,1248
1990,30620,2221,2512,47036,47713,220,8.8,205,8.2,5011,1521,3490,3.2,10.5,6365,1596,4769,3.3,13.3,-1354,-2.8,21,0,157,157,1153
1991,30620,2183,2471,44716,45911,206,8.3,237,9.5,4688,1532,3156,3.3,10.2,7078,1676,5402,3.7,15.4,-2390,-5.2,20.4,0,155,155,1055
1992,30620,2200,2506,45011,44889,244,9.8,205,8.2,5555,1887,3668,4.2,12.4,5311,1481,3830,3.3,11.8,244,0.6,23.6,0,123,129,1011
1993,30620,2220,2508,45902,45444,204,8.1,197,7.9,6336,2349,3987,5.2,13.9,5420,2157,3263,4.7,11.9,916,2,23.8,0,119,122,832
1994,30620,2256,2529,46166,45928,229,9.1,192,7.6,5847,2396,3451,5.2,12.7,5370,1490,3880,3.2,11.7,477,1,23.4,0,126,126,795
1995,30620,2292,2568,47625,46878,229,9,185,7.3,5948,2265,3683,4.8,12.7,4453,955,3498,2,9.5,1495,3.2,19,0,115,115,441
1996,30620,2328,2602,48176,47866,237,9.2,198,7.7,7327,1585,5742,3.3,15.3,6706,1689,5017,3.5,14,621,1.3,28,0,133,133,763
1997,30620,2331,2601,47537,47908,260,10,263,10.1,7023,2258,4765,4.7,14.7,7765,2798,4967,5.8,16.2,-742,-1.5,29.4,0,144,144,574
1998,30620,2329,2594,47990,47813,215,8.3,217,8.4,6491,1828,4663,3.8,13.6,6136,1922,4214,4,12.8,355,0.8,25.6,0,150,150,843
1999,30620,2309,2585,49789,48886,188,7.3,192,7.4,6263,2246,4017,4.6,12.8,4457,1174,3283,2.4,9.1,1806,3.7,18.2,0,127,127,528
2000,30620,2314,2596,51090,50435,215,8.3,204,7.9,7246,2144,5102,4.3,14.4,5935,2283,3652,4.5,11.8,1311,2.6,23.6,0,125,125,738
2001,30620,2343,2630,49922,50547,235,9,217,8.3,5805,2514,3291,5,11.5,7054,1573,5481,3.1,14,-1249,-2.5,23,0,111,111,667
2002,30620,2326,2620,47870,48862,265,10.1,276,10.5,6292,2577,3715,5.3,12.9,8275,3225,5050,6.6,16.9,-1983,-4,25.8,0,130,135,1079
2003,30620,2264,2562,48793,48087,205,7.9,232,9,6303,2008,4295,4.2,13.1,4891,1616,3275,3.4,10.2,1412,2.9,20.4,0,145,145,890
2004,30620,2275,2569,49659,49122,232,9.1,194,7.6,5665,1866,3799,3.8,11.5,4590,980,3610,2,9.3,1075,2.2,18.6,0,127,127,683
2005,30620,2267,2555,51190,50393,195,7.6,195,7.6,6322,2261,4061,4.5,12.5,4728,849,3879,1.7,9.4,1594,3.1,18.8,0,118,118,420
2006,30620,2219,2524,51321,51123,217,8.6,223,8.8,6979,3213,3766,6.3,13.7,6582,2323,4259,4.5,12.9,397,0.8,25.8,0,140,140,1605
2007,30620,2216,2530,50196,50717,195,7.7,200,7.9,5797,2200,3597,4.3,11.4,6838,2790,4048,5.5,13.5,-1041,-2.1,22.8,0,130,132,1829
2008,30620,2164,2480,48363,48822,143,5.7,176,7.1,4832,1708,3124,3.5,9.9,5749,1471,4278,3,11.8,-917,-1.9,19.8,0,113,113,1032
2009,30620,2099,2417,46402,47252,139,5.7,181,7.4,4051,1226,2825,2.6,8.6,5751,1055,4696,2.2,12.2,-1700,-3.6,17.2,0,127,127,544
2010,30620,2075,2394,45688,45853,138,5.8,142,5.9,4883,1853,3030,4,10.6,5213,1708,3505,3.7,11.4,-330,-0.8,21.2,0,89,89,1422
2011,30620,2042,2358,45490,45460,140,5.9,160,6.8,4687,1108,3579,2.4,10.3,4627,721,3906,1.6,10.2,60,0.1,20.4,0,98,98,474
2012,30620,2023,2335,46386,45891,168,7.2,188,8,6148,2504,3644,5.5,13.4,5157,1147,4010,2.5,11.2,991,2.2,22.4,0,112,114,523
2013,30620,1979,2288,46269,46293,130,5.6,174,7.6,4706,1295,3411,2.8,10.2,4753,1648,3105,3.6,10.3,-47,-0.1,20.4,0,111,111,709
2014,30620,1962,2269,44366,44636,141,6.2,135,6,4418,1212,3206,2.7,9.9,4958,1015,3943,2.3,11.1,-540,-1.2,19.8,0,96,96,562
1977,30700,3900,4276,68449,66767,713,17.1,473,11.4,14112,6111,8001,9.2,21.1,10747,4583,6164,6.9,16.1,3365,5,32.2,0,323,325,3138
1978,30700,4078,4472,82141,75284,662,15.1,462,10.6,23774,4696,19078,6.2,31.6,10060,3813,6247,5.1,13.4,13714,18.2,26.8,0,321,328,2054
1979,30700,4164,4557,73749,77818,596,13.2,483,10.7,11907,3897,8010,5,15.3,20044,3147,16897,4,25.8,-8137,-10.5,30.6,0,326,326,1589
1980,30700,4178,4571,73310,73497,568,12.4,544,11.9,11077,4920,6157,6.7,15.1,11451,4633,6818,6.3,15.6,-374,-0.5,30.2,0,394,394,2668
1981,30700,4028,4417,71434,71702,547,12.2,656,14.6,11014,4466,6548,6.2,15.4,11550,4371,7179,6.1,16.1,-536,-0.7,30.8,0,389,389,1769
1982,30700,4028,4487,70665,71004,632,14.2,490,11,10283,4884,5399,6.9,14.5,10961,2860,8101,4,15.4,-678,-0.9,29,0,291,292,1549
1983,30700,4162,4618,72404,71623,509,11.2,438,9.6,11333,3665,7668,5.1,15.8,9770,3675,6095,5.1,13.6,1563,2.2,27.2,0,276,276,1475
1984,30700,4183,4648,73692,73041,555,12,526,11.4,13542,5013,8529,6.9,18.5,12240,4560,7680,6.2,16.8,1302,1.7,33.6,0,315,315,1990
1985,30700,4393,4849,78171,76642,682,14.3,503,10.6,12808,5073,7735,6.6,16.7,9749,4117,5632,5.4,12.7,3059,4,25.4,0,323,323,1875
1986,30700,4479,4975,80712,79402,640,13,496,10.1,13140,6326,6814,8,16.5,10520,4061,6459,5.1,13.2,2620,3.3,26.4,0,359,359,2321
1987,30700,4554,5067,85439,83913,632,12.6,515,10.2,13975,5099,8876,6.1,16.7,10922,5075,5847,6,13,3053,3.7,26,0,326,328,2361
1988,30700,4578,5134,88645,86300,616,12.1,504,9.9,15601,6336,9265,7.3,18.1,10910,5353,5557,6.2,12.6,4691,5.5,25.2,0,331,331,1683
1989,30700,4663,5248,92512,90534,618,11.9,502,9.7,17066,6586,10480,7.3,18.9,13110,5198,7912,5.7,14.5,3956,4.4,29,0,327,327,2176
1990,30700,4761,5393,96302,94358,580,10.9,409,7.7,13849,4817,9032,5.1,14.7,9961,2969,6992,3.1,10.6,3888,4.1,21.2,0,269,269,1480
1991,30700,4868,5547,97460,96905,608,11.1,458,8.4,12703,4381,8322,4.5,13.1,11592,4584,7008,4.7,12,1111,1.1,24,0,300,303,2944
1992,30700,4984,5663,98462,97950,658,11.7,519,9.3,14357,5284,9073,5.4,14.7,13332,4678,8654,4.8,13.6,1025,1.1,27.2,0,334,337,2390
1993,30700,5109,5794,101153,99807,601,10.5,457,8,13456,4294,9162,4.3,13.5,10764,2936,7828,2.9,10.8,2692,2.7,21.6,0,306,306,1741
1994,30700,5239,5967,105033,103099,697,11.9,501,8.5,16333,6180,10153,6,15.8,12464,5417,7047,5.3,12.1,3869,3.7,24.2,0,353,353,2183
1995,30700,5325,6078,110876,107867,626,10.4,490,8.1,16374,5606,10768,5.2,15.2,10356,3180,7176,2.9,9.6,6018,5.6,19.2,0,340,341,1906
1996,30700,5361,6130,114969,112934,637,10.4,577,9.5,16832,4793,12039,4.2,14.9,12762,3944,8818,3.5,11.3,4070,3.6,22.6,0,406,406,1768
1997,30700,5465,6271,118959,117076,688,11.1,551,8.9,18047,6993,11054,6,15.4,14280,4723,9557,4,12.2,3767,3.2,24.4,0,374,374,2570
1998,30700,5509,6328,118954,118325,656,10.4,587,9.3,16293,5740,10553,4.9,13.8,15035,5512,9523,4.7,12.7,1258,1.1,25.4,0,406,406,2819
1999,30700,5663,6508,122137,120097,707,11,512,8,16468,4743,11725,3.9,13.7,12387,4584,7803,3.8,10.3,4081,3.4,20.6,0,312,312,2157
2000,30700,5759,6631,130838,127811,725,11,600,9.1,20465,8100,12365,6.3,16,14410,6310,8100,4.9,11.3,6055,4.7,22.6,0,341,341,2099
2001,30700,5805,6737,133423,132258,730,10.9,686,10.2,19190,8768,10422,6.6,14.5,16859,5672,11187,4.3,12.7,2331,1.8,25.4,0,366,366,2123
2002,30700,5930,6908,130619,131147,861,12.6,674,9.9,19788,7351,12437,5.6,15.1,20843,6678,14165,5.1,15.9,-1055,-0.8,30.2,0,357,357,2903
2003,30700,6028,7077,133629,131544,759,10.9,508,7.3,20198,6550,13648,5,15.4,16028,4071,11957,3.1,12.2,4170,3.2,24.4,0,329,329,1774
2004,30700,6160,7202,137102,134772,770,10.8,581,8.2,18713,6436,12277,4.8,13.9,14055,3916,10139,2.9,10.4,4658,3.5,20.8,0,377,383,2245
2005,30700,6272,7351,135103,135849,783,10.8,574,7.9,15422,5101,10321,3.8,11.4,16915,4425,12490,3.3,12.5,-1493,-1.1,22.8,0,405,406,2401
2006,30700,6311,7417,136514,135720,741,10.1,629,8.5,19097,8192,10905,6,14.1,17511,5419,12092,4,12.9,1586,1.2,25.8,0,361,361,2450
2007,30700,6375,7498,139082,137579,771,10.4,658,8.8,21372,6144,15228,4.5,15.5,18367,5318,13049,3.9,13.4,3005,2.1,26.8,0,396,396,2396
2008,30700,6358,7502,137677,137882,641,8.6,570,7.6,15540,4619,10921,3.3,11.3,15950,3685,12265,2.7,11.6,-410,-0.3,22.6,0,380,380,2295
2009,30700,6273,7412,134898,136049,575,7.7,617,8.3,14994,4826,10168,3.5,11,17295,4820,12475,3.5,12.7,-2301,-1.7,22,0,395,395,2610
2010,30700,6260,7397,132510,133308,569,7.7,544,7.4,15071,4781,10290,3.6,11.3,16666,3962,12704,3,12.5,-1595,-1.2,22.6,0,314,314,2146
2011,30700,6270,7451,132391,132011,662,8.9,566,7.6,15764,6538,9226,5,11.9,15004,2957,12047,2.2,11.4,760,0.5,22.8,0,363,363,1726
2012,30700,6380,7579,138984,135650,667,8.9,541,7.2,22000,8459,13541,6.2,16.2,15331,3708,11623,2.7,11.3,6669,4.9,22.6,0,323,324,1850
2013,30700,6399,7612,134407,136572,639,8.4,603,8,15528,4290,11238,3.1,11.4,19857,4777,15080,3.5,14.5,-4329,-3.1,22.8,0,365,368,2338
2014,30700,6529,7738,134025,133938,672,8.8,502,6.6,14025,4075,9950,3,10.5,13850,5300,8550,4,10.3,175,0.2,20.6,0,332,334,2204
1977,30780,8319,9533,147026,143905,1737,18.7,1199,12.9,28029,11237,16792,7.8,19.5,21786,8708,13078,6.1,15.1,6243,4.4,30.2,0,853,857,5232
1978,30780,7924,9134,155007,150968,1355,14.5,1649,17.7,30197,9381,20816,6.2,20,22119,12299,9820,8.1,14.7,8078,5.3,29.4,0,1022,1023,5561
1979,30780,8533,9735,165634,160441,1407,14.9,856,9.1,31251,10616,20635,6.6,19.5,20865,6217,14648,3.9,13,10386,6.5,26,0,16,21,453
1980,30780,8698,9908,168153,166763,1378,14,1158,11.8,28515,9650,18865,5.8,17.1,25735,8680,17055,5.2,15.4,2780,1.7,30.8,0,821,822,4558
1981,30780,8458,9640,159266,161652,1305,13.4,1410,14.5,25458,11216,14242,6.9,15.7,30229,10758,19471,6.7,18.7,-4771,-3,31.4,0,867,871,5355
1982,30780,8585,9904,161426,159961,1513,15.5,1158,11.8,29370,11102,18268,6.9,18.4,26440,7716,18724,4.8,16.5,2930,1.9,33,0,627,628,3153
1983,30780,8950,10234,160489,159707,1376,13.7,1130,11.2,27947,11263,16684,7.1,17.5,26382,7093,19289,4.4,16.5,1565,1,33,0,759,759,3901
1984,30780,9449,10816,170018,164376,1716,16.3,1130,10.7,33568,13071,20497,8,20.4,22284,8304,13980,5.1,13.6,11284,6.8,27.2,0,736,737,3889
1985,30780,9730,11112,181869,177947,1529,13.9,1270,11.6,32183,10716,21467,6,18.1,24338,10459,13879,5.9,13.7,7845,4.4,27.4,0,871,881,5525
1986,30780,10046,11453,197742,189703,1648,14.6,1267,11.2,44158,13853,30305,7.3,23.3,28079,9877,18202,5.2,14.8,16079,8.5,29.6,0,872,882,5184
1987,30780,10243,11713,194555,198846,1814,15.6,1499,12.9,32888,13145,19743,6.6,16.5,41469,17316,24153,8.7,20.9,-8581,-4.4,33,0,973,983,8587
1988,30780,10178,11744,194388,191927,1624,13.9,1438,12.3,35936,14526,21410,7.6,18.7,31014,12832,18182,6.7,16.2,4922,2.5,32.4,0,950,950,5263
1989,30780,10276,11988,204102,199857,1585,13.4,1390,11.7,38356,17475,20881,8.7,19.2,29866,10841,19025,5.4,14.9,8490,4.3,29.8,0,977,993,7075
1990,30780,10481,12235,214996,209390,1558,12.9,1237,10.2,39795,13659,26136,6.5,19,28583,9461,19122,4.5,13.7,11212,5.3,27.4,0,842,842,5203
1991,30780,10739,12590,219768,217353,1638,13.2,1308,10.5,36410,16414,19996,7.6,16.8,31579,9992,21587,4.6,14.5,4831,2.3,29,0,808,811,5130
1992,30780,10876,12759,224065,221961,1613,12.7,1391,11,39412,14422,24990,6.5,17.8,35203,11547,23656,5.2,15.9,4209,1.9,31.8,0,918,938,6036
1993,30780,11153,12983,231043,227439,1471,11.4,1221,9.5,37367,10135,27232,4.5,16.4,30158,9426,20732,4.1,13.3,7209,3.1,26.6,0,832,839,4923
1994,30780,11400,13255,235317,232864,1643,12.5,1312,10,39514,17259,22255,7.4,17,34607,13545,21062,5.8,14.9,4907,2.1,29.8,0,892,892,7582
1995,30780,11697,13648,250754,242911,1745,13,1328,9.9,46744,15727,31017,6.5,19.2,31059,13027,18032,5.4,12.8,15685,6.4,25.6,0,921,922,5275
1996,30780,11915,13878,259480,255075,1747,12.7,1496,10.9,42728,14274,28454,5.6,16.8,33918,11294,22624,4.4,13.3,8810,3.5,26.6,0,1011,1011,6507
1997,30780,11947,14019,260909,260514,1776,12.7,1636,11.7,42818,15513,27305,6,16.4,42027,14829,27198,5.7,16.1,791,0.3,32.2,0,1016,1016,6887
1998,30780,12000,14089,268551,264527,1698,12.1,1576,11.2,47230,18846,28384,7.1,17.9,39182,13778,25404,5.2,14.8,8048,3.1,29.6,0,1013,1013,6309
1999,30780,12103,14273,273906,271123,1718,12.1,1514,10.7,45844,14430,31414,5.3,16.9,40277,16916,23361,6.2,14.9,5567,2,29.8,0,983,983,5965
2000,30780,12067,14297,283024,278704,1639,11.5,1621,11.3,44565,16998,27567,6.1,16,35924,13058,22866,4.7,12.9,8641,3.1,25.8,0,974,974,5703
2001,30780,12121,14464,284246,284031,1653,11.5,1600,11.1,42789,14917,27872,5.3,15.1,42358,14480,27878,5.1,14.9,431,0.2,29.8,0,923,924,6806
2002,30780,12282,14714,275593,279551,1914,13.1,1646,11.3,48118,19433,28685,7,17.2,56034,26115,29919,9.3,20,-7916,-2.8,34.4,0,878,879,4653
2003,30780,12471,14986,272653,271137,1759,11.9,1258,8.5,38771,13406,25365,4.9,14.3,35738,10466,25272,3.9,13.2,3033,1.1,26.4,0,892,892,5549
2004,30780,12658,15225,278142,274188,1713,11.4,1343,8.9,40597,12554,28043,4.6,14.8,32689,10242,22447,3.7,11.9,7908,2.9,23.8,0,928,928,5047
2005,30780,12840,15498,284314,280455,1756,11.5,1347,8.8,40881,17187,23694,6.1,14.6,33162,9019,24143,3.2,11.8,7719,2.8,23.6,0,926,928,5648
2006,30780,13033,15840,292618,287571,1910,12.2,1434,9.2,44409,18202,26207,6.3,15.4,34314,9943,24371,3.5,11.9,10095,3.5,23.8,0,1002,1002,6885
2007,30780,13228,16198,295439,293226,1858,11.6,1445,9,48029,16159,31870,5.5,16.4,43604,15765,27839,5.4,14.9,4425,1.5,29.8,0,910,921,6418
2008,30780,13194,16152,294864,293997,1560,9.7,1452,9,35096,12042,23054,4.1,11.9,33363,9348,24015,3.2,11.3,1733,0.6,22.6,0,977,977,6588
2009,30780,12991,15947,274637,284114,1463,9.1,1537,9.6,29531,11310,18221,4,10.4,48487,12655,35832,4.5,17.1,-18956,-6.7,20.8,0,1033,1034,5471
2010,30780,12842,15813,275217,273516,1392,8.8,1421,9,34980,13503,21477,4.9,12.8,31578,8988,22590,3.3,11.5,3402,1.3,23,0,935,938,6222
2011,30780,12872,15870,278068,276002,1439,9.1,1286,8.1,33384,12245,21139,4.4,12.1,29252,7490,21762,2.7,10.6,4132,1.5,21.2,0,852,852,4708
2012,30780,12966,15977,271147,274295,1491,9.4,1389,8.7,33694,9812,23882,3.6,12.3,39990,11849,28141,4.3,14.6,-6296,-2.3,24.6,0,860,877,5861
2013,30780,12985,16041,273912,272017,1431,9,1357,8.5,32979,10548,22431,3.9,12.1,29188,9545,19643,3.5,10.7,3791,1.4,21.4,0,883,891,5242
2014,30780,12902,15994,275159,273243,1386,8.7,1329,8.3,32927,11431,21496,4.2,12.1,29095,9530,19565,3.5,10.6,3832,1.5,21.2,0,946,956,6210
1977,30860,1012,1057,11969,11362,223,22,131,12.9,3072,1617,1455,14.2,27,1858,921,937,8.1,16.4,1214,10.6,32.8,0,94,94,436
1978,30860,969,1014,13004,12461,163,15.7,193,18.6,3130,1018,2112,8.2,25.1,2044,1284,760,10.3,16.4,1086,8.7,32.8,0,102,103,706
1979,30860,1075,1117,13526,13275,166,15.6,70,6.6,2493,898,1595,6.8,18.8,1990,565,1425,4.3,15,503,3.8,30,1,1,1,
1980,30860,1081,1118,13511,13514,153,13.7,149,13.3,2047,604,1443,4.5,15.1,2053,738,1315,5.5,15.2,-6,-0.1,30.2,0,99,101,479
1981,30860,1020,1059,13484,13286,145,13.3,182,16.8,2758,1229,1529,9.3,20.8,2362,897,1465,6.8,17.8,396,3,35.6,0,112,112,604
1982,30860,1032,1086,13340,13446,200,18.6,165,15.4,2562,1424,1138,10.6,19.1,2774,1350,1424,10,20.6,-212,-1.5,38.2,0,101,101,524
1983,30860,1073,1131,14419,13882,145,13.1,114,10.3,2664,985,1679,7.1,19.2,1590,545,1045,3.9,11.5,1074,7.7,23,0,78,78,281
1984,30860,1087,1143,14685,14545,146,12.8,132,11.6,2541,957,1584,6.6,17.5,2261,1065,1196,7.3,15.5,280,2,31,0,80,80,648
1985,30860,1055,1109,14676,14692,132,11.7,163,14.5,2116,717,1399,4.9,14.4,2147,961,1186,6.5,14.6,-31,-0.2,28.8,0,115,115,530
1986,30860,1099,1160,15932,15300,168,14.8,115,10.1,3160,1168,1992,7.6,20.7,1896,819,1077,5.4,12.4,1264,8.3,24.8,0,90,90,456
1987,30860,1112,1171,16509,16210,160,13.7,140,12,3232,1071,2161,6.6,19.9,2634,1087,1547,6.7,16.2,598,3.7,32.4,0,87,87,472
1988,30860,1106,1173,17139,16753,161,13.7,147,12.6,3279,1228,2051,7.3,19.6,2507,1266,1241,7.6,15,772,4.6,30,0,106,106,970
1989,30860,1135,1209,19953,18591,152,12.8,116,9.7,4714,1984,2730,10.7,25.4,1990,1095,895,5.9,10.7,2724,14.7,21.4,0,75,78,922
1990,30860,1159,1238,20109,20003,155,12.7,123,10.1,3355,896,2459,4.5,16.8,3143,1257,1886,6.3,15.7,212,1.1,31.4,0,88,89,628
1991,30860,1232,1309,19696,19912,172,13.5,100,7.9,3415,1450,1965,7.3,17.2,3846,1020,2826,5.1,19.3,-431,-2.1,34.4,0,68,68,612
1992,30860,1277,1360,22656,21173,194,14.5,141,10.5,5650,3405,2245,16.1,26.7,2684,972,1712,4.6,12.7,2966,14,25.4,0,100,100,594
1993,30860,1337,1415,24285,23451,191,13.8,130,9.4,3854,1321,2533,5.6,16.4,2185,719,1466,3.1,9.3,1669,7.1,18.6,0,93,93,489
1994,30860,1431,1505,24900,24593,241,16.5,155,10.6,3706,1377,2329,5.6,15.1,3092,1354,1738,5.5,12.6,614,2.5,25.2,0,107,108,911
1995,30860,1519,1608,29523,27188,255,16.4,144,9.3,7269,4585,2684,16.9,26.7,2598,922,1676,3.4,9.6,4671,17.1,19.2,0,96,97,679
1996,30860,1644,1741,29323,29442,298,17.8,165,9.9,5163,2152,3011,7.3,17.5,5400,1820,3580,6.2,18.3,-237,-0.8,35,0,106,106,609
1997,30860,1745,1845,27241,28258,321,17.9,205,11.4,5680,2202,3478,7.8,20.1,7714,6003,1711,21.2,27.3,-2034,-7.2,40.2,0,129,129,831
1998,30860,1797,1905,32087,29689,295,15.7,233,12.4,8708,6256,2452,21.1,29.3,3912,1837,2075,6.2,13.2,4796,16.1,26.4,0,161,161,904
1999,30860,1919,2029,31586,31923,327,16.6,201,10.2,4536,1970,2566,6.2,14.2,5210,1014,4196,3.2,16.3,-674,-2.1,28.4,0,141,141,686
2000,30860,1940,2056,32702,32145,281,13.8,250,12.2,5498,1892,3606,5.9,17.1,4384,1382,3002,4.3,13.6,1114,3.5,27.2,0,151,151,709
2001,30860,1996,2125,34182,33519,314,15,262,12.5,5596,2129,3467,6.4,16.7,4269,1187,3082,3.5,12.7,1327,4,25.4,0,165,165,740
2002,30860,2074,2202,34622,34405,362,16.7,284,13.1,5233,2267,2966,6.6,15.2,4798,1528,3270,4.4,13.9,435,1.3,27.8,0,161,161,830
2003,30860,2167,2298,35322,34740,333,14.9,208,9.3,5652,1946,3706,5.6,16.3,4487,1607,2880,4.6,12.9,1165,3.4,25.8,0,131,133,934
2004,30860,2279,2413,36513,35911,351,14.9,226,9.6,5529,2344,3185,6.5,15.4,4325,1149,3176,3.2,12,1204,3.4,24,0,133,133,707
2005,30860,2368,2508,36735,36569,344,14,225,9.2,5832,2765,3067,7.6,15.9,5499,2691,2808,7.4,15,333,0.9,30,0,142,142,1640
2006,30860,2474,2619,39077,37866,394,15.4,265,10.3,6693,2001,4692,5.3,17.7,4270,1369,2901,3.6,11.3,2423,6.4,22.6,0,161,161,850
2007,30860,2650,2803,39950,39544,416,15.3,256,9.4,6445,2381,4064,6,16.3,5632,1807,3825,4.6,14.2,813,2.1,28.4,0,167,167,988
2008,30860,2647,2805,41717,40776,331,11.8,310,11.1,6660,1588,5072,3.9,16.3,4777,1615,3162,4,11.7,1883,4.6,23.4,0,200,200,759
2009,30860,2598,2774,40180,40777,308,11.1,313,11.2,4912,1689,3223,4.1,12,6105,1252,4853,3.1,15,-1193,-3,24,0,188,188,863
2010,30860,2589,2768,39417,39461,308,11.1,297,10.7,5770,2476,3294,6.3,14.6,5857,3200,2657,8.1,14.8,-87,-0.2,29.2,0,188,188,1681
2011,30860,2542,2724,38540,38942,269,9.8,308,11.2,4271,1211,3060,3.1,11,5075,1852,3223,4.8,13,-804,-2,22,0,183,183,1197
2012,30860,2560,2746,40756,39636,290,10.6,268,9.8,6495,1746,4749,4.4,16.4,4255,1344,2911,3.4,10.7,2240,5.7,21.4,0,164,164,949
2013,30860,2568,2750,40808,40786,260,9.5,264,9.6,4843,1136,3707,2.8,11.9,4799,1233,3566,3,11.8,44,0.1,23.6,0,160,160,830
2014,30860,2595,2769,41614,41129,308,11.2,276,10,5001,1632,3369,4,12.2,4031,1199,2832,2.9,9.8,970,2.4,19.6,0,185,185,769
1977,30980,3325,3577,45071,43612,677,19.6,438,12.7,9175,3562,5613,8.2,21,6257,2898,3359,6.6,14.3,2918,6.7,28.6,0,317,320,1959
1978,30980,3195,3470,48929,46869,580,16.5,641,18.2,11441,4502,6939,9.6,24.4,7320,3693,3627,7.9,15.6,4121,8.8,31.2,0,391,391,1933
1979,30980,3542,3829,54777,51890,620,17,289,7.9,13108,5150,7958,9.9,25.3,7334,2826,4508,5.4,14.1,5774,11.2,28.2,1,3,3,
1980,30980,3648,3927,56807,55704,633,16.3,507,13.1,12146,5202,6944,9.3,21.8,9939,3424,6515,6.1,17.8,2207,4,35.6,0,367,367,2424
1981,30980,3680,3946,57258,56621,644,16.4,581,14.8,11494,4876,6618,8.6,20.3,10220,4919,5301,8.7,18,1274,2.3,36,0,362,363,2360
1982,30980,3829,4165,61516,59407,753,18.5,498,12.3,14745,7115,7630,12,24.8,10527,4331,6196,7.3,17.7,4218,7.1,35.4,0,303,304,2013
1983,30980,3934,4287,57706,59307,631,14.9,536,12.7,10818,5303,5515,8.9,18.2,14019,3919,10100,6.6,23.6,-3201,-5.4,36.4,0,402,402,2759
1984,30980,3986,4352,56902,57215,664,15.4,593,13.7,9822,4401,5421,7.7,17.2,10448,4249,6199,7.4,18.3,-626,-1.1,34.4,0,421,421,2275
1985,30980,4043,4421,58444,57697,664,15.1,577,13.2,9706,4525,5181,7.8,16.8,8211,3091,5120,5.4,14.2,1495,2.6,28.4,0,407,407,2016
1986,30980,4031,4397,59942,59280,605,13.7,614,13.9,11236,4082,7154,6.9,19,9912,4050,5862,6.8,16.7,1324,2.3,33.4,0,423,424,2406
1987,30980,3934,4318,55592,57749,610,14,672,15.4,8709,4348,4361,7.5,15.1,13022,4723,8299,8.2,22.5,-4313,-7.4,30.2,0,463,467,2772
1988,30980,3890,4295,55281,55140,586,13.6,588,13.7,9364,3713,5651,6.7,17,9081,3799,5282,6.9,16.5,283,0.5,33,0,433,433,2115
1989,30980,3845,4252,57534,56740,497,11.6,541,12.7,9486,3229,6257,5.7,16.7,7898,3436,4462,6.1,13.9,1588,2.8,27.8,0,391,393,2381
1990,30980,3850,4265,60294,58893,473,11.1,454,10.7,11101,3801,7300,6.5,18.8,8298,3430,4868,5.8,14.1,2803,4.7,28.2,0,320,322,2267
1991,30980,3935,4374,60169,60414,557,12.9,455,10.5,9824,3341,6483,5.5,16.3,10314,3576,6738,5.9,17.1,-490,-0.8,32.6,0,322,322,2715
1992,30980,3919,4382,60470,60256,505,11.5,474,10.8,9289,3236,6053,5.4,15.4,8861,3412,5449,5.7,14.7,428,0.7,29.4,0,310,310,2030
1993,30980,3955,4426,62408,61352,486,11,424,9.6,10668,3813,6855,6.2,17.4,8555,2819,5736,4.6,13.9,2113,3.5,27.8,0,293,293,1499
1994,30980,4037,4530,63638,63017,521,11.6,423,9.4,10118,3522,6596,5.6,16.1,8876,2955,5921,4.7,14.1,1242,2,28.2,0,297,297,1854
1995,30980,4100,4619,66737,65158,519,11.3,407,8.9,11271,4761,6510,7.3,17.3,8112,2833,5279,4.3,12.4,3159,4.9,24.8,0,281,285,1555
1996,30980,4145,4670,68001,67378,518,11.2,462,10,10531,4395,6136,6.5,15.6,9285,2776,6509,4.1,13.8,1246,1.8,27.6,0,347,347,1952
1997,30980,4138,4708,70592,69335,580,12.4,532,11.3,11956,4503,7453,6.5,17.2,9441,3657,5784,5.3,13.6,2515,3.6,27.2,0,351,351,1909
1998,30980,4127,4654,71687,71059,524,11.2,566,12.1,11810,4318,7492,6.1,16.6,10554,4975,5579,7,14.9,1256,1.7,29.8,0,352,352,2268
1999,30980,4094,4651,70064,71017,541,11.6,538,11.6,9898,4188,5710,5.9,13.9,11805,4605,7200,6.5,16.6,-1907,-2.7,27.8,0,348,348,2233
2000,30980,4063,4634,71129,70607,508,10.9,524,11.3,10215,3851,6364,5.5,14.5,9172,3121,6051,4.4,13,1043,1.5,26,0,306,306,1349
2001,30980,4089,4667,72777,72101,479,10.3,481,10.3,9872,3331,6541,4.6,13.7,8520,3100,5420,4.3,11.8,1352,1.9,23.6,0,290,290,1644
2002,30980,4109,4699,71914,72200,585,12.5,548,11.7,11834,4905,6929,6.8,16.4,12405,4405,8000,6.1,17.2,-571,-0.8,32.8,0,298,300,1865
2003,30980,4090,4687,72279,71574,486,10.4,415,8.9,12102,5300,6802,7.4,16.9,10691,3367,7324,4.7,14.9,1411,2,29.8,0,315,317,2227
2004,30980,4072,4672,73653,72740,469,10,435,9.3,11689,3808,7881,5.2,16.1,9862,3581,6281,4.9,13.6,1827,2.5,27.2,0,296,296,2125
2005,30980,4145,4762,75896,74786,490,10.4,371,7.9,11772,4382,7390,5.9,15.7,9551,2590,6961,3.5,12.8,2221,2.9,25.6,0,261,262,1560
2006,30980,4179,4807,80058,77819,500,10.5,414,8.7,14460,5754,8706,7.4,18.6,9981,4722,5259,6.1,12.8,4479,5.8,25.6,0,281,282,2543
2007,30980,4290,4945,82332,80847,547,11.2,395,8.1,13692,5125,8567,6.3,16.9,10722,3341,7381,4.1,13.3,2970,3.6,26.6,0,261,263,2176
2008,30980,4264,4946,85386,83642,469,9.5,402,8.2,13802,5441,8361,6.5,16.5,10314,2800,7514,3.3,12.3,3488,4.2,24.6,0,299,308,2070
2009,30980,4244,4936,82280,83699,391,7.9,376,7.6,10865,3716,7149,4.4,13,13703,2908,10795,3.5,16.4,-2838,-3.4,26,0,266,267,1607
2010,30980,4233,4958,78375,79726,403,8.2,357,7.2,8670,2760,5910,3.5,10.9,11371,2762,8609,3.5,14.3,-2701,-3.4,21.8,0,269,269,2057
2011,30980,4237,4994,82091,80116,409,8.2,354,7.1,11493,3839,7654,4.8,14.3,7544,2215,5329,2.8,9.4,3949,4.9,18.8,0,245,245,1443
2012,30980,4313,5060,85694,83866,443,8.8,381,7.6,13658,4261,9397,5.1,16.3,10002,3169,6833,3.8,11.9,3656,4.4,23.8,0,227,228,1941
2013,30980,4307,5059,87342,86706,399,7.9,389,7.7,10332,2747,7585,3.2,11.9,9059,2363,6696,2.7,10.4,1273,1.5,20.8,0,252,252,1505
2014,30980,4284,5042,87255,87043,455,9,434,8.6,10572,3766,6806,4.3,12.1,10148,3504,6644,4,11.7,424,0.4,23.4,0,303,303,2430
1977,31020,1408,1503,24614,23812,295,20.4,180,12.4,4851,1934,2917,8.1,20.4,3246,1057,2189,4.4,13.6,1605,6.8,27.2,0,118,118,601
1978,31020,1462,1564,26334,25468,271,17.7,208,13.6,4876,1429,3447,5.6,19.1,3144,1049,2095,4.1,12.3,1732,6.8,24.6,0,145,146,708
1979,31020,1483,1587,24889,25593,250,15.9,219,13.9,3931,1453,2478,5.7,15.4,5338,1341,3997,5.2,20.9,-1407,-5.5,30.8,0,174,174,1035
1980,31020,1495,1599,25306,25117,203,12.7,181,11.4,4235,1394,2841,5.6,16.9,3856,977,2879,3.9,15.4,379,1.5,30.8,0,129,129,538
1981,31020,1437,1531,24535,24390,184,11.8,219,14,3592,1252,2340,5.1,14.7,3302,1135,2167,4.7,13.5,290,1.2,27,0,128,129,598
1982,31020,1440,1546,23456,24034,248,16.1,210,13.6,3240,1777,1463,7.4,13.5,4395,997,3398,4.1,18.3,-1155,-4.8,27,0,128,128,688
1983,31020,1445,1543,23403,23463,188,12.2,207,13.4,3505,1001,2504,4.3,14.9,3624,1058,2566,4.5,15.4,-119,-0.5,29.8,0,147,147,765
1984,31020,1504,1600,23850,23553,239,15.2,176,11.2,3872,1193,2679,5.1,16.4,3277,1342,1935,5.7,13.9,595,2.5,27.8,0,117,117,609
1985,31020,1517,1613,24616,24841,216,13.4,213,13.2,3411,1489,1922,6,13.7,3861,1689,2172,6.8,15.5,-450,-1.8,27.4,0,150,150,1096
1986,31020,1528,1618,23352,23974,215,13.3,205,12.7,2986,1240,1746,5.2,12.5,4229,1341,2888,5.6,17.6,-1243,-5.1,25,0,140,140,874
1987,31020,1579,1667,25230,24232,247,15,190,11.6,4405,1334,3071,5.5,18.2,2408,913,1495,3.8,9.9,1997,8.3,19.8,0,121,121,506
1988,31020,1546,1651,25476,24711,242,14.6,228,13.8,4760,2067,2693,8.4,19.3,3229,1379,1850,5.6,13.1,1531,6.2,26.2,0,157,157,732
1989,31020,1363,1467,25189,25450,175,11.2,363,23.3,3813,1198,2615,4.7,15,4334,2773,1561,10.9,17,-521,-2,30,0,121,121,617
1990,31020,1664,1770,28308,26738,423,26.1,112,6.9,5601,3272,2329,12.2,20.9,2461,733,1728,2.7,9.2,3140,11.7,18.4,0,72,72,414
1991,31020,1724,1851,28892,28622,241,13.3,162,8.9,4354,1533,2821,5.4,15.2,3813,820,2993,2.9,13.3,541,1.9,26.6,0,101,101,593
1992,31020,1760,1890,29489,29166,226,12.1,177,9.5,4480,1350,3130,4.6,15.4,3834,969,2865,3.3,13.1,646,2.3,26.2,0,120,120,568
1993,31020,1801,1931,28934,29188,231,12.1,178,9.3,3633,975,2658,3.3,12.4,4140,1482,2658,5.1,14.2,-507,-1.8,24.8,0,111,111,826
1994,31020,1837,1959,29036,28963,231,11.9,196,10.1,4044,1296,2748,4.5,14,3898,1447,2451,5,13.5,146,0.5,27,0,141,141,627
1995,31020,1892,2019,30883,29950,275,13.8,200,10.1,5139,1796,3343,6,17.2,3272,1446,1826,4.8,10.9,1867,6.3,21.8,0,147,150,1115
1996,31020,1943,2065,31307,31094,243,11.9,200,9.8,4324,1718,2606,5.5,13.9,3897,936,2961,3,12.5,427,1.4,25,0,141,141,539
1997,31020,1953,2080,32018,31689,277,13.3,263,12.7,5826,2690,3136,8.5,18.4,5168,2421,2747,7.6,16.3,658,2.1,32.6,0,185,185,942
1998,31020,1989,2130,32319,32164,256,12.2,199,9.5,4732,1848,2884,5.7,14.7,4421,1618,2803,5,13.7,311,1,27.4,0,139,139,730
1999,31020,1959,2109,32393,32320,255,12,265,12.5,4743,1693,3050,5.2,14.7,4597,1445,3152,4.5,14.2,146,0.5,28.4,0,184,184,973
2000,31020,1931,2084,32380,32391,224,10.7,251,12,4530,1348,3182,4.2,14,4551,1738,2813,5.4,14.1,-21,-0.1,28,0,171,171,1046
2001,31020,1915,2063,32960,33122,221,10.6,260,12.5,4193,1681,2512,5.1,12.7,4517,1682,2835,5.1,13.6,-324,-0.9,25.4,0,159,159,785
2002,31020,1881,2021,31323,32058,235,11.5,266,13.1,4397,2167,2230,6.8,13.7,5866,1519,4347,4.7,18.3,-1469,-4.6,27.4,0,157,157,596
2003,31020,1913,2055,30721,30899,268,13.2,205,10.1,4080,1542,2538,5,13.2,4437,1260,3177,4.1,14.4,-357,-1.2,26.4,0,157,157,945
2004,31020,1926,2070,31147,30789,224,10.9,187,9.1,3874,1480,2394,4.8,12.6,3157,883,2274,2.9,10.3,717,2.3,20.6,0,134,134,667
2005,31020,1938,2091,31948,31528,236,11.4,202,9.7,3744,1356,2388,4.3,11.9,2903,1120,1783,3.6,9.2,841,2.7,18.4,0,149,149,817
2006,31020,1948,2113,32569,31940,251,11.9,221,10.5,5202,1946,3256,6.1,16.3,3943,1444,2499,4.5,12.3,1259,4,24.6,0,164,164,758
2007,31020,1942,2118,33149,32797,229,10.8,216,10.2,4872,1425,3447,4.3,14.9,4168,1618,2550,4.9,12.7,704,2.2,25.4,0,148,148,1164
2008,31020,1943,2121,32071,32486,216,10.2,197,9.3,4096,1316,2780,4.1,12.6,4925,1313,3612,4,15.2,-829,-2.6,25.2,0,148,148,718
2009,31020,1840,2015,30077,31057,154,7.5,244,11.8,3358,1501,1857,4.8,10.8,5317,1050,4267,3.4,17.1,-1959,-6.3,21.6,0,164,164,779
2010,31020,1826,1994,28966,29698,165,8.3,179,9,2700,658,2042,2.2,9.1,4164,1445,2719,4.9,14,-1464,-4.9,18.2,0,122,122,723
2011,31020,1766,1937,29573,28993,164,8.4,201,10.2,4045,1698,2347,5.9,14,2884,805,2079,2.8,9.9,1161,4.1,19.8,0,143,143,628
2012,31020,1781,1956,30179,30374,182,9.4,173,8.9,3299,1170,2129,3.9,10.9,3688,1219,2469,4,12.1,-389,-1.2,21.8,0,112,112,572
2013,31020,1766,1943,31123,30569,161,8.3,175,9,4010,1288,2722,4.2,13.1,2901,941,1960,3.1,9.5,1109,3.6,19,0,112,112,665
2014,31020,1746,1920,29948,30324,166,8.6,170,8.8,3573,1152,2421,3.8,11.8,4325,1168,3157,3.9,14.3,-752,-2.5,23.6,0,121,121,816
1977,31100,152903,181798,3254812,3101132,35186,19.9,25382,14.3,822433,367662,454771,11.9,26.5,515073,222602,292471,7.2,16.6,307360,9.9,33.2,0,16785,16865,120956
1978,31100,155983,185346,3416207,3331003,31343,17.1,27731,15.1,763628,253478,510150,7.6,22.9,593220,247621,345599,7.4,17.8,170408,5.1,35.6,0,17126,17215,105844
1979,31100,164514,194932,3733484,3571844,35065,18.4,24275,12.8,860892,317311,543581,8.9,24.1,537612,211605,326007,5.9,15.1,323280,9,30.2,0,16629,16708,107170
1980,31100,169269,200179,3873768,3800457,31792,16.1,25675,13,780098,292898,487200,7.7,20.5,633476,229166,404310,6,16.7,146622,3.8,33.4,0,17713,17798,121575
1981,31100,168568,198577,3882763,3870897,30881,15.5,30879,15.5,800370,312506,487864,8.1,20.7,776639,317845,458794,8.2,20.1,23731,0.6,40.2,0,18048,18136,129209
1982,31100,172372,206039,3946242,3910190,34522,17.1,25415,12.6,819229,345857,473372,8.8,21,747126,259121,488005,6.6,19.1,72103,1.9,38.2,0,13815,13824,104000
1983,31100,175096,208546,3783711,3855961,27865,13.4,26163,12.6,692543,250937,441606,6.5,18,837045,275455,561590,7.1,21.7,-144502,-3.7,36,0,16612,16690,114943
1984,31100,180301,214077,4056876,3920447,30782,14.6,25120,11.9,858515,291793,566722,7.4,21.9,585657,216195,369462,5.5,14.9,272858,7,29.8,0,15312,15388,106108
1985,31100,186438,220051,4212553,4137525,32169,14.8,26177,12.1,850659,306996,543663,7.4,20.6,700604,282662,417942,6.8,16.9,150055,3.7,33.8,0,16068,16167,132038
1986,31100,192894,227428,4370827,4290905,35562,15.9,27462,12.3,899370,356201,543169,8.3,21,739527,274288,465239,6.4,17.2,159843,3.8,34.4,0,17109,17134,128341
1987,31100,199747,236216,4510525,4464245,39297,16.9,29374,12.7,933476,351595,581881,7.9,20.9,840917,356424,484493,8,18.8,92559,2.1,37.6,0,18705,18874,154531
1988,31100,201595,239268,4663927,4575894,34431,14.5,30466,12.8,997004,348280,648724,7.6,21.8,820938,309496,511442,6.8,17.9,176066,3.9,35.8,0,19696,19696,144949
1989,31100,204177,243554,4838163,4741726,33894,14,29798,12.3,986394,364471,621923,7.7,20.8,793520,298051,495469,6.3,16.7,192874,4.1,33.4,0,19427,19555,168941
1990,31100,207963,247739,4950899,4888801,33983,13.8,27952,11.4,946281,328141,618140,6.7,19.4,822084,283737,538347,5.8,16.8,124197,2.6,33.6,0,18669,18739,151251
1991,31100,210630,252056,4761776,4853894,34517,13.8,30165,12.1,809086,316952,492134,6.5,16.7,993322,326554,666768,6.7,20.5,-184236,-3.8,33.4,0,18883,19053,175625
1992,31100,208055,250118,4594235,4673975,33568,13.4,33663,13.4,899409,401308,498101,8.6,19.2,1058889,411178,647711,8.8,22.7,-159480,-3.5,38.4,0,21845,22202,224040
1993,31100,205015,245222,4526122,4555273,28889,11.7,32203,13,836158,294990,541168,6.5,18.4,894459,326041,568418,7.2,19.6,-58301,-1.2,36.8,0,21176,21427,153032
1994,31100,204279,243630,4447354,4482785,30687,12.6,31150,12.7,757231,292620,464611,6.5,16.9,828092,313579,514513,7,18.5,-70861,-1.6,33.8,0,20360,20501,176823
1995,31100,206831,246052,4579102,4510298,32216,13.2,28603,11.7,813880,285972,527908,6.3,18,676274,243179,433095,5.4,15,137606,3,30,0,19038,19156,129134
1996,31100,209691,248867,4569614,4576464,32856,13.3,29149,11.8,801587,285772,515815,6.2,17.5,815287,323768,491519,7.1,17.8,-13700,-0.3,35,0,19406,19408,137508
1997,31100,212397,251919,4711104,4644392,35055,14,31872,12.7,957968,360916,597052,7.8,20.6,824543,318987,505556,6.9,17.8,133425,2.8,35.6,0,19660,19661,150123
1998,31100,214594,254370,4898200,4790242,33660,13.3,30373,12,937857,347094,590763,7.2,19.6,721943,292184,429759,6.1,15.1,215914,4.5,30.2,0,19991,19991,145954
1999,31100,216725,257613,4967228,4934726,33841,13.2,30226,11.8,891176,333697,557479,6.8,18.1,826172,321306,504866,6.5,16.7,65004,1.4,33.4,0,19535,19535,158986
2000,31100,219733,261400,5116243,5040867,33831,13,30213,11.6,950219,343072,607147,6.8,18.9,799467,329603,469864,6.5,15.9,150752,3,31.8,0,18751,18751,153833
2001,31100,223147,266400,5203408,5172661,34717,13.1,32004,12.1,891212,326307,564905,6.3,17.2,829719,321558,508161,6.2,16,61493,1.2,32,0,19307,19317,141293
2002,31100,226048,270066,5097230,5144140,39066,14.6,34806,13,942020,394563,547457,7.7,18.3,1035842,386461,649381,7.5,20.1,-93822,-1.8,36.6,0,19920,19969,174939
2003,31100,230545,274961,5145579,5090092,38273,14.1,28786,10.6,929066,345732,583334,6.8,18.3,818092,266168,551924,5.2,16.1,110974,2.2,32.2,0,20039,20259,153579
2004,31100,234344,278446,5240509,5167355,36627,13.3,29839,10.8,924747,360458,564289,7,17.9,778438,278320,500118,5.4,15.1,146309,2.8,30.2,0,20456,20469,158048
2005,31100,240361,285845,5266477,5239696,38955,13.8,29033,10.3,907070,365119,541951,7,17.3,853508,268782,584726,5.1,16.3,53562,1,32.6,0,20592,20637,159353
2006,31100,245856,293416,5448087,5342268,40612,14,30776,10.6,969681,373100,596581,7,18.2,758043,272546,485497,5.1,14.2,211638,4,28.4,0,21789,21826,168571
2007,31100,249924,298036,5435842,5429020,38897,13.2,33230,11.2,911254,329472,581782,6.1,16.8,897609,301018,596591,5.5,16.5,13645,0.3,33,0,21588,21716,145940
2008,31100,249455,298303,5425444,5414536,34913,11.7,32208,10.8,834177,285988,548189,5.3,15.4,812360,281645,530715,5.2,15,21817,0.4,30,0,23081,23095,185668
2009,31100,241922,290125,5107799,5248458,30150,10.3,35464,12.1,666424,256085,410339,4.9,12.7,947742,270559,677183,5.2,18.1,-281318,-5.4,25.4,0,24691,24761,157874
2010,31100,237713,285702,4882289,4977890,29848,10.4,31851,11.1,623512,234520,388992,4.7,12.5,814714,258225,556489,5.2,16.4,-191202,-3.9,25,0,21645,21680,154509
2011,31100,238018,286850,4958319,4911128,31702,11.1,29065,10.2,719304,237390,481914,4.8,14.6,624921,217890,407031,4.4,12.7,94383,1.9,25.4,0,19596,19668,126136
2012,31100,242175,291062,5048344,4992835,33444,11.6,29255,10.1,767974,242364,525610,4.9,15.4,656958,211090,445868,4.2,13.2,111016,2.2,26.4,0,18013,18132,112343
2013,31100,245870,294712,5239177,5136375,32733,11.2,29541,10.1,798027,265300,532727,5.2,15.5,592423,213266,379157,4.2,11.5,205604,4,23,0,18295,18354,122864
2014,31100,250606,299715,5344503,5274933,35773,12.1,29219,9.9,852046,298697,553349,5.7,16.2,712905,242268,470637,4.6,13.5,139141,2.7,27,0,19594,19650,133845
1977,31140,15618,18204,352397,339435,2792,15.5,2277,12.7,70354,23698,46656,7,20.7,44429,17086,27343,5,13.1,25925,7.6,26.2,0,1495,1498,10181
1978,31140,15911,18570,376059,364140,2486,13.5,2100,11.4,71752,17922,53830,4.9,19.7,47913,16458,31455,4.5,13.2,23839,6.5,26.4,0,1468,1474,8813
1979,31140,16239,19000,374846,375168,2495,13.3,1962,10.4,63538,25111,38427,6.7,16.9,64182,19351,44831,5.2,17.1,-644,-0.2,33.8,0,1411,1416,10948
1980,31140,16196,19008,369553,372209,2121,11.2,2071,10.9,51397,19035,32362,5.1,13.8,56709,15697,41012,4.2,15.2,-5312,-1.4,27.6,0,1437,1443,8383
1981,31140,15743,18407,346183,349403,2020,10.8,2448,13.1,50877,19051,31826,5.5,14.6,57316,19483,37833,5.6,16.4,-6439,-1.8,29.2,0,1402,1407,7716
1982,31140,15855,18817,338229,342059,2615,14,2064,11.1,50521,25948,24573,7.6,14.8,58183,16046,42137,4.7,17,-7662,-2.2,29.6,0,1182,1182,6810
1983,31140,16057,18983,334404,335966,2162,11.4,2068,10.9,49975,16129,33846,4.8,14.9,53100,19336,33764,5.8,15.8,-3125,-0.9,29.8,0,1330,1337,8152
1984,31140,16564,19564,347454,341390,2463,12.8,1957,10.2,60669,21322,39347,6.2,17.8,48541,16190,32351,4.7,14.2,12128,3.6,28.4,0,1160,1163,8676
1985,31140,16957,19926,377031,372042,2373,12,2053,10.4,56721,19426,37295,5.2,15.2,46742,17412,29330,4.7,12.6,9979,2.6,25.2,0,1340,1343,8079
1986,31140,17443,20466,389422,382960,2564,12.7,1969,9.8,61559,20606,40953,5.4,16.1,48635,17195,31440,4.5,12.7,12924,3.4,25.4,0,1311,1316,9013
1987,31140,17712,20881,400563,396362,2750,13.3,2277,11,66053,23131,42922,5.8,16.7,57652,23115,34537,5.8,14.5,8401,2.2,29,0,1405,1412,9166
1988,31140,17854,21238,388465,382534,2722,12.9,2256,10.7,67451,26953,40498,7,17.6,55590,21932,33658,5.7,14.5,11861,3.1,29,0,1533,1533,10712
1989,31140,18160,21696,411254,399721,2622,12.2,2150,10,72923,26640,46283,6.7,18.2,49857,18158,31699,4.5,12.5,23066,5.7,25,0,1486,1492,10696
1990,31140,18561,22204,423591,416975,2637,12,2043,9.3,67491,21580,45911,5.2,16.2,54258,16827,37431,4,13,13233,3.2,26,0,1396,1400,9213
1991,31140,19053,23037,429049,426479,2899,12.8,2078,9.2,68512,28308,40204,6.6,16.1,63371,22130,41241,5.2,14.9,5141,1.2,29.8,0,1325,1334,13565
1992,31140,19308,23418,434935,432724,2708,11.6,2276,9.8,63403,22111,41292,5.1,14.7,58981,18208,40773,4.2,13.6,4422,1.1,27.2,0,1502,1522,9554
1993,31140,19748,23795,444141,439387,2709,11.5,2278,9.7,69810,22948,46862,5.2,15.9,60302,21035,39267,4.8,13.7,9508,2.2,27.4,0,1405,1410,9871
1994,31140,20240,24343,461727,452799,2801,11.6,2189,9.1,75771,23846,51925,5.3,16.7,57914,17458,40456,3.9,12.8,17857,3.9,25.6,0,1404,1407,9027
1995,31140,20666,24862,477915,469430,2866,11.7,2273,9.2,76485,25579,50906,5.4,16.3,59514,19687,39827,4.2,12.7,16971,3.6,25.4,0,1509,1526,9871
1996,31140,20964,25338,484330,481993,2974,11.9,2432,9.7,75421,31979,43442,6.6,15.6,70747,21482,49265,4.5,14.7,4674,0.9,29.4,0,1595,1595,10992
1997,31140,21340,25896,498761,491310,3269,12.7,2726,10.6,85472,28467,57005,5.8,17.4,70570,26459,44111,5.4,14.4,14902,3,28.8,0,1603,1603,10587
1998,31140,21548,26095,507011,502338,2946,11.3,2681,10.3,84069,36421,47648,7.3,16.7,74725,26389,48336,5.3,14.9,9344,1.8,29.8,0,1633,1633,10334
1999,31140,21644,26347,518178,512847,2913,11.1,2605,9.9,82376,35112,47264,6.8,16.1,71714,23940,47774,4.7,14,10662,2.1,28,0,1682,1682,11268
2000,31140,21565,26483,550254,541609,2854,10.8,2742,10.4,90297,36181,54116,6.7,16.7,73006,25493,47513,4.7,13.5,17291,3.2,27,0,1641,1641,12821
2001,31140,21735,26748,555912,554911,2832,10.6,2754,10.3,84506,30353,54153,5.5,15.2,82503,29947,52556,5.4,14.9,2003,0.3,29.8,0,1569,1571,11773
2002,31140,21746,26852,536263,544528,3070,11.5,2918,10.9,77727,32021,45706,5.9,14.3,94256,29133,65123,5.4,17.3,-16529,-3,28.6,0,1502,1503,9003
2003,31140,21780,27021,545819,537712,2827,10.5,2227,8.3,88044,33265,54779,6.2,16.4,71830,20075,51755,3.7,13.4,16214,3,26.8,0,1511,1513,10432
2004,31140,21962,27172,539851,534658,2869,10.6,2436,9,78931,25794,53137,4.8,14.8,68545,22733,45812,4.3,12.8,10386,2,25.6,0,1562,1562,12364
2005,31140,22067,27358,541009,539435,2882,10.6,2460,9,84138,29328,54810,5.4,15.6,80989,21799,59190,4,15,3149,0.6,30,0,1670,1676,13148
2006,31140,22198,27701,542997,538500,3067,11.2,2497,9.1,82049,30624,51425,5.7,15.2,73054,23642,49412,4.4,13.6,8995,1.6,27.2,0,1665,1667,15009
2007,31140,22164,27802,544133,542443,2874,10.4,2650,9.6,82719,32221,50498,5.9,15.2,79339,21644,57695,4,14.6,3380,0.6,29.2,0,1652,1680,11074
2008,31140,21880,27643,550678,546074,2526,9.1,2512,9.1,78011,24216,53795,4.4,14.3,68803,22521,46282,4.1,12.6,9208,1.7,25.2,0,1765,1765,14672
2009,31140,21359,27272,520970,533413,2384,8.7,2499,9.1,58939,21278,37661,4,11,83825,19101,64724,3.6,15.7,-24886,-4.7,22,0,1686,1696,9641
2010,31140,21043,26908,513867,515974,2186,8.1,2359,8.7,61865,24908,36957,4.8,12,66078,18806,47272,3.6,12.8,-4213,-0.8,24,0,1423,1423,11063
2011,31140,20665,26628,515622,513829,2198,8.2,2273,8.5,62893,18197,44696,3.5,12.2,59307,16991,42316,3.3,11.5,3586,0.7,23,0,1491,1491,10831
2012,31140,20725,26775,531858,523208,2479,9.3,2374,8.9,78264,26576,51688,5.1,15,60963,18593,42370,3.6,11.7,17301,3.3,23.4,0,1393,1408,8868
2013,31140,20710,26831,547133,538967,2233,8.4,2137,8,78041,23938,54103,4.4,14.5,61709,18732,42977,3.5,11.4,16332,3.1,22.8,0,1352,1355,11841
2014,31140,20777,27037,559737,552301,2424,9,2024,7.5,77266,25274,51992,4.6,14,62393,16379,46014,3,11.3,14873,2.7,22.6,0,1345,1347,8488
1977,31180,4528,4977,62518,61762,930,19.1,706,14.5,13479,6654,6825,10.8,21.8,11966,5307,6659,8.6,19.4,1513,2.4,38.8,0,468,469,2892
1978,31180,4343,4788,66419,64362,761,15.6,903,18.5,15057,5223,9834,8.1,23.4,10942,5819,5123,9,17,4115,6.4,34,0,538,538,3009
1979,31180,4687,5159,71079,68849,793,15.9,463,9.3,16888,8964,7924,13,24.5,12428,3278,9150,4.8,18.1,4460,6.4,36.2,0,9,13,174
1980,31180,4681,5183,72645,71809,766,14.8,709,13.7,14119,5333,8786,7.4,19.7,12446,4755,7691,6.6,17.3,1673,2.4,34.6,0,504,504,2474
1981,31180,4559,5052,71549,71847,673,13.2,759,14.8,12669,4907,7762,6.8,17.6,13265,4975,8290,6.9,18.5,-596,-0.9,35.2,0,488,488,2488
1982,31180,4636,5204,75284,73388,834,16.3,634,12.4,15819,7002,8817,9.5,21.6,12027,5185,6842,7.1,16.4,3792,5.2,32.8,0,345,347,2632
1983,31180,4737,5284,74115,74250,689,13.1,650,12.4,15674,4956,10718,6.7,21.1,15944,5824,10120,7.8,21.5,-270,-0.4,42.2,0,433,433,2641
1984,31180,4845,5389,72166,73144,725,13.6,623,11.7,12684,5222,7462,7.1,17.3,14639,3577,11062,4.9,20,-1955,-2.7,34.6,0,410,413,2094
1985,31180,4828,5385,72911,72618,676,12.5,675,12.5,12180,4415,7765,6.1,16.8,11594,4610,6984,6.3,16,586,0.8,32,0,456,456,2722
1986,31180,4808,5380,72437,72574,701,13,677,12.6,13315,5657,7658,7.8,18.3,13589,4518,9071,6.2,18.7,-274,-0.4,36.6,0,442,442,2334
1987,31180,4759,5369,72241,73138,745,13.9,722,13.4,12726,5834,6892,8,17.4,14519,5931,8588,8.1,19.9,-1793,-2.5,34.8,0,472,476,3262
1988,31180,4634,5251,73633,72722,648,12.2,744,14,13517,4763,8754,6.5,18.6,11694,5121,6573,7,16.1,1823,2.5,32.2,0,500,500,2439
1989,31180,4643,5272,74775,74265,639,12.1,634,12,12955,5115,7840,6.9,17.4,11934,6035,5899,8.1,16.1,1021,1.3,32.2,0,414,417,4506
1990,31180,4680,5315,77108,75855,644,12.2,569,10.8,13081,5127,7954,6.8,17.2,10574,3419,7155,4.5,13.9,2507,3.3,27.8,0,380,381,1578
1991,31180,4795,5459,77308,77302,716,13.3,559,10.4,14106,6207,7899,8,18.2,14094,5385,8709,7,18.2,12,0,36.4,0,339,341,2641
1992,31180,4865,5557,78418,77612,738,13.4,611,11.1,15092,6136,8956,7.9,19.4,13479,4955,8524,6.4,17.4,1613,2,34.8,0,390,395,2840
1993,31180,4929,5605,79178,78809,662,11.9,588,10.5,13451,4845,8606,6.1,17.1,12713,5864,6849,7.4,16.1,738,1,32.2,0,389,389,2964
1994,31180,5109,5793,82480,80972,728,12.8,531,9.3,13073,4849,8224,6,16.1,10057,3819,6238,4.7,12.4,3016,3.7,24.8,0,355,355,2137
1995,31180,5140,5825,85274,83814,651,11.2,597,10.3,14423,5160,9263,6.2,17.2,11502,4621,6881,5.5,13.7,2921,3.5,27.4,0,399,400,2145
1996,31180,5157,5844,85519,85285,645,11.1,614,10.5,14398,5923,8475,6.9,16.9,13930,6920,7010,8.1,16.3,468,0.6,32.6,0,410,410,2356
1997,31180,5171,5923,86957,86209,752,12.8,667,11.3,15515,6145,9370,7.1,18,14019,4915,9104,5.7,16.3,1496,1.7,32.6,0,425,425,2442
1998,31180,5232,5996,88585,87708,725,12.2,643,10.8,14805,6297,8508,7.2,16.9,13051,4874,8177,5.6,14.9,1754,2,29.8,0,425,425,2407
1999,31180,5134,5929,88643,88510,642,10.8,688,11.5,17660,7443,10217,8.4,20,17394,8186,9208,9.2,19.7,266,0.3,39.4,0,432,432,2957
2000,31180,5138,5944,93587,92196,638,10.7,638,10.7,15628,5978,9650,6.5,17,12846,4381,8465,4.8,13.9,2782,3.1,27.8,0,369,369,2240
2001,31180,5173,6005,96718,95126,681,11.4,668,11.2,17164,6300,10864,6.6,18,13980,5343,8637,5.6,14.7,3184,3.3,29.4,0,413,414,2793
2002,31180,5235,6077,95411,96074,766,12.7,687,11.4,16315,6786,9529,7.1,17,17641,6601,11040,6.9,18.4,-1326,-1.4,34,0,373,373,2419
2003,31180,5312,6156,97716,96126,699,11.5,524,8.6,17073,7756,9317,8.1,17.8,13893,4083,9810,4.2,14.5,3180,3.3,29,0,376,382,2730
2004,31180,5292,6127,98454,97841,635,10.4,596,9.7,14231,4992,9239,5.1,14.5,13005,3808,9197,3.9,13.3,1226,1.2,26.6,0,431,431,2339
2005,31180,5351,6221,98343,98195,649,10.5,499,8.1,13809,4437,9372,4.5,14.1,13513,4726,8787,4.8,13.8,296,0.3,27.6,0,371,372,2686
2006,31180,5384,6279,102917,100521,656,10.5,542,8.7,15283,5567,9716,5.5,15.2,10491,3007,7484,3,10.4,4792,4.8,20.8,0,401,401,2270
2007,31180,5385,6338,103208,102803,668,10.6,589,9.4,16627,6343,10284,6.2,16.2,15816,4481,11335,4.4,15.4,811,0.8,30.8,0,413,414,2890
2008,31180,5358,6346,106304,104333,617,9.8,539,8.5,16799,5594,11205,5.4,16.1,12857,4358,8499,4.2,12.3,3942,3.8,24.6,0,400,401,3436
2009,31180,5296,6297,103785,104776,512,8.1,518,8.2,11953,4292,7661,4.1,11.4,13934,3344,10590,3.2,13.3,-1981,-1.9,22.8,0,359,359,1895
2010,31180,5315,6343,102885,103262,590,9.4,535,8.5,13725,5727,7998,5.5,13.3,14478,4055,10423,3.9,14,-753,-0.7,26.6,0,381,381,2459
2011,31180,5367,6402,104769,103503,566,8.9,461,7.3,13832,4658,9174,4.5,13.4,11299,3238,8061,3.1,10.9,2533,2.5,21.8,0,329,329,1642
2012,31180,5406,6429,105200,104854,559,8.7,532,8.3,14075,4372,9703,4.2,13.4,13382,4226,9156,4,12.8,693,0.6,25.6,0,319,322,1963
2013,31180,5429,6463,106405,105653,564,8.8,530,8.2,13536,4385,9151,4.2,12.8,12032,3593,8439,3.4,11.4,1504,1.4,22.8,0,362,366,2138
2014,31180,5504,6534,110571,108214,581,9,465,7.2,15058,5508,9550,5.1,13.9,10343,2700,7643,2.5,9.6,4715,4.3,19.2,0,338,338,1538
1977,31340,3004,3337,69779,64507,428,12.9,353,10.7,16968,2365,14603,3.7,26.3,6423,1588,4835,2.5,10,10545,16.3,20,0,233,233,1024
1978,31340,3088,3427,63219,66496,442,13.1,355,10.5,9450,2449,7001,3.7,14.2,16004,4196,11808,6.3,24.1,-6554,-9.9,28.4,0,237,237,998
1979,31340,3139,3497,66692,64907,432,12.5,349,10.1,10373,3905,6468,6,16,6803,2128,4675,3.3,10.5,3570,5.5,21,0,254,254,1110
1980,31340,3133,3493,68474,67526,401,11.5,383,11,9485,3874,5611,5.7,14,7588,2560,5028,3.8,11.2,1897,2.8,22.4,0,265,265,1107
1981,31340,3066,3425,73525,70717,438,12.7,476,13.8,15511,5384,10127,7.6,21.9,9894,4853,5041,6.9,14,5617,7.9,28,0,283,283,1238
1982,31340,3023,3431,65808,69689,447,13,397,11.6,7381,3163,4218,4.5,10.6,15142,4017,11125,5.8,21.7,-7761,-11.1,21.2,0,226,227,1036
1983,31340,3089,3495,66422,65988,370,10.7,344,9.9,8973,2162,6811,3.3,13.6,8104,2671,5433,4,12.3,869,1.3,24.6,0,229,229,1175
1984,31340,3055,3469,68013,67124,454,13,448,12.9,9856,3067,6789,4.6,14.7,8077,2708,5369,4,12,1779,2.7,24,0,238,239,1317
1985,31340,3332,3747,72478,70516,449,12.4,217,6,9558,3107,6451,4.4,13.6,5633,1217,4416,1.7,8,3925,5.6,16,0,5,5,43
1986,31340,3514,3916,72622,72535,528,13.8,351,9.2,9172,3066,6106,4.2,12.6,8998,2679,6319,3.7,12.4,174,0.2,24.8,0,212,212,947
1987,31340,3630,4094,74486,73536,567,14.1,366,9.1,10069,3691,6378,5,13.7,8170,2357,5813,3.2,11.1,1899,2.6,22.2,0,240,241,1087
1988,31340,3664,4119,78180,75958,481,11.7,426,10.4,12762,5796,6966,7.6,16.8,8318,2922,5396,3.8,11,4444,5.8,22,0,264,264,1486
1989,31340,3725,4212,82507,80372,458,11,362,8.7,12156,3823,8333,4.8,15.1,7885,2176,5709,2.7,9.8,4271,5.3,19.6,0,241,245,1363
1990,31340,3829,4332,82244,82358,490,11.5,356,8.3,11697,4764,6933,5.8,14.2,11924,2389,9535,2.9,14.5,-227,-0.3,28.4,0,236,236,1101
1991,31340,3899,4422,79149,80691,503,11.5,411,9.4,8048,2860,5188,3.5,10,11132,2609,8523,3.2,13.8,-3084,-3.8,20,0,260,261,1412
1992,31340,3980,4532,83500,81322,554,12.4,422,9.4,12964,6187,6777,7.6,15.9,8607,2843,5764,3.5,10.6,4357,5.3,21.2,0,256,258,1217
1993,31340,4053,4573,81614,82238,457,10,407,8.9,9184,3306,5878,4,11.2,10431,4289,6142,5.2,12.7,-1247,-1.5,22.4,0,262,263,1420
1994,31340,4098,4632,83533,82737,457,9.9,386,8.4,10049,3273,6776,4,12.1,8456,2908,5548,3.5,10.2,1593,1.9,20.4,0,259,259,1140
1995,31340,4227,4772,88157,85841,537,11.4,390,8.3,13044,5031,8013,5.9,15.2,8411,2775,5636,3.2,9.8,4633,5.4,19.6,0,266,267,1635
1996,31340,4277,4822,87778,87977,495,10.3,440,9.2,9993,3453,6540,3.9,11.4,10390,2745,7645,3.1,11.8,-397,-0.4,22.8,0,285,285,1477
1997,31340,4368,4924,87752,87790,573,11.8,467,9.6,11245,3648,7597,4.2,12.8,11320,4612,6708,5.3,12.9,-75,-0.1,25.6,0,294,294,2423
1998,31340,4420,4994,90248,88962,517,10.4,438,8.8,11940,5336,6604,6,13.4,9368,3461,5907,3.9,10.5,2572,2.9,21,0,283,283,1356
1999,31340,4497,5101,91693,90993,531,10.5,421,8.3,12413,4185,8228,4.6,13.6,11012,4360,6652,4.8,12.1,1401,1.5,24.2,0,278,278,1174
2000,31340,4486,5113,96282,93984,514,10.1,501,9.8,13302,4439,8863,4.7,14.2,8706,2797,5909,3,9.3,4596,4.9,18.6,0,310,310,1367
2001,31340,4575,5196,94592,95583,542,10.5,501,9.7,11151,4111,7040,4.3,11.7,13133,4280,8853,4.5,13.7,-1982,-2,23.4,0,277,277,1262
2002,31340,4555,5197,91357,92948,556,10.7,539,10.4,12122,4627,7495,5,13,15304,4902,10402,5.3,16.5,-3182,-3.5,26,0,302,302,1423
2003,31340,4607,5241,91605,91142,538,10.3,424,8.2,12895,3402,9493,3.7,14.1,11968,3842,8126,4.2,13.1,927,1,26.2,0,268,268,1596
2004,31340,4706,5361,92400,91774,592,11.2,416,7.9,12524,4829,7695,5.3,13.6,11272,2537,8735,2.8,12.3,1252,1.3,24.6,0,282,282,1252
2005,31340,4825,5495,92655,92270,592,10.9,422,7.8,11820,3747,8073,4.1,12.8,11050,2278,8772,2.5,12,770,0.8,24,0,308,308,1537
2006,31340,4896,5616,95615,93897,648,11.7,491,8.9,14303,4385,9918,4.7,15.2,10867,3954,6913,4.2,11.6,3436,3.6,23.2,0,352,352,2219
2007,31340,5029,5772,95921,95504,653,11.5,506,8.9,13724,4916,8808,5.1,14.4,12889,3259,9630,3.4,13.5,835,0.9,27,0,295,300,1837
2008,31340,4988,5754,98461,97020,540,9.4,526,9.2,12657,3410,9247,3.5,13,9774,2200,7574,2.3,10.1,2883,2.9,20.2,0,388,388,1516
2009,31340,4818,5611,94882,96426,436,7.7,543,9.6,9969,3636,6333,3.8,10.3,13057,2576,10481,2.7,13.5,-3088,-3.2,20.6,0,396,396,1974
2010,31340,4688,5466,93362,93852,372,6.7,488,8.8,9590,2906,6684,3.1,10.2,10570,2761,7809,2.9,11.3,-980,-1.1,20.4,0,315,315,1698
2011,31340,4564,5348,93494,93356,396,7.3,488,9,9956,2327,7629,2.5,10.7,9680,2696,6984,2.9,10.4,276,0.3,20.8,0,331,331,2016
2012,31340,4590,5384,93412,93397,432,8.1,400,7.5,10225,2453,7772,2.6,10.9,10195,3282,6913,3.5,10.9,30,0,21.8,0,257,261,1227
2013,31340,4576,5346,92351,92777,385,7.2,425,7.9,7253,1672,5581,1.8,7.8,8105,1974,6131,2.1,8.7,-852,-0.9,15.6,0,267,268,1435
2014,31340,4568,5346,93464,92699,425,8,393,7.4,10025,2259,7766,2.4,10.8,8495,2108,6387,2.3,9.2,1530,1.6,18.4,0,282,282,1305
1977,31420,3379,3851,54288,52861,622,16.3,528,13.9,11200,4934,6266,9.3,21.2,8346,3071,5275,5.8,15.8,2854,5.4,31.6,0,348,350,1734
1978,31420,3411,3902,55744,55010,526,13.6,468,12.1,10922,3123,7799,5.7,19.9,9453,3515,5938,6.4,17.2,1469,2.7,34.4,0,332,333,1675
1979,31420,3400,3911,58147,56889,509,13,476,12.2,11347,3847,7500,6.8,19.9,8830,2431,6399,4.3,15.5,2517,4.4,31,0,340,341,1507
1980,31420,3399,3899,58119,58100,430,11,428,11,8757,3648,5109,6.3,15.1,8718,3786,4932,6.5,15,39,0.1,30,0,304,304,1565
1981,31420,3266,3731,58880,58153,397,10.4,527,13.8,10135,3446,6689,5.9,17.4,8681,3434,5247,5.9,14.9,1454,2.5,29.8,0,313,314,1478
1982,31420,3263,3753,58573,58699,518,13.8,454,12.1,9447,3737,5710,6.4,16.1,9699,3224,6475,5.5,16.5,-252,-0.4,32.2,0,246,246,1452
1983,31420,3332,3823,60135,59435,427,11.3,389,10.3,9339,3102,6237,5.2,15.7,7938,2586,5352,4.4,13.4,1401,2.3,26.8,0,252,253,1429
1984,31420,3403,3901,63368,61773,463,12,398,10.3,9753,3119,6634,5,15.8,6562,2689,3873,4.4,10.6,3191,5.2,21.2,0,229,229,1086
1985,31420,3549,4045,72863,68329,560,14.1,405,10.2,16820,4489,12331,6.6,24.6,7752,3566,4186,5.2,11.3,9068,13.3,22.6,0,256,257,1391
1986,31420,3654,4176,69509,71177,537,13.1,393,9.6,11098,3875,7223,5.4,15.6,14434,2994,11440,4.2,20.3,-3336,-4.7,31.2,0,246,246,1492
1987,31420,3708,4283,70333,69856,592,14,467,11,11585,5111,6474,7.3,16.6,10631,4876,5755,7,15.2,954,1.4,30.4,0,292,304,2560
1988,31420,3767,4354,73211,71496,540,12.5,471,10.9,13006,4302,8704,6,18.2,9575,3642,5933,5.1,13.4,3431,4.8,26.8,0,307,307,1305
1989,31420,3813,4404,74599,74051,484,11.1,436,10,11962,4523,7439,6.1,16.2,10866,4302,6564,5.8,14.7,1096,1.5,29.4,0,277,277,1302
1990,31420,3791,4398,76199,75354,476,10.8,458,10.4,12260,4028,8232,5.3,16.3,10570,3683,6887,4.9,14,1690,2.3,28,0,313,313,2006
1991,31420,3853,4453,79937,78054,491,11.1,427,9.7,16141,4645,11496,6,20.7,12374,3847,8527,4.9,15.9,3767,4.8,31.8,0,239,244,1775
1992,31420,3860,4447,76661,78285,491,11,481,10.8,12305,5084,7221,6.5,15.7,15553,9147,6406,11.7,19.9,-3248,-4.2,31.4,0,310,315,2160
1993,31420,3932,4521,77427,76837,498,11.1,408,9.1,11837,4128,7709,5.4,15.4,10657,4523,6134,5.9,13.9,1180,1.5,27.8,0,276,277,1753
1994,31420,3977,4563,78186,77771,479,10.5,437,9.6,11016,3750,7266,4.8,14.2,10185,3189,6996,4.1,13.1,831,1.1,26.2,0,298,298,2076
1995,31420,4009,4628,82133,80045,510,11.1,420,9.1,13084,3723,9361,4.7,16.3,8908,2796,6112,3.5,11.1,4176,5.2,22.2,0,268,269,1631
1996,31420,4128,4741,83637,82917,586,12.5,461,9.8,13451,5867,7584,7.1,16.2,12011,4201,7810,5.1,14.5,1440,1.7,29,0,287,287,1847
1997,31420,4197,4853,85938,84877,653,13.6,549,11.4,15175,6336,8839,7.5,17.9,13053,4652,8401,5.5,15.4,2122,2.5,30.8,0,339,339,2116
1998,31420,4187,4852,84908,85339,569,11.7,548,11.3,13291,5154,8137,6,15.6,14153,6820,7333,8,16.6,-862,-1,31.2,0,346,346,2632
1999,31420,4193,4861,87442,88048,537,11.1,522,10.7,12343,4286,8057,4.9,14,13554,6457,7097,7.3,15.4,-1211,-1.4,28,0,324,324,1713
2000,31420,4164,4828,90260,89202,495,10.2,523,10.8,13437,4255,9182,4.8,15.1,11320,4114,7206,4.6,12.7,2117,2.4,25.4,0,318,318,1646
2001,31420,4131,4820,86850,88770,528,10.9,579,12,11672,4291,7381,4.8,13.1,15512,6472,9040,7.3,17.5,-3840,-4.4,26.2,0,316,316,2931
2002,31420,4195,4869,83697,84545,606,12.5,544,11.2,11147,4504,6643,5.3,13.2,12843,4126,8717,4.9,15.2,-1696,-2,26.4,0,274,274,1503
2003,31420,4207,4862,85946,84381,540,11.2,437,9.1,13100,5010,8090,5.9,15.5,9970,2433,7537,2.9,11.8,3130,3.7,23.6,0,312,312,1618
2004,31420,4235,4898,88949,87203,517,10.6,434,8.9,14364,6091,8273,7,16.5,10872,3767,7105,4.3,12.5,3492,4,25,0,304,304,1486
2005,31420,4236,4904,85608,86977,520,10.6,457,9.3,11800,5204,6596,6,13.6,14537,5047,9490,5.8,16.7,-2737,-3.1,27.2,0,308,309,2673
2006,31420,4268,4975,83973,84459,552,11.2,447,9.1,12248,4888,7360,5.8,14.5,13220,5017,8203,5.9,15.7,-972,-1.2,29,0,328,328,1683
2007,31420,4357,5089,83186,83584,547,10.9,447,8.9,11012,4105,6907,4.9,13.2,11808,3661,8147,4.4,14.1,-796,-0.9,26.4,0,292,294,1575
2008,31420,4305,5048,81960,82264,481,9.5,469,9.3,10285,3791,6494,4.6,12.5,10892,3720,7172,4.5,13.2,-607,-0.7,25,0,347,347,1930
2009,31420,4139,4869,80347,80994,416,8.4,524,10.6,9600,4009,5591,4.9,11.9,10893,2902,7991,3.6,13.4,-1293,-1.5,23.8,0,354,355,1632
2010,31420,4063,4786,78859,79244,381,7.9,417,8.7,8681,3051,5630,3.9,11,9450,2588,6862,3.3,11.9,-769,-0.9,22,0,276,276,1570
2011,31420,4010,4749,79418,78937,442,9.3,427,9,9857,4327,5530,5.5,12.5,8895,2935,5960,3.7,11.3,962,1.2,22.6,0,297,301,2242
2012,31420,3999,4716,79199,79173,402,8.5,424,9,9240,2473,6767,3.1,11.7,9187,2452,6735,3.1,11.6,53,0.1,23.2,0,247,249,1235
2013,31420,3970,4674,80376,79465,384,8.2,401,8.6,9098,3507,5591,4.4,11.4,7275,1902,5373,2.4,9.2,1823,2.2,18.4,0,274,275,1357
2014,31420,3947,4706,81731,80939,418,8.9,356,7.6,8490,2517,5973,3.1,10.5,6905,2122,4783,2.6,8.5,1585,2,17,0,248,248,1510
1977,31460,864,901,22698,15272,187,21.6,114,13.2,16226,1063,15163,7,106.2,1374,693,681,4.5,9,14852,97.2,18,0,72,72,405
1978,31460,901,941,9486,16091,184,20,142,15.4,2289,1022,1267,6.4,14.2,15498,641,14857,4,96.3,-13209,-82.1,28.4,0,86,86,354
1979,31460,960,1012,10532,9990,208,21.3,126,12.9,2411,856,1555,8.6,24.1,1326,491,835,4.9,13.3,1085,10.8,26.6,0,99,99,333
1980,31460,992,1047,10817,10651,196,19.1,148,14.4,2746,1441,1305,13.5,25.8,2413,1169,1244,11,22.7,333,3.1,45.4,0,101,101,531
1981,31460,960,1011,11020,10847,157,15.3,175,17,2354,1238,1116,11.4,21.7,2008,813,1195,7.5,18.5,346,3.2,37,0,110,110,424
1982,31460,986,1048,10878,10969,195,18.9,145,14.1,2057,1050,1007,9.6,18.8,2239,655,1584,6,20.4,-182,-1.6,37.6,0,102,102,479
1983,31460,1006,1065,10652,10711,150,14.2,136,12.9,1957,719,1238,6.7,18.3,2074,626,1448,5.8,19.4,-117,-1.1,36.6,0,93,93,469
1984,31460,1055,1111,11190,10904,166,15.3,119,10.9,2328,901,1427,8.3,21.3,1755,574,1181,5.3,16.1,573,5.2,32.2,0,71,71,309
1985,31460,1088,1146,12217,11741,182,16.1,142,12.6,2803,1154,1649,9.8,23.9,1851,623,1228,5.3,15.8,952,8.1,31.6,0,91,91,316
1986,31460,1112,1177,12606,12381,180,15.5,140,12.1,2690,1198,1492,9.7,21.7,2239,812,1427,6.6,18.1,451,3.6,36.2,0,90,90,513
1987,31460,1179,1252,13247,12923,204,16.8,126,10.4,2633,1021,1612,7.9,20.4,1985,687,1298,5.3,15.4,648,5,30.8,0,80,80,377
1988,31460,1204,1281,13165,13181,196,15.5,159,12.6,2164,816,1348,6.2,16.4,2195,676,1519,5.1,16.7,-31,-0.3,32.8,0,105,105,438
1989,31460,1177,1254,14789,13989,197,15.5,224,17.7,4328,2448,1880,17.5,30.9,2727,1709,1018,12.2,19.5,1601,11.4,39,0,90,90,600
1990,31460,1318,1398,17645,16170,286,21.6,115,8.7,5057,3012,2045,18.6,31.3,2107,840,1267,5.2,13,2950,18.3,26,0,81,81,657
1991,31460,1442,1536,19297,18487,269,18.3,136,9.3,4787,1755,3032,9.5,25.9,3167,896,2271,4.8,17.1,1620,8.8,34.2,0,89,89,565
1992,31460,1431,1531,18652,18797,224,14.6,203,13.2,3584,1725,1859,9.2,19.1,3873,1056,2817,5.6,20.6,-289,-1.5,38.2,0,145,145,709
1993,31460,1382,1482,18637,18631,197,13.1,232,15.4,3041,1291,1750,6.9,16.3,3028,1213,1815,6.5,16.3,13,0,32.6,0,157,159,700
1994,31460,1370,1476,18233,18401,187,12.6,188,12.7,2455,964,1491,5.2,13.3,2791,732,2059,4,15.2,-336,-1.9,26.6,0,125,125,407
1995,31460,1386,1497,18815,18648,207,13.9,184,12.4,3322,1382,1940,7.4,17.8,2988,851,2137,4.6,16,334,1.8,32,0,124,124,553
1996,31460,1411,1517,25664,25000,197,13.1,167,11.1,4180,1062,3118,4.2,16.7,2852,1070,1782,4.3,11.4,1328,5.3,22.8,0,98,98,673
1997,31460,1449,1562,22333,23994,220,14.3,169,11,3453,1101,2352,4.6,14.4,6775,909,5866,3.8,28.2,-3322,-13.8,28.8,0,110,110,593
1998,31460,1472,1601,23670,22779,207,13.1,160,10.1,4198,1283,2915,5.6,18.4,2416,854,1562,3.7,10.6,1782,7.8,21.2,0,112,112,446
1999,31460,1504,1631,26337,25053,186,11.5,159,9.8,5720,1182,4538,4.7,22.8,3151,974,2177,3.9,12.6,2569,10.2,25.2,0,101,101,501
2000,31460,1505,1624,25136,24968,187,11.5,188,11.6,3595,1309,2286,5.2,14.4,3258,1074,2184,4.3,13,337,1.4,26,0,115,115,528
2001,31460,1526,1652,25542,25396,198,12,199,12.1,3138,1163,1975,4.6,12.4,2846,953,1893,3.8,11.2,292,1.2,22.4,0,126,126,527
2002,31460,1566,1699,22958,24242,229,13.7,183,10.9,3204,1083,2121,4.5,13.2,5771,1644,4127,6.8,23.8,-2567,-10.6,26.4,0,111,111,512
2003,31460,1587,1720,23455,23039,207,12.2,156,9.2,3164,1094,2070,4.7,13.7,2331,792,1539,3.4,10.1,833,3.6,20.2,0,103,106,548
2004,31460,1584,1713,23444,23293,200,11.7,177,10.3,3267,1189,2078,5.1,14,2964,999,1965,4.3,12.7,303,1.3,25.4,0,120,120,687
2005,31460,1626,1762,23896,23620,234,13.5,168,9.7,3444,1214,2230,5.1,14.6,2892,977,1915,4.1,12.2,552,2.4,24.4,0,123,123,586
2006,31460,1681,1819,25386,24590,255,14.3,188,10.5,4112,1486,2626,6,16.7,2520,992,1528,4,10.2,1592,6.5,20.4,0,136,136,741
2007,31460,1762,1894,25966,25637,287,15.5,207,11.1,4599,2382,2217,9.3,17.9,3941,1262,2679,4.9,15.4,658,2.5,30.8,0,132,132,797
2008,31460,1706,1840,25576,25754,187,10,209,11.2,3361,1055,2306,4.1,13.1,3716,1345,2371,5.2,14.4,-355,-1.3,26.2,0,157,157,962
2009,31460,1617,1753,23718,24482,177,9.9,243,13.6,2226,960,1266,3.9,9.1,3753,1100,2653,4.5,15.3,-1527,-6.2,18.2,0,179,179,641
2010,31460,1554,1683,24231,23796,158,9.2,210,12.3,3817,1367,2450,5.7,16,2947,952,1995,4,12.4,870,3.6,24.8,0,142,142,598
2011,31460,1514,1652,25072,24624,163,9.8,190,11.4,3190,704,2486,2.9,13,2294,669,1625,2.7,9.3,896,3.7,18.6,0,132,132,471
2012,31460,1532,1673,24612,24865,178,10.7,165,9.9,2677,749,1928,3,10.8,3183,722,2461,2.9,12.8,-506,-2,21.6,0,111,111,433
2013,31460,1526,1664,25267,24919,152,9.1,169,10.1,2665,657,2008,2.6,10.7,1968,723,1245,2.9,7.9,697,2.8,15.8,0,114,114,529
2014,31460,1552,1693,26146,25686,192,11.5,158,9.4,3138,1526,1612,5.9,12.2,2218,734,1484,2.9,8.6,920,3.6,17.2,0,106,106,446
1977,31540,7089,7925,111179,108267,1272,16.4,943,12.1,20102,8896,11206,8.2,18.6,14277,6592,7685,6.1,13.2,5825,5.4,26.4,0,629,631,4084
1978,31540,7411,8271,120914,116039,1170,14.4,828,10.2,23209,7478,15731,6.4,20,13458,5776,7682,5,11.6,9751,8.4,23.2,0,584,584,3039
1979,31540,7591,8509,126239,123498,1161,13.8,894,10.7,22671,8972,13699,7.3,18.4,17189,6700,10489,5.4,13.9,5482,4.5,27.8,0,659,661,4505
1980,31540,7675,8627,130162,128003,1026,12,874,10.2,21395,8256,13139,6.4,16.7,17077,5928,11149,4.6,13.3,4318,3.4,26.6,0,613,615,3405
1981,31540,7519,8432,128941,128284,962,11.3,1067,12.5,21651,8156,13495,6.4,16.9,20336,8119,12217,6.3,15.9,1315,1,31.8,0,614,615,3047
1982,31540,7566,8642,129916,129389,1160,13.6,857,10,21623,11036,10587,8.5,16.7,20569,5568,15001,4.3,15.9,1054,0.8,31.8,0,498,500,2922
1983,31540,7832,8918,127912,129000,974,11.1,787,9,18825,7907,10918,6.1,14.6,21001,6114,14887,4.7,16.3,-2176,-1.7,29.2,0,515,517,3670
1984,31540,8034,9148,135698,132091,1125,12.5,892,9.9,23994,8101,15893,6.1,18.2,16780,6662,10118,5,12.7,7214,5.5,25.4,0,558,558,2905
1985,31540,8205,9323,142434,138677,1133,12.3,919,10,25017,8508,16509,6.1,18,17503,7962,9541,5.7,12.6,7514,5.4,25.2,0,603,606,4488
1986,31540,7826,8938,142172,141524,1022,11.2,1279,14,24221,9670,14551,6.8,17.1,22924,11009,11915,7.8,16.2,1297,0.9,32.4,0,693,694,4702
1987,31540,8507,9787,161877,155953,1479,15.8,716,7.6,28742,11967,16775,7.7,18.4,16893,5624,11269,3.6,10.8,11849,7.6,21.6,0,175,179,2198
1988,31540,8673,9993,167436,164081,1199,12.1,947,9.6,27912,10834,17078,6.6,17,21201,8039,13162,4.9,12.9,6711,4.1,25.8,0,621,621,3988
1989,31540,8746,10166,174133,170604,1153,11.4,983,9.8,28759,9690,19069,5.7,16.9,21701,8882,12819,5.2,12.7,7058,4.2,25.4,0,649,654,5604
1990,31540,8858,10287,181491,177751,1047,10.2,886,8.7,27384,9442,17942,5.3,15.4,19903,6110,13793,3.4,11.2,7481,4.2,22.4,0,593,594,3374
1991,31540,9147,10717,187366,184458,1295,12.3,848,8.1,29311,11983,17328,6.5,15.9,23494,7481,16013,4.1,12.7,5817,3.2,25.4,0,540,550,4050
1992,31540,9273,10895,192895,190796,1121,10.4,936,8.6,27096,8871,18225,4.6,14.2,22898,7446,15452,3.9,12,4198,2.2,24,0,575,584,3850
1993,31540,9580,11242,200642,196635,1209,10.9,842,7.6,30196,10689,19507,5.4,15.4,22182,6388,15794,3.2,11.3,8014,4.1,22.6,0,548,548,3272
1994,31540,9858,11562,207119,203733,1222,10.7,868,7.6,28975,9104,19871,4.5,14.2,22203,7237,14966,3.6,10.9,6772,3.3,21.8,0,554,556,4093
1995,31540,10155,11868,218118,212439,1338,11.4,969,8.3,33107,10782,22325,5.1,15.6,21748,8124,13624,3.8,10.2,11359,5.4,20.4,0,647,669,4625
1996,31540,10321,12038,221284,219715,1289,10.8,1096,9.2,30203,11800,18403,5.4,13.7,27064,8860,18204,4,12.3,3139,1.4,24.6,0,722,722,4093
1997,31540,10500,12356,231002,226245,1440,11.8,1128,9.2,37193,13793,23400,6.1,16.4,27679,9261,18418,4.1,12.2,9514,4.2,24.4,0,663,663,4036
1998,31540,10522,12387,237167,233977,1236,10,1180,9.5,36691,10710,25981,4.6,15.7,30310,11176,19134,4.8,13,6381,2.7,26,0,748,748,4658
1999,31540,10641,12651,243043,240054,1377,11,1084,8.7,35758,13240,22518,5.5,14.9,29780,10463,19317,4.4,12.4,5978,2.5,24.8,0,700,700,6512
2000,31540,10717,12781,246201,244672,1287,10.1,1144,9,34621,11415,23206,4.7,14.1,31563,14463,17100,5.9,12.9,3058,1.2,25.8,0,686,686,4081
2001,31540,10857,12996,250351,248539,1376,10.7,1262,9.8,35472,13287,22185,5.3,14.3,31847,10714,21133,4.3,12.8,3625,1.5,25.6,0,665,665,3782
2002,31540,11018,13196,254620,253914,1514,11.6,1297,9.9,38082,16275,21807,6.4,15,36670,11124,25546,4.4,14.4,1412,0.6,28.8,0,647,647,4421
2003,31540,11106,13349,264645,258448,1438,10.9,1080,8.2,44287,14969,29318,5.8,17.1,31893,9316,22577,3.6,12.3,12394,4.8,24.6,0,700,704,5022
2004,31540,11267,13526,274904,268778,1300,9.7,1002,7.5,37541,12775,24766,4.8,14,25289,7098,18191,2.6,9.4,12252,4.6,18.8,0,646,649,3800
2005,31540,11472,13771,274414,274001,1397,10.3,1034,7.6,34847,11246,23601,4.1,12.7,34021,12658,21363,4.6,12.4,826,0.3,24.8,0,694,695,7250
2006,31540,11577,13951,277605,274398,1515,11,1200,8.7,36601,12336,24265,4.5,13.3,30187,9787,20400,3.6,11,6414,2.3,22,0,781,782,6687
2007,31540,11709,14060,287320,282119,1496,10.7,1310,9.4,43803,13754,30049,4.9,15.5,33400,9915,23485,3.5,11.8,10403,3.7,23.6,0,746,751,4644
2008,31540,11583,13982,289518,287803,1202,8.6,1168,8.4,35579,11393,24186,4,12.4,32149,8539,23610,3,11.2,3430,1.2,22.4,0,825,827,5244
2009,31540,11361,13723,279103,283948,1086,7.9,1250,9,28499,7934,20565,2.8,10,38188,8996,29192,3.2,13.4,-9689,-3.4,20,0,807,807,4986
2010,31540,11215,13584,270622,274213,1053,7.7,1102,8.1,24210,7332,16878,2.7,8.8,31392,7492,23900,2.7,11.4,-7182,-2.6,17.6,0,686,686,4032
2011,31540,11247,13629,275668,272878,1107,8.2,988,7.3,29616,8988,20628,3.3,10.9,24035,5444,18591,2,8.8,5581,2.1,17.6,0,601,602,3174
2012,31540,11313,13725,282578,278994,1211,8.9,1101,8.1,35108,9826,25282,3.5,12.6,27939,8655,19284,3.1,10,7169,2.6,20,0,664,665,4121
2013,31540,11330,13770,286966,284233,1114,8.1,1056,7.7,31019,6766,24253,2.4,10.9,25553,6862,18691,2.4,9,5466,1.9,18,0,647,649,4065
2014,31540,11446,13854,293904,289940,1168,8.5,983,7.1,33077,9739,23338,3.4,11.4,25148,7419,17729,2.6,8.7,7929,2.7,17.4,0,651,654,4525
1977,31700,4981,5437,94341,91996,886,16.7,591,11.2,17297,6649,10648,7.2,18.8,12607,5328,7279,5.8,13.7,4690,5.1,27.4,0,409,411,2996
1978,31700,5296,5804,105800,100004,1009,18,642,11.4,23290,9783,13507,9.8,23.3,11697,4460,7237,4.5,11.7,11593,11.6,23.4,0,461,464,2335
1979,31700,5430,5982,115265,110448,865,14.7,658,11.2,22365,6834,15531,6.2,20.2,12731,5145,7586,4.7,11.5,9634,8.7,23,0,479,480,2434
1980,31700,5400,5960,117960,116586,737,12.3,722,12.1,19016,6441,12575,5.5,16.3,16267,5744,10523,4.9,14,2749,2.3,28,0,506,506,3267
1981,31700,5380,5932,118375,116951,780,13.2,733,12.4,23712,7385,16327,6.3,20.3,20864,9072,11792,7.8,17.8,2848,2.5,35.6,0,443,443,2196
1982,31700,5555,6188,121451,120513,934,15.4,630,10.4,18073,7903,10170,6.6,15,16197,5508,10689,4.6,13.4,1876,1.6,26.8,0,373,374,2547
1983,31700,5788,6403,122913,121623,804,12.8,614,9.8,17760,6326,11434,5.2,14.6,15179,5397,9782,4.4,12.5,2581,2.1,25,0,412,412,2861
1984,31700,6150,6820,143199,133500,1025,15.5,631,9.5,32723,15129,17594,11.3,24.5,13325,5395,7930,4,10,19398,14.5,20,0,424,425,2714
1985,31700,6597,7298,158069,151747,1157,16.4,725,10.2,31470,9604,21866,6.3,20.7,18825,8812,10013,5.8,12.4,12645,8.3,24.8,0,474,474,3920
1986,31700,7094,7846,156364,157062,1390,18.4,808,10.7,31036,13709,17327,8.7,19.8,32432,16228,16204,10.3,20.6,-1396,-0.8,39.6,0,529,529,4036
1987,31700,7612,8491,160671,159137,1610,19.7,938,11.5,29598,12757,16841,8,18.6,26530,9168,17362,5.8,16.7,3068,1.9,33.4,0,619,621,4846
1988,31700,7795,8737,159908,158472,1388,16.1,1088,12.7,29551,12585,16966,7.9,18.6,26679,8846,17833,5.6,16.8,2872,1.8,33.6,0,768,768,4935
1989,31700,7889,8901,161657,160955,1256,14.2,1107,12.6,26519,12310,14209,7.6,16.5,25115,8950,16165,5.6,15.6,1404,0.9,31.2,0,792,800,5369
1990,31700,7614,8657,152694,157019,1054,12,1216,13.9,20966,8493,12473,5.4,13.4,29616,10060,19556,6.4,18.9,-8650,-5.5,26.8,0,855,856,4992
1991,31700,7415,8490,142934,147576,998,11.6,1152,13.4,19055,8269,10786,5.6,12.9,28339,9219,19120,6.2,19.2,-9284,-6.3,25.8,0,778,783,5379
1992,31700,7386,8538,141004,141938,1070,12.5,982,11.5,22034,7977,14057,5.6,15.5,23901,7687,16214,5.4,16.8,-1867,-1.3,31,0,665,675,5403
1993,31700,7377,8527,142237,141555,930,10.9,914,10.7,21582,7365,14217,5.2,15.2,20218,6964,13254,4.9,14.3,1364,0.9,28.6,0,595,596,3311
1994,31700,7522,8680,144916,143542,1065,12.4,882,10.3,22246,7177,15069,5,15.5,19498,8427,11071,5.9,13.6,2748,1.9,27.2,0,537,538,3100
1995,31700,7734,8914,151897,148358,1093,12.4,846,9.6,23374,8964,14410,6,15.8,16295,5983,10312,4,11,7079,4.8,22,0,557,560,3119
1996,31700,7923,9105,158785,155545,1136,12.6,938,10.4,25368,8443,16925,5.4,16.3,18888,7302,11586,4.7,12.1,6480,4.2,24.2,0,583,583,3383
1997,31700,8131,9360,163438,161290,1195,12.9,969,10.5,28505,10445,18060,6.5,17.7,24208,7358,16850,4.6,15,4297,2.7,30,0,571,571,2995
1998,31700,8247,9447,167680,165476,1104,11.7,989,10.5,26518,8945,17573,5.4,16,22110,8027,14083,4.9,13.4,4408,2.6,26.8,0,622,622,3439
1999,31700,8327,9615,171852,169854,1082,11.4,912,9.6,25474,9628,15846,5.7,15,21477,6453,15024,3.8,12.6,3997,2.4,25.2,0,572,572,3761
2000,31700,8390,9706,180934,176289,1048,10.9,979,10.1,32464,11077,21387,6.3,18.4,23174,9153,14021,5.2,13.1,9290,5.3,26.2,0,556,556,3435
2001,31700,8456,9811,185862,183634,1077,11,1025,10.5,29238,9162,20076,5,15.9,24781,8799,15982,4.8,13.5,4457,2.4,27,0,610,610,4043
2002,31700,8356,9745,179273,182435,1065,10.9,1125,11.5,24261,8749,15512,4.8,13.3,30585,9399,21186,5.2,16.8,-6324,-3.5,26.6,0,585,585,3552
2003,31700,8404,9810,178316,178005,1058,10.9,856,8.8,24997,10765,14232,6,14,24375,6989,17386,3.9,13.7,622,0.3,27.4,0,545,545,3629
2004,31700,8515,9960,179048,178319,1070,10.8,837,8.5,21514,7461,14053,4.2,12.1,20056,7279,12777,4.1,11.2,1458,0.9,22.4,0,537,538,3782
2005,31700,8597,10100,183524,180954,1128,11.3,924,9.2,22557,8434,14123,4.7,12.5,17416,5146,12270,2.8,9.6,5141,2.9,19.2,0,633,633,2866
2006,31700,8608,10152,185796,184185,1109,11,944,9.4,25518,9956,15562,5.4,13.9,22295,6696,15599,3.6,12.1,3223,1.8,24.2,0,639,639,3557
2007,31700,8558,10151,185861,185476,1065,10.5,1020,10.1,25540,8195,17345,4.4,13.8,24770,6763,18007,3.6,13.4,770,0.4,26.8,0,644,644,4074
2008,31700,8584,10187,200532,192808,965,9.5,875,8.6,38772,8572,30200,4.4,20.1,23324,6618,16706,3.4,12.1,15448,8,24.2,0,594,594,4194
2009,31700,8301,9886,192202,196023,842,8.4,1045,10.4,22050,6150,15900,3.1,11.2,29692,6159,23533,3.1,15.1,-7642,-3.9,22.4,0,676,679,3532
2010,31700,8224,9814,197978,194740,831,8.5,837,8.5,29249,8770,20479,4.5,15,22773,6135,16638,3.2,11.7,6476,3.3,23.4,0,532,532,4061
2011,31700,8140,9740,194470,195870,858,8.8,864,8.9,20048,5838,14210,3,10.2,22848,6141,16707,3.1,11.7,-2800,-1.5,20.4,0,560,560,3842
2012,31700,8210,9825,186836,190291,942,9.7,831,8.5,22130,6071,16059,3.2,11.6,29039,14904,14135,7.8,15.3,-6909,-3.7,23.2,0,504,509,3196
2013,31700,8254,9931,189085,187677,924,9.4,817,8.3,22528,7193,15335,3.8,12,19712,5786,13926,3.1,10.5,2816,1.5,21,0,498,498,3063
2014,31700,8241,9986,193852,190724,877,8.8,748,7.5,25118,7724,17394,4,13.2,18862,5118,13744,2.7,9.9,6256,3.3,19.8,0,512,517,2780
1977,31740,1547,1675,16113,15699,286,17.2,245,14.8,3579,1815,1764,11.6,22.8,2751,1418,1333,9,17.5,828,5.3,35,0,172,172,736
1978,31740,1594,1726,17456,16774,251,14.8,195,11.5,3520,1177,2343,7,21,2155,954,1201,5.7,12.8,1365,8.2,25.6,0,145,146,687
1979,31740,1592,1728,18400,17928,195,11.3,187,10.8,3602,1274,2328,7.1,20.1,2657,892,1765,5,14.8,945,5.3,29.6,0,130,130,560
1980,31740,1602,1741,18299,18315,221,12.7,203,11.7,3388,1811,1577,9.9,18.5,3419,990,2429,5.4,18.7,-31,-0.2,37,0,136,136,615
1981,31740,1564,1698,18481,18353,213,12.4,235,13.7,3176,1520,1656,8.3,17.3,2919,1271,1648,6.9,15.9,257,1.4,31.8,0,140,141,632
1982,31740,1580,1736,19371,18898,264,15.4,193,11.2,3689,1639,2050,8.7,19.5,2742,924,1818,4.9,14.5,947,5,29,0,119,119,518
1983,31740,1650,1810,19345,19335,212,12,164,9.2,3808,1700,2108,8.8,19.7,3787,1168,2619,6,19.6,21,0.1,39.2,0,115,117,676
1984,31740,1671,1828,20139,19853,226,12.4,215,11.8,3856,1216,2640,6.1,19.4,3283,1488,1795,7.5,16.5,573,2.9,33,0,122,122,497
1985,31740,1722,1875,20238,20195,247,13.3,200,10.8,3831,2041,1790,10.1,19,3745,1396,2349,6.9,18.5,86,0.5,37,0,141,142,917
1986,31740,1725,1881,20391,20291,231,12.3,220,11.7,3668,1476,2192,7.3,18.1,3467,1608,1859,7.9,17.1,201,1,34.2,0,151,151,931
1987,31740,1749,1902,22086,21659,253,13.4,231,12.2,4080,1424,2656,6.6,18.8,3226,1263,1963,5.8,14.9,854,3.9,29.8,0,138,141,836
1988,31740,1756,1925,23069,22527,225,11.8,187,9.8,4146,1963,2183,8.7,18.4,3061,1218,1843,5.4,13.6,1085,4.8,27.2,0,131,131,897
1989,31740,1769,1952,24132,23605,232,12,208,10.7,4262,1593,2669,6.7,18.1,3208,1193,2015,5.1,13.6,1054,4.5,27.2,0,146,146,882
1990,31740,1777,1972,24239,24171,207,10.5,172,8.8,3816,1199,2617,5,15.8,3680,1734,1946,7.2,15.2,136,0.6,30.4,0,118,118,1248
1991,31740,1782,1977,23458,23774,214,10.8,204,10.3,3832,1977,1855,8.3,16.1,4463,1839,2624,7.7,18.8,-631,-2.7,32.2,0,122,122,992
1992,31740,1845,2041,25350,24386,275,13.7,200,9.9,5005,1942,3063,8,20.5,3077,1034,2043,4.2,12.6,1928,7.9,25.2,0,128,128,617
1993,31740,1877,2064,25720,25450,220,10.7,186,9.1,3775,1231,2544,4.8,14.8,3235,996,2239,3.9,12.7,540,2.1,25.4,0,132,133,712
1994,31740,1911,2105,27548,26617,239,11.5,199,9.6,5064,1857,3207,7,19,3202,1426,1776,5.4,12,1862,7,24,0,125,126,674
1995,31740,1957,2155,27496,27520,244,11.5,191,9,3487,1227,2260,4.5,12.7,3534,921,2613,3.3,12.8,-47,-0.1,25.4,0,135,135,514
1996,31740,2003,2213,28513,27989,255,11.7,193,8.8,4415,1715,2700,6.1,15.8,3367,1329,2038,4.7,12,1048,3.8,24,0,144,144,864
1997,31740,2005,2221,28373,28351,256,11.5,240,10.8,4941,2462,2479,8.7,17.4,4897,2017,2880,7.1,17.3,44,0.1,34.6,0,151,151,1071
1998,31740,1996,2208,28777,28600,247,11.2,259,11.7,4114,1857,2257,6.5,14.4,3760,1576,2184,5.5,13.1,354,1.3,26.2,0,182,182,805
1999,31740,1982,2191,30334,29791,227,10.3,248,11.3,5643,2575,3068,8.6,18.9,4557,2383,2174,8,15.3,1086,3.6,30.6,0,162,162,933
2000,31740,1975,2208,32638,31502,245,11.1,229,10.4,6033,3112,2921,9.9,19.2,3760,1314,2446,4.2,11.9,2273,7.3,23.8,0,145,145,812
2001,31740,1977,2215,33396,33062,220,9.9,234,10.6,4854,1529,3325,4.6,14.7,4186,1344,2842,4.1,12.7,668,2,25.4,0,137,137,767
2002,31740,2021,2239,31380,32280,270,12.1,238,10.7,4585,2002,2583,6.2,14.2,6384,2840,3544,8.8,19.8,-1799,-5.6,28.4,0,127,127,606
2003,31740,2051,2278,33047,32066,224,10,157,7,5471,1654,3817,5.2,17.1,3509,881,2628,2.7,10.9,1962,6.2,21.8,0,109,109,638
2004,31740,2070,2321,33729,33218,233,10.2,170,7.4,5737,1817,3920,5.5,17.3,4715,1672,3043,5,14.2,1022,3.1,28.4,0,108,108,559
2005,31740,2105,2368,34648,34156,234,10,167,7.1,5112,2039,3073,6,15,4127,958,3169,2.8,12.1,985,2.9,24.2,0,113,113,680
2006,31740,2125,2417,36471,35501,298,12.5,224,9.4,6502,2317,4185,6.5,18.3,4561,1385,3176,3.9,12.8,1941,5.5,25.6,0,133,133,723
2007,31740,2197,2491,37316,36766,302,12.3,226,9.2,6342,1879,4463,5.1,17.2,5241,2091,3150,5.7,14.3,1101,2.9,28.6,0,131,133,1097
2008,31740,2208,2511,37994,37562,237,9.5,205,8.2,5228,2075,3153,5.5,13.9,4363,1006,3357,2.7,11.6,865,2.3,23.2,0,152,152,779
2009,31740,2152,2472,36281,37083,182,7.3,199,8,3969,1443,2526,3.9,10.7,5573,1548,4025,4.2,15,-1604,-4.3,21.4,0,140,140,787
2010,31740,2131,2465,35986,35959,191,7.8,176,7.2,4152,1477,2675,4.1,11.5,4097,997,3100,2.8,11.4,55,0.1,22.8,0,104,104,419
2011,31740,2128,2471,35117,35502,194,7.9,177,7.2,4221,1462,2759,4.1,11.9,4990,1508,3482,4.2,14.1,-769,-2.2,23.8,0,119,119,741
2012,31740,2127,2471,35629,35399,185,7.5,191,7.7,4861,1553,3308,4.4,13.7,4400,1081,3319,3.1,12.4,461,1.3,24.8,0,115,116,616
2013,31740,2123,2451,35461,35406,174,7.1,188,7.7,4008,1452,2556,4.1,11.3,3897,1248,2649,3.5,11,111,0.3,22,0,118,118,781
2014,31740,2153,2481,36908,36045,226,9.2,173,7,4977,2620,2357,7.3,13.8,3251,984,2267,2.7,9,1726,4.8,18,0,115,115,688
1977,31860,1564,1660,23310,23020,245,15,175,10.7,4135,1972,2163,8.6,18,3555,1622,1933,7,15.4,580,2.6,30.8,0,108,108,707
1978,31860,1591,1687,25537,24432,208,12.4,181,10.8,5413,1881,3532,7.7,22.2,3202,1768,1434,7.2,13.1,2211,9.1,26.2,0,128,128,1234
1979,31860,1637,1742,29281,27376,220,12.8,160,9.3,6551,1338,5213,4.9,23.9,2741,1120,1621,4.1,10,3810,13.9,20,0,114,114,569
1980,31860,1653,1751,28791,29028,179,10.3,164,9.4,4447,1474,2973,5.1,15.3,4921,2028,2893,7,17,-474,-1.7,30.6,0,115,115,1504
1981,31860,1627,1723,28116,28034,184,10.6,190,11,4531,1954,2577,7,16.2,4367,1224,3143,4.4,15.6,164,0.6,31.2,0,111,111,652
1982,31860,1624,1745,28853,28526,193,11.1,157,9,4342,2244,2098,7.9,15.2,3688,1027,2661,3.6,12.9,654,2.3,25.8,0,89,89,548
1983,31860,1639,1762,26687,27779,173,9.9,176,10,3833,1604,2229,5.8,13.8,6017,1833,4184,6.6,21.7,-2184,-7.9,27.6,0,114,114,558
1984,31860,1711,1838,28566,27629,226,12.6,152,8.4,4604,1552,3052,5.6,16.7,2730,951,1779,3.4,9.9,1874,6.8,19.8,0,101,101,527
1985,31860,1717,1847,29735,29463,198,10.7,193,10.4,4565,1852,2713,6.3,15.5,4020,1391,2629,4.7,13.6,545,1.9,27.2,0,128,128,712
1986,31860,1692,1821,28975,29338,187,10.2,201,11,3813,1429,2384,4.9,13,4538,1075,3463,3.7,15.5,-725,-2.5,26,0,128,128,596
1987,31860,1681,1817,31048,30519,178,9.8,185,10.2,4048,1053,2995,3.5,13.3,2989,1119,1870,3.7,9.8,1059,3.5,19.6,0,109,109,716
1988,31860,1636,1779,31123,30715,160,8.9,188,10.5,4016,1263,2753,4.1,13.1,3200,1405,1795,4.6,10.4,816,2.7,20.8,0,111,111,581
1989,31860,1684,1817,32427,31809,175,9.7,132,7.3,4300,1451,2849,4.6,13.5,3064,1100,1964,3.5,9.6,1236,3.9,19.2,0,90,90,672
1990,31860,1673,1812,32671,32529,148,8.2,141,7.8,5252,2845,2407,8.7,16.1,4968,2799,2169,8.6,15.3,284,0.8,30.6,0,100,100,701
1991,31860,1727,1897,33516,33107,205,11.1,131,7.1,3760,1412,2348,4.3,11.4,2942,804,2138,2.4,8.9,818,2.5,17.8,0,86,86,538
1992,31860,1758,1935,34689,34105,210,10.9,172,9,4986,1961,3025,5.7,14.6,3817,1020,2797,3,11.2,1169,3.4,22.4,0,94,94,438
1993,31860,1782,1959,34888,34787,190,9.8,158,8.1,5863,3179,2684,9.1,16.9,5661,3453,2208,9.9,16.3,202,0.6,32.6,0,101,104,959
1994,31860,1791,1975,36167,35508,183,9.3,159,8.1,4237,1030,3207,2.9,11.9,2919,975,1944,2.7,8.2,1318,3.7,16.4,0,96,96,484
1995,31860,1827,2010,37778,36948,197,9.9,157,7.9,4764,2014,2750,5.5,12.9,3104,889,2215,2.4,8.4,1660,4.5,16.8,0,104,104,481
1996,31860,1838,2026,35999,36897,160,7.9,146,7.2,3946,1321,2625,3.6,10.7,5741,1436,4305,3.9,15.6,-1795,-4.9,21.4,0,88,88,675
1997,31860,1835,2026,36359,36221,193,9.5,201,9.9,4836,1701,3135,4.7,13.4,4559,1681,2878,4.6,12.6,277,0.8,25.2,0,106,106,802
1998,31860,1869,2063,39132,37744,201,9.8,162,7.9,5844,2371,3473,6.3,15.5,3068,814,2254,2.2,8.1,2776,7.4,16.2,0,100,100,535
1999,31860,1921,2125,40760,40137,211,10.1,144,6.9,5728,2714,3014,6.8,14.3,4482,1552,2930,3.9,11.2,1246,3.1,22.4,0,78,78,550
2000,31860,1939,2147,41997,41225,182,8.5,157,7.4,5151,1331,3820,3.2,12.5,3607,1191,2416,2.9,8.7,1544,3.8,17.4,0,87,87,619
2001,31860,1978,2227,43442,42776,221,10.1,152,6.9,6279,1952,4327,4.6,14.7,4947,1540,3407,3.6,11.6,1332,3.1,23.2,0,94,94,581
2002,31860,2017,2265,42515,42889,246,11,206,9.2,5009,1849,3160,4.3,11.7,5756,1296,4460,3,13.4,-747,-1.7,23.4,0,93,93,549
2003,31860,2041,2279,44441,43296,227,10.1,175,7.8,5856,1853,4003,4.3,13.5,3566,1039,2527,2.4,8.2,2290,5.3,16.4,0,99,99,526
2004,31860,2059,2301,44668,44461,207,9.1,165,7.2,4898,1965,2933,4.4,11,4484,1405,3079,3.2,10.1,414,0.9,20.2,0,107,107,645
2005,31860,2107,2350,44763,44478,210,9.1,149,6.4,4637,1659,2978,3.7,10.4,4067,1449,2618,3.3,9.1,570,1.3,18.2,0,99,99,781
2006,31860,2050,2345,47398,46000,235,10,220,9.4,7438,3648,3790,7.9,16.2,4642,1941,2701,4.2,10.1,2796,6.1,20.2,0,142,142,1654
2007,31860,2081,2377,47862,47551,241,10.2,202,8.6,6611,2573,4038,5.4,13.9,5988,1845,4143,3.9,12.6,623,1.3,25.2,0,100,100,671
2008,31860,2075,2363,47656,47629,196,8.3,187,7.9,5408,1818,3590,3.8,11.4,5353,1509,3844,3.2,11.2,55,0.2,22.4,0,134,134,864
2009,31860,2025,2312,45962,46561,169,7.3,206,8.8,4973,2069,2904,4.4,10.7,6171,1527,4644,3.3,13.3,-1198,-2.6,21.4,0,127,127,773
2010,31860,2026,2324,45234,45480,178,7.7,154,6.7,4322,1238,3084,2.7,9.5,4814,897,3917,2,10.6,-492,-1.1,19,0,99,99,603
2011,31860,2021,2334,45882,45670,169,7.3,155,6.7,4323,1087,3236,2.4,9.5,3898,1338,2560,2.9,8.5,425,1,17,0,104,104,875
2012,31860,2063,2364,46963,46306,189,8.1,155,6.6,5491,1614,3877,3.5,11.9,4177,1342,2835,2.9,9,1314,2.9,18,0,94,94,893
2013,31860,2034,2330,46774,46885,130,5.6,161,6.9,4051,987,3064,2.1,8.6,4272,1232,3040,2.6,9.1,-221,-0.5,17.2,0,105,105,690
2014,31860,2018,2319,47712,47205,142,6.1,138,6,4448,1344,3104,2.8,9.4,3434,882,2552,1.9,7.3,1014,2.1,14.6,0,92,92,386
1977,31900,2122,2361,44654,43939,323,13.8,286,12.2,7079,2572,4507,5.9,16.1,5650,3035,2615,6.9,12.9,1429,3.2,25.8,0,165,168,1880
1978,31900,2143,2395,45834,45241,281,11.8,247,10.4,6610,1745,4865,3.9,14.6,5423,1315,4108,2.9,12,1187,2.6,24,0,170,170,761
1979,31900,2131,2394,47469,46628,258,10.8,243,10.1,6898,1933,4965,4.1,14.8,5216,1499,3717,3.2,11.2,1682,3.6,22.4,0,163,163,870
1980,31900,2141,2406,48596,48008,258,10.8,244,10.2,6931,3124,3807,6.5,14.4,5755,1360,4395,2.8,12,1176,2.4,24,0,161,161,712
1981,31900,2088,2340,46480,47195,252,10.6,288,12.2,5174,2202,2972,4.7,11,6604,1665,4939,3.5,14,-1430,-3,22,0,161,161,618
1982,31900,2045,2318,45074,45733,247,10.6,232,10,5640,1314,4326,2.9,12.3,6958,1487,5471,3.3,15.2,-1318,-2.9,24.6,0,129,129,755
1983,31900,2088,2356,43947,44527,211,9,192,8.2,5487,1338,4149,3,12.3,6646,1307,5339,2.9,14.9,-1159,-2.6,24.6,0,105,105,530
1984,31900,2149,2419,47205,45574,295,12.4,232,9.7,7301,2139,5162,4.7,16,4039,1278,2761,2.8,8.9,3262,7.1,17.8,0,126,126,355
1985,31900,2162,2419,45964,46556,267,11,262,10.8,5574,1606,3968,3.4,12,6758,3027,3731,6.5,14.5,-1184,-2.5,24,0,160,160,1443
1986,31900,2223,2477,47104,46537,296,12.1,234,9.6,6425,2304,4121,5,13.8,5290,1836,3454,3.9,11.4,1135,2.4,22.8,0,156,156,1429
1987,31900,2240,2512,47529,47292,296,11.9,255,10.2,6133,1930,4203,4.1,13,5659,1965,3694,4.2,12,474,1,24,0,160,161,1063
1988,31900,2283,2563,47220,47269,311,12.3,252,9.9,6672,2441,4231,5.2,14.1,6770,2818,3952,6,14.3,-98,-0.2,28.2,0,146,146,773
1989,31900,2330,2624,50294,48757,288,11.1,228,8.8,8679,3846,4833,7.9,17.8,5605,1699,3906,3.5,11.5,3074,6.3,23,0,154,154,1203
1990,31900,2330,2628,50203,50227,253,9.6,233,8.9,6359,2549,3810,5.1,12.7,6406,1970,4436,3.9,12.8,-47,-0.1,25.4,0,155,157,987
1991,31900,2334,2635,47369,48751,232,8.8,226,8.6,5390,1590,3800,3.3,11.1,8153,3275,4878,6.7,16.7,-2763,-5.6,22.2,0,141,141,1006
1992,31900,2355,2674,47068,47237,251,9.4,213,8,5669,2009,3660,4.3,12,6006,1254,4752,2.7,12.7,-337,-0.7,24,0,132,134,662
1993,31900,2381,2681,48540,47781,242,9,229,8.6,6546,1675,4871,3.5,13.7,5027,2048,2979,4.3,10.5,1519,3.2,21,0,139,139,728
1994,31900,2401,2693,50514,49538,238,8.9,216,8,7261,2643,4618,5.3,14.7,5308,1579,3729,3.2,10.7,1953,4,21.4,0,140,140,750
1995,31900,2490,2787,52949,51730,298,10.9,205,7.5,7960,2896,5064,5.6,15.4,5522,2066,3456,4,10.7,2438,4.7,21.4,0,128,128,1090
1996,31900,2504,2806,56747,54892,273,9.8,249,8.9,11372,2738,8634,5,20.7,7661,2246,5415,4.1,14,3711,6.7,28,0,165,165,1182
1997,31900,2507,2801,56667,56702,265,9.4,267,9.5,6512,2205,4307,3.9,11.5,6581,2347,4234,4.1,11.6,-69,-0.1,23,0,147,147,866
1998,31900,2501,2799,53255,54947,263,9.4,262,9.4,8071,2690,5381,4.9,14.7,11455,7428,4027,13.5,20.8,-3384,-6.1,29.4,0,174,174,5811
1999,31900,2477,2799,53739,53478,242,8.6,238,8.5,7362,2113,5249,4,13.8,6839,2604,4235,4.9,12.8,523,1,25.6,0,161,161,1078
2000,31900,2439,2754,51339,52600,222,8,260,9.4,6399,2002,4397,3.8,12.2,8920,2325,6595,4.4,17,-2521,-4.8,24.4,0,155,155,739
2001,31900,2420,2757,51389,51396,251,9.1,267,9.7,7439,3007,4432,5.9,14.5,7453,2094,5359,4.1,14.5,-14,0,29,0,150,150,1027
2002,31900,2434,2742,49403,50238,278,10.1,284,10.3,6877,3152,3725,6.3,13.7,8547,3161,5386,6.3,17,-1670,-3.3,27.4,0,113,113,1106
2003,31900,2437,2726,49512,49127,234,8.6,209,7.7,6209,2076,4133,4.2,12.6,5439,1275,4164,2.6,11.1,770,1.5,22.2,0,130,130,784
2004,31900,2441,2733,49619,49213,247,9.1,212,7.8,5671,1589,4082,3.2,11.5,4859,1286,3573,2.6,9.9,812,1.6,19.8,0,141,141,851
2005,31900,2457,2762,50880,50120,262,9.6,207,7.6,7173,2561,4612,5.1,14.3,5652,1559,4093,3.1,11.3,1521,3,22.6,0,136,136,1071
2006,31900,2407,2730,50873,50643,229,8.4,231,8.4,6190,1935,4255,3.8,12.2,5729,1819,3910,3.6,11.3,461,0.9,22.6,0,148,148,1180
2007,31900,2384,2705,50571,50640,226,8.3,247,9.1,7250,2167,5083,4.3,14.3,7388,1976,5412,3.9,14.6,-138,-0.3,28.6,0,148,148,756
2008,31900,2353,2666,49435,49615,186,7,200,7.5,4999,2153,2846,4.3,10.1,5358,1062,4296,2.1,10.8,-359,-0.7,20.2,0,139,139,653
2009,31900,2280,2586,44422,46715,161,6.2,214,8.2,4127,908,3219,1.9,8.8,8713,1482,7231,3.2,18.7,-4586,-9.9,17.6,0,141,142,761
2010,31900,2211,2510,43025,43504,160,6.3,196,7.7,4816,1455,3361,3.3,11.1,5773,1626,4147,3.7,13.3,-957,-2.2,22.2,0,121,121,864
2011,31900,2148,2442,42424,42592,174,7.1,223,9,4370,1420,2950,3.3,10.3,4706,1455,3251,3.4,11,-336,-0.7,20.6,0,148,148,825
2012,31900,2136,2430,43489,43056,185,7.6,187,7.7,5043,1652,3391,3.8,11.7,4176,1184,2992,2.7,9.7,867,2,19.4,0,109,110,608
2013,31900,2143,2435,43494,43482,147,6.1,145,6,3695,911,2784,2.1,8.5,3671,678,2993,1.6,8.4,24,0.1,16.8,0,87,87,393
2014,31900,2080,2378,42984,43176,159,6.6,201,8.4,3972,1096,2876,2.5,9.2,4356,1208,3148,2.8,10.1,-384,-0.9,18.4,0,136,138,706
1977,32580,3508,3901,46530,45219,757,20.1,461,12.3,11036,5312,5724,11.7,24.4,8414,2924,5490,6.5,18.6,2622,5.8,37.2,0,325,326,1951
1978,32580,3333,3710,48098,47192,537,14.1,669,17.6,10784,3779,7005,8,22.9,8972,5599,3373,11.9,19,1812,3.9,38,0,390,390,3479
1979,32580,3646,4031,51036,49683,614,15.9,330,8.5,11397,4997,6400,10.1,22.9,8690,2706,5984,5.4,17.5,2707,5.4,35,1,6,6,
1980,32580,2793,3156,49660,48912,157,4.4,625,17.4,9990,1125,8865,2.3,20.4,8493,4093,4400,8.4,17.4,1497,3,34.8,0,454,484,3141
1981,32580,3753,4145,57729,55364,838,23,389,10.7,13240,6492,6748,11.7,23.9,8509,2609,5900,4.7,15.4,4731,8.5,30.8,0,233,233,1321
1982,32580,4117,4627,65490,61565,955,21.8,447,10.2,17998,8810,9188,14.3,29.2,10147,3982,6165,6.5,16.5,7851,12.7,33,0,278,278,1684
1983,32580,4175,4692,61621,63404,663,14.2,600,12.9,11556,4950,6606,7.8,18.2,15121,4450,10671,7,23.8,-3565,-5.6,36.4,0,424,424,2930
1984,32580,4182,4749,63473,62535,715,15.2,649,13.8,14905,5962,8943,9.5,23.8,13028,4159,8869,6.7,20.8,1877,3,41.6,0,434,434,2474
1985,32580,4266,4797,67864,66004,693,14.5,639,13.4,13655,3955,9700,6,20.7,9934,3698,6236,5.6,15.1,3721,5.6,30.2,0,403,405,2492
1986,32580,4299,4840,67229,67287,690,14.3,606,12.6,13653,6334,7319,9.4,20.3,13769,3782,9987,5.6,20.5,-116,-0.2,40.6,0,415,415,2420
1987,32580,4315,4877,67602,67640,759,15.6,699,14.4,12953,5668,7285,8.4,19.1,13030,5393,7637,8,19.3,-77,-0.2,38.2,0,447,450,3290
1988,32580,4370,4967,69575,67983,710,14.4,601,12.2,13624,5050,8574,7.4,20,10440,3670,6770,5.4,15.4,3184,4.6,30.8,0,411,411,1928
1989,32580,4567,5199,74774,72522,776,15.3,561,11,15601,4812,10789,6.6,21.5,11096,3709,7387,5.1,15.3,4505,6.2,30.6,0,392,394,2659
1990,32580,4785,5455,75373,74734,813,15.3,500,9.4,13549,5871,7678,7.9,18.1,12270,2561,9709,3.4,16.4,1279,1.7,32.8,0,359,359,1792
1991,32580,4926,5631,79345,77488,822,14.8,629,11.4,16666,6752,9914,8.7,21.5,12952,5025,7927,6.5,16.7,3714,4.8,33.4,0,422,425,2754
1992,32580,5067,5846,80691,79555,881,15.3,629,11,16173,6850,9323,8.6,20.3,13901,4892,9009,6.1,17.5,2272,2.8,35,0,428,432,2442
1993,32580,5209,5989,84033,82014,823,13.9,657,11.1,17610,6161,11449,7.5,21.5,13572,4859,8713,5.9,16.5,4038,5,33,0,468,471,2770
1994,32580,5410,6202,85833,84771,878,14.4,643,10.6,15856,7199,8657,8.5,18.7,13731,5248,8483,6.2,16.2,2125,2.5,32.4,0,465,466,2715
1995,32580,5631,6424,90591,88126,943,14.9,686,10.9,17613,7273,10340,8.3,20,12682,4853,7829,5.5,14.4,4931,5.6,28.8,0,499,514,3117
1996,32580,5753,6568,91597,90867,922,14.2,754,11.6,14890,6090,8800,6.7,16.4,13430,4072,9358,4.5,14.8,1460,1.6,29.6,0,507,507,2242
1997,32580,5951,6858,96116,94018,1091,16.2,804,12,19804,8277,11527,8.8,21.1,15608,5857,9751,6.2,16.6,4196,4.5,33.2,0,556,556,3343
1998,32580,6071,6998,100360,98136,945,13.6,778,11.2,18204,6867,11337,7,18.5,13756,5011,8745,5.1,14,4448,4.5,28,0,539,539,2890
1999,32580,6235,7248,107865,104375,1058,14.9,818,11.5,21444,8537,12907,8.2,20.5,14464,5963,8501,5.7,13.9,6980,6.6,27.8,0,577,577,4072
2000,32580,6317,7381,116396,112176,980,13.4,872,11.9,25854,9351,16503,8.3,23,17413,6583,10830,5.9,15.5,8441,7.5,31,0,556,556,3111
2001,32580,6441,7562,126171,121506,980,13.1,891,11.9,26820,10626,16194,8.7,22.1,17489,6522,10967,5.4,14.4,9331,7.7,28.8,0,544,544,3145
2002,32580,6611,7775,126586,126105,1149,15,964,12.5,25174,11024,14150,8.7,20,24212,10173,14039,8.1,19.2,962,0.8,38.4,0,571,571,3801
2003,32580,6796,8035,135384,130222,1182,15,788,10,27715,9769,17946,7.5,21.3,17390,7421,9969,5.7,13.4,10325,7.9,26.8,0,551,551,3253
2004,32580,7022,8326,142499,138426,1120,13.7,741,9.1,29056,9971,19085,7.2,21,20909,4564,16345,3.3,15.1,8147,5.9,30.2,0,534,534,2991
2005,32580,7338,8728,150092,146019,1256,14.8,787,9.3,30569,13053,17516,8.9,20.9,22423,5994,16429,4.1,15.4,8146,5.5,30.8,0,584,584,4063
2006,32580,7422,8911,156991,152199,1238,14.1,965,11,31284,12512,18772,8.2,20.6,21700,8935,12765,5.9,14.3,9584,6.3,28.6,0,695,695,6009
2007,32580,7735,9420,164754,160373,1461,15.9,948,10.3,32880,13085,19795,8.2,20.5,24118,8168,15950,5.1,15,8762,5.5,30,0,626,627,4915
2008,32580,7892,9689,171792,167998,1234,13,877,9.2,30586,12403,18183,7.4,18.2,22997,7072,15925,4.2,13.7,7589,4.5,27.4,0,719,719,5587
2009,32580,7883,9753,165987,168667,1061,10.9,944,9.7,22644,9136,13508,5.4,13.4,28004,10045,17959,6,16.6,-5360,-3.2,26.8,0,738,738,8049
2010,32580,8014,9984,167852,166588,1119,11.4,835,8.5,25847,9809,16038,5.9,15.5,23319,5684,17635,3.4,14,2528,1.5,28,0,600,600,3805
2011,32580,8178,10132,169234,168401,1172,11.7,986,9.8,23973,8526,15447,5.1,14.2,22306,7243,15063,4.3,13.2,1667,1,26.4,0,689,705,4856
2012,32580,8475,10467,174838,171942,1303,12.7,978,9.5,26644,9445,17199,5.5,15.5,20852,6543,14309,3.8,12.1,5792,3.4,24.2,0,658,664,3418
2013,32580,8665,10679,176723,175630,1115,10.6,958,9.1,24703,7943,16760,4.5,14.1,22516,7287,15229,4.1,12.8,2187,1.3,25.6,0,680,685,5259
2014,32580,8674,10725,180549,178309,1133,10.6,999,9.4,26959,9981,16978,5.6,15.1,22478,8074,14404,4.5,12.6,4481,2.5,25.2,0,780,781,5285
1977,32780,2399,2561,28660,27681,540,21.7,379,15.2,6841,3406,3435,12.3,24.7,4882,2417,2465,8.7,17.6,1959,7.1,35.2,0,258,259,1481
1978,32780,2544,2712,33426,30990,578,21.9,417,15.8,9111,3224,5887,10.4,29.4,4239,2386,1853,7.7,13.7,4872,15.7,27.4,0,293,293,1278
1979,32780,2650,2843,33902,33598,567,20.4,400,14.4,8845,5168,3677,15.4,26.3,8236,3315,4921,9.9,24.5,609,1.8,49,0,277,280,1456
1980,32780,2707,2910,34314,34145,544,18.9,466,16.2,6909,3227,3682,9.5,20.2,6571,2767,3804,8.1,19.2,338,1,38.4,0,334,335,1673
1981,32780,2612,2801,32668,33007,460,16.2,521,18.3,5763,2369,3394,7.2,17.5,6440,2599,3841,7.9,19.5,-677,-2,35,0,337,340,1579
1982,32780,2570,2796,29807,31207,473,16.9,437,15.6,5554,2786,2768,8.9,17.8,8354,2667,5687,8.5,26.8,-2800,-9,35.6,0,247,247,1367
1983,32780,2619,2842,31382,30522,412,14.6,388,13.8,6576,2269,4307,7.4,21.5,4855,1875,2980,6.1,15.9,1721,5.6,31.8,0,254,254,1218
1984,32780,2793,3037,34386,32916,526,17.9,343,11.7,7960,2873,5087,8.7,24.2,5020,1553,3467,4.7,15.3,2940,8.9,30.6,0,249,249,1081
1985,32780,2900,3143,36082,35628,498,16.1,398,12.9,6705,2580,4125,7.2,18.8,5797,2302,3495,6.5,16.3,908,2.5,32.6,0,286,287,1539
1986,32780,3013,3257,37000,36515,523,16.3,400,12.5,7098,2840,4258,7.8,19.4,6127,2855,3272,7.8,16.8,971,2.6,33.6,0,283,283,1602
1987,32780,3133,3422,40186,38386,651,19.5,454,13.6,9317,4317,5000,11.2,24.3,5717,2577,3140,6.7,14.9,3600,9.4,29.8,0,313,314,1642
1988,32780,3098,3416,41853,40482,521,15.3,489,14.3,11212,5709,5503,14.1,27.7,8470,3163,5307,7.8,20.9,2742,6.8,41.8,0,319,319,1460
1989,32780,2813,3116,40148,41098,428,13.1,726,22.2,7182,2849,4333,6.9,17.5,9081,5610,3471,13.7,22.1,-1899,-4.6,35,0,280,280,1893
1990,32780,3289,3615,47006,43516,829,24.6,302,9,12687,7092,5595,16.3,29.2,5706,1966,3740,4.5,13.1,6981,16.1,26.2,0,202,202,1321
1991,32780,3415,3767,46400,46616,551,14.9,380,10.3,8329,3821,4508,8.2,17.9,8760,2890,5870,6.2,18.8,-431,-0.9,35.8,0,267,267,2100
1992,32780,3482,3839,46841,46562,509,13.4,421,11.1,8477,3312,5165,7.1,18.2,7919,2321,5598,5,17,558,1.2,34,0,285,290,1611
1993,32780,3563,3931,48025,47350,526,13.5,411,10.6,8377,3161,5216,6.7,17.7,7027,2967,4060,6.3,14.8,1350,2.9,29.6,0,281,282,1750
1994,32780,3682,4068,50152,49038,549,13.7,393,9.8,9069,3682,5387,7.5,18.5,6841,2656,4185,5.4,14,2228,4.5,28,0,263,263,1782
1995,32780,3754,4133,52943,51504,568,13.9,478,11.7,9563,3464,6099,6.7,18.6,6685,2396,4289,4.7,13,2878,5.6,26,0,317,321,1412
1996,32780,3866,4256,54739,53871,595,14.2,451,10.8,8972,2959,6013,5.5,16.7,7235,2559,4676,4.8,13.4,1737,3.3,26.8,0,326,326,1506
1997,32780,3975,4375,56875,55828,639,14.8,512,11.8,11241,4982,6259,8.9,20.1,9147,3704,5443,6.6,16.4,2094,3.7,32.8,0,334,334,1699
1998,32780,4020,4426,56799,56726,549,12.5,478,10.9,8783,3123,5660,5.5,15.5,8637,3071,5566,5.4,15.2,146,0.3,30.4,0,306,306,1342
1999,32780,4106,4542,59305,58074,611,13.6,484,10.8,10334,3924,6410,6.8,17.8,7871,2884,4987,5,13.6,2463,4.2,27.2,0,341,341,1891
2000,32780,4174,4611,60714,60073,592,12.9,540,11.8,10923,4552,6371,7.6,18.2,9640,3908,5732,6.5,16,1283,2.2,32,0,334,334,2012
2001,32780,4353,4818,62356,61638,668,14.1,516,10.9,10562,4471,6091,7.3,17.1,9126,3452,5674,5.6,14.8,1436,2.3,29.6,0,330,330,1900
2002,32780,4405,4889,61689,61897,669,13.8,574,11.9,9316,4046,5270,6.5,15.1,9732,3835,5897,6.2,15.7,-416,-0.6,30.2,0,342,343,1733
2003,32780,4554,5074,64156,62708,707,14.2,467,9.4,10286,3756,6530,6,16.4,7390,2323,5067,3.7,11.8,2896,4.6,23.6,0,319,319,1521
2004,32780,4664,5207,67014,65483,675,13.1,494,9.6,10310,3487,6823,5.3,15.7,7248,2692,4556,4.1,11.1,3062,4.6,22.2,0,334,334,1622
2005,32780,4888,5463,69775,68033,811,15.2,521,9.8,10912,4166,6746,6.1,16,7428,2955,4473,4.3,10.9,3484,5.1,21.8,0,371,371,1897
2006,32780,4990,5592,70609,70026,745,13.5,575,10.4,9872,3890,5982,5.6,14.1,8706,3124,5582,4.5,12.4,1166,1.7,24.8,0,431,431,2474
2007,32780,5065,5697,71693,71131,688,12.2,598,10.6,11125,3746,7379,5.3,15.6,10001,3442,6559,4.8,14.1,1124,1.5,28.2,0,399,399,1835
2008,32780,4923,5567,70150,70686,530,9.4,598,10.7,8128,2749,5379,3.9,11.5,9199,2397,6802,3.4,13,-1071,-1.5,23,0,472,472,1993
2009,32780,4647,5305,64331,67029,449,8.3,650,12,6376,2554,3822,3.8,9.5,11772,2381,9391,3.6,17.6,-5396,-8.1,19,0,459,459,1662
2010,32780,4539,5192,62888,63529,457,8.7,549,10.5,7450,2701,4749,4.3,11.7,8732,2566,6166,4,13.7,-1282,-2,23.4,0,373,374,1853
2011,32780,4459,5094,61864,62309,452,8.8,519,10.1,6430,1925,4505,3.1,10.3,7320,2089,5231,3.4,11.7,-890,-1.4,20.6,0,349,358,1349
2012,32780,4520,5149,62637,62133,547,10.7,496,9.7,8801,2695,6106,4.3,14.2,7793,2578,5215,4.1,12.5,1008,1.7,25,0,281,281,1334
2013,32780,4579,5207,65520,63913,510,9.9,468,9.1,9925,3012,6913,4.7,15.5,6711,2657,4054,4.2,10.5,3214,5,21,0,302,304,1936
2014,32780,4643,5272,67239,66248,535,10.2,446,8.5,9447,3667,5780,5.5,14.3,7465,2597,4868,3.9,11.3,1982,3,22.6,0,313,313,1220
1977,32820,14494,17246,314347,296309,3024,17.8,2447,14.4,83063,41764,41299,14.1,28,46987,20959,26028,7.1,15.9,36076,12.1,31.8,0,1640,1649,13265
1978,32820,14591,17362,309604,312122,2422,14,2300,13.3,61804,18942,42862,6.1,19.8,66840,20442,46398,6.5,21.4,-5036,-1.6,39.6,0,1533,1538,9325
1979,32820,14897,17782,325391,317290,2499,14.2,1998,11.4,64779,21429,43350,6.8,20.4,48577,17875,30702,5.6,15.3,16202,5.1,30.6,0,1296,1300,7827
1980,32820,15087,18042,314235,319693,2420,13.5,2132,11.9,53242,20653,32589,6.5,16.7,64158,18904,45254,5.9,20.1,-10916,-3.4,33.4,0,1479,1484,8735
1981,32820,14636,17480,316865,314040,2122,12,2523,14.2,55295,18347,36948,5.8,17.6,49644,18812,30832,6,15.8,5651,1.8,31.6,0,1547,1550,8252
1982,32820,14626,17797,315427,316905,2665,15.1,2171,12.3,53996,27345,26651,8.6,17,56951,15406,41545,4.9,18,-2955,-1,34,0,1195,1195,6374
1983,32820,14983,18142,319713,316735,2237,12.5,2029,11.3,57462,19517,37945,6.2,18.1,51506,16864,34642,5.3,16.3,5956,1.8,32.6,0,1310,1315,7865
1984,32820,15446,18657,337353,328851,2588,14.1,2074,11.3,65104,23382,41722,7.1,19.8,48099,18009,30090,5.5,14.6,17005,5.2,29.2,0,1298,1301,7518
1985,32820,15752,18981,356899,347733,2472,13.1,2149,11.4,66581,22702,43879,6.5,19.1,48249,19036,29213,5.5,13.9,18332,5.2,27.8,0,1330,1359,8454
1986,32820,16252,19498,363439,359856,2681,13.9,2101,10.9,64838,25184,39654,7,18,57671,20991,36680,5.8,16,7167,2,32,0,1359,1361,10457
1987,32820,16501,19970,367834,367392,2909,14.7,2333,11.8,71658,26868,44790,7.3,19.5,70774,33339,37435,9.1,19.3,884,0.2,38.6,0,1486,1492,10580
1988,32820,16676,20532,392019,377868,3003,14.8,2293,11.3,91840,45747,46093,12.1,24.3,63538,24176,39362,6.4,16.8,28302,7.5,33.6,0,1483,1483,10698
1989,32820,16753,20866,411349,403179,2651,12.8,2387,11.5,76633,29241,47392,7.3,19,60292,23185,37107,5.8,15,16341,4,30,0,1524,1583,15354
1990,32820,16943,21226,417191,414630,2589,12.3,2113,10,66536,24277,42259,5.9,16,61414,19772,41642,4.8,14.8,5122,1.2,29.6,0,1390,1391,9629
1991,32820,17204,21568,421226,419046,2612,12.2,2270,10.6,69940,27628,42312,6.6,16.7,65579,23203,42376,5.5,15.6,4361,1.1,31.2,0,1322,1329,11735
1992,32820,17365,21604,429383,424454,2669,12.3,2562,11.9,80309,25653,54656,6,18.9,70451,28218,42233,6.6,16.6,9858,2.3,33.2,0,1450,1463,10850
1993,32820,17690,21963,435639,432387,2579,11.8,2186,10,75752,30437,45315,7,17.5,69248,20183,49065,4.7,16,6504,1.5,32,0,1368,1382,8369
1994,32820,17912,22235,447407,441188,2553,11.6,2201,10,74232,27727,46505,6.3,16.8,61794,21673,40121,4.9,14,12438,2.8,28,0,1413,1416,8708
1995,32820,18084,22593,493134,471015,2676,11.9,2257,10.1,107374,34181,73193,7.3,22.8,63137,18544,44593,3.9,13.4,44237,9.4,26.8,0,1470,1487,8380
1996,32820,18338,23190,494641,494377,2861,12.5,2231,9.7,85680,37025,48655,7.5,17.3,85152,38582,46570,7.8,17.2,528,0.1,34.4,0,1432,1432,27654
1997,32820,18490,23451,517368,506006,2865,12.3,2630,11.3,97405,33495,63910,6.6,19.2,74681,25736,48945,5.1,14.8,22724,4.4,29.6,0,1465,1465,10688
1998,32820,18520,23681,536985,527260,2810,11.9,2514,10.7,96725,37988,58737,7.2,18.3,77274,28585,48689,5.4,14.7,19451,3.6,29.4,0,1532,1532,11899
1999,32820,18498,23799,547971,543016,2663,11.2,2544,10.7,88942,33630,55312,6.2,16.4,79031,29923,49108,5.5,14.6,9911,1.8,29.2,0,1529,1529,12952
2000,32820,18348,23836,570211,558647,2685,11.3,2663,11.2,111375,37998,73377,6.8,19.9,88247,32874,55373,5.9,15.8,23128,4.1,31.6,0,1473,1473,10180
2001,32820,18262,23990,564110,568491,2804,11.7,2834,11.8,99329,37056,62273,6.5,17.5,108090,45089,63001,7.9,19,-8761,-1.5,35,0,1500,1501,18097
2002,32820,18093,23775,530557,545494,2804,11.8,2971,12.5,85652,37636,48016,6.9,15.7,115526,39160,76366,7.2,21.2,-29874,-5.5,31.4,0,1502,1506,10985
2003,32820,18214,23792,524979,523466,2831,12,2290,9.7,91451,37426,54025,7.1,17.5,88424,25638,62786,4.9,16.9,3027,0.6,33.8,0,1473,1475,12257
2004,32820,18403,24032,530462,525320,2702,11.3,2208,9.3,83039,27686,55353,5.3,15.8,72755,27685,45070,5.3,13.8,10284,2,27.6,0,1468,1469,11990
2005,32820,18516,24247,538746,531803,2690,11.2,2226,9.3,86220,33803,52417,6.4,16.2,72334,21990,50344,4.1,13.6,13886,2.6,27.2,0,1456,1459,13389
2006,32820,18591,24719,558525,547354,3043,12.5,2351,9.6,94577,37749,56828,6.9,17.3,72234,22692,49542,4.1,13.2,22343,4.1,26.4,0,1482,1489,10731
2007,32820,18707,24906,568604,562144,2895,11.7,2618,10.6,105742,31939,73803,5.7,18.8,92822,30419,62403,5.4,16.5,12920,2.3,33,0,1485,1496,11259
2008,32820,18411,25013,563418,563638,2645,10.7,2236,9,85237,35415,49822,6.3,15.1,85676,19398,66278,3.4,15.2,-439,-0.1,30.2,0,1616,1618,11507
2009,32820,17910,24343,526531,543287,2006,8.2,2404,9.8,59912,22343,37569,4.1,11,93423,21281,72142,3.9,17.2,-33511,-6.2,22,0,1601,1615,13110
2010,32820,17559,23984,515573,518783,1958,8.1,2049,8.5,61752,19965,41787,3.8,11.9,68171,17843,50328,3.4,13.1,-6419,-1.2,23.8,0,1362,1369,9752
2011,32820,17332,23675,519302,516376,1943,8.2,2049,8.6,62511,16505,46006,3.2,12.1,56659,18004,38655,3.5,11,5852,1.1,22,0,1333,1362,8715
2012,32820,17301,23580,529139,523395,2000,8.5,2069,8.8,67708,18403,49305,3.5,12.9,56220,18764,37456,3.6,10.7,11488,2.2,21.4,0,1177,1183,7401
2013,32820,17309,23496,538797,532961,1850,7.9,1872,8,66964,18794,48170,3.5,12.6,55291,14218,41073,2.7,10.4,11673,2.2,20.8,0,1181,1186,7565
2014,32820,17190,23491,532403,533593,2002,8.6,1755,7.5,59370,17386,41984,3.3,11.1,61749,17608,44141,3.3,11.6,-2379,-0.5,22.2,0,1242,1245,8534
1977,32900,1870,2015,20377,20347,373,19,246,12.6,4806,1922,2884,9.4,23.6,4745,1245,3500,6.1,23.3,61,0.3,46.6,0,170,170,933
1978,32900,1901,2059,21969,21182,329,16.2,289,14.2,5040,2253,2787,10.6,23.8,3466,1484,1982,7,16.4,1574,7.4,32.8,0,175,175,688
1979,32900,1994,2167,23804,22872,370,17.5,251,11.9,5200,2132,3068,9.3,22.7,3335,1233,2102,5.4,14.6,1865,8.1,29.2,0,179,180,749
1980,32900,2031,2213,24125,23935,339,15.5,282,12.9,4736,1876,2860,7.8,19.8,4356,1698,2658,7.1,18.2,380,1.6,36.4,0,203,203,783
1981,32900,1935,2104,22313,23054,269,12.5,350,16.2,3639,1427,2212,6.2,15.8,5120,2811,2309,12.2,22.2,-1481,-6.4,31.6,0,211,211,1034
1982,32900,1937,2136,22603,22390,330,15.6,269,12.7,4261,2135,2126,9.5,19,3835,1436,2399,6.4,17.1,426,1.9,34.2,0,155,155,805
1983,32900,1963,2148,23513,22876,224,10.5,229,10.7,5228,1497,3731,6.5,22.9,3954,1036,2918,4.5,17.3,1274,5.6,34.6,0,137,137,531
1984,32900,2025,2228,26071,24779,316,14.5,228,10.4,5414,2207,3207,8.9,21.8,2830,1016,1814,4.1,11.4,2584,10.4,22.8,0,145,145,713
1985,32900,2077,2280,28107,27224,280,12.4,240,10.6,5775,1978,3797,7.3,21.2,4009,1872,2137,6.9,14.7,1766,6.5,29.4,0,139,139,567
1986,32900,2127,2320,31364,29728,290,12.6,242,10.5,7145,1591,5554,5.4,24,3873,1310,2563,4.4,13,3272,11,26,0,145,145,541
1987,32900,2180,2378,29974,30950,337,14.4,262,11.2,5633,1957,3676,6.3,18.2,7584,2366,5218,7.6,24.5,-1951,-6.3,36.4,0,158,161,1122
1988,32900,2202,2401,32517,31114,294,12.3,258,10.8,6846,1721,5125,5.5,22,4039,1320,2719,4.2,13,2807,9,26,0,170,170,777
1989,32900,2081,2285,32605,32521,290,12.4,407,17.4,5359,2238,3121,6.9,16.5,5193,2483,2710,7.6,16,166,0.5,32,0,168,168,659
1990,32900,2295,2511,35793,34136,457,19.1,209,8.7,7222,3127,4095,9.2,21.2,3909,1386,2523,4.1,11.5,3313,9.7,23,0,139,139,828
1991,32900,2319,2551,34986,35425,282,11.1,240,9.5,4662,1728,2934,4.9,13.2,5539,1588,3951,4.5,15.6,-877,-2.4,26.4,0,148,149,788
1992,32900,2294,2529,32672,33837,282,11.1,294,11.5,4164,1473,2691,4.4,12.3,6494,2066,4428,6.1,19.2,-2330,-6.9,24.6,0,187,187,1396
1993,32900,2266,2499,34331,33479,257,10.2,268,10.7,5704,1653,4051,4.9,17,4000,1466,2534,4.4,11.9,1704,5.1,23.8,0,178,178,866
1994,32900,2298,2537,35383,34841,286,11.4,252,10,5766,2599,3167,7.5,16.5,4682,1438,3244,4.1,13.4,1084,3.1,26.8,0,159,159,772
1995,32900,2309,2560,34155,34576,261,10.3,233,9.2,4235,1539,2696,4.5,12.2,5076,1145,3931,3.3,14.7,-841,-2.5,24.4,0,144,144,517
1996,32900,2264,2514,34180,34170,249,9.8,286,11.3,4040,1357,2683,4,11.8,4019,1464,2555,4.3,11.8,21,0,23.6,0,194,194,845
1997,32900,2281,2534,35023,34592,299,11.8,271,10.7,5492,1949,3543,5.6,15.9,4630,1613,3017,4.7,13.4,862,2.5,26.8,0,162,162,826
1998,32900,2260,2532,36668,35847,269,10.6,260,10.3,6036,2539,3497,7.1,16.8,4394,1394,3000,3.9,12.3,1642,4.5,24.6,0,167,167,793
1999,32900,2296,2578,37226,37008,286,11.2,233,9.1,5916,2242,3674,6.1,16,5480,2492,2988,6.7,14.8,436,1.2,29.6,0,149,149,648
2000,32900,2282,2572,39509,38367,261,10.1,276,10.7,6933,2764,4169,7.2,18.1,4648,2096,2552,5.5,12.1,2285,6,24.2,0,179,179,1202
2001,32900,2298,2601,40115,40130,278,10.7,279,10.8,5200,1810,3390,4.5,13,5230,2082,3148,5.2,13,-30,0,26,0,147,147,1156
2002,32900,2357,2655,40603,40310,361,13.8,299,11.4,7052,3295,3757,8.2,17.5,6465,2199,4266,5.5,16,587,1.5,32,0,159,160,956
2003,32900,2387,2697,41278,40430,329,12.3,243,9.1,7126,2294,4832,5.7,17.6,5429,1685,3744,4.2,13.4,1697,4.2,26.8,0,153,157,910
2004,32900,2431,2745,43955,42478,320,11.8,236,8.7,8180,4186,3994,9.9,19.3,5226,1408,3818,3.3,12.3,2954,7,24.6,0,156,156,835
2005,32900,2442,2767,44502,44044,317,11.5,254,9.2,5995,2381,3614,5.4,13.6,5078,1768,3310,4,11.5,917,2.1,23,0,192,192,1113
2006,32900,2482,2798,44419,44239,332,12,266,9.6,6209,2670,3539,6,14,5849,2511,3338,5.7,13.2,360,0.8,26.4,0,174,174,1898
2007,32900,2474,2801,45088,44535,343,12.3,314,11.2,8059,2722,5337,6.1,18.1,6953,2831,4122,6.4,15.6,1106,2.5,31.2,0,194,194,918
2008,32900,2397,2745,42533,43676,275,10,296,10.7,5206,2074,3132,4.7,11.9,7492,2828,4664,6.5,17.2,-2286,-5.3,23.8,0,231,231,2340
2009,32900,2310,2650,40400,41237,230,8.6,286,10.6,4300,2259,2041,5.5,10.4,5973,1649,4324,4,14.5,-1673,-4.1,20.8,0,200,201,1152
2010,32900,2264,2603,38697,39206,211,8.1,233,8.9,3543,1176,2367,3,9,4561,1327,3234,3.4,11.6,-1018,-2.6,18,0,166,166,953
2011,32900,2208,2555,39469,39050,216,8.4,250,9.7,4796,1493,3303,3.8,12.3,3957,1202,2755,3.1,10.1,839,2.2,20.2,0,165,165,682
2012,32900,2237,2587,40456,39912,257,10,237,9.2,5494,1808,3686,4.5,13.8,4406,1410,2996,3.5,11,1088,2.8,22,0,143,143,909
2013,32900,2240,2593,40677,40506,225,8.7,213,8.3,4286,1460,2826,3.6,10.6,3943,1199,2744,3,9.7,343,0.9,19.4,0,145,145,932
2014,32900,2222,2581,41169,40805,222,8.6,210,8.2,4602,1199,3403,2.9,11.3,3874,1503,2371,3.7,9.5,728,1.8,19,0,144,149,979
1977,33100,27606,31543,384326,363214,6826,22.3,4678,15.3,111375,54626,56749,15,30.7,69151,34185,34966,9.4,19,42224,11.7,38,0,3340,3353,21827
1978,33100,29399,33447,423640,404178,6570,20.2,4669,14.4,113543,46319,67224,11.5,28.1,74618,33727,40891,8.3,18.5,38925,9.6,37,0,3412,3414,18050
1979,33100,31318,35573,471240,447006,6972,20.2,4648,13.5,126961,54136,72825,12.1,28.4,78492,34259,44233,7.7,17.6,48469,10.8,35.2,0,3459,3478,21759
1980,33100,33191,37684,524350,497472,7065,19.3,4829,13.2,139795,67421,72374,13.6,28.1,86038,34855,51183,7,17.3,53757,10.8,34.6,0,3651,3658,22092
1981,33100,33968,38567,533977,528330,7035,18.5,5889,15.5,134826,58162,76664,11,25.5,123531,43356,80175,8.2,23.4,11295,2.1,46.8,0,3973,3982,23022
1982,33100,35602,41051,536176,535074,8030,20.2,5320,13.4,122098,65424,56674,12.2,22.8,119893,41003,78890,7.7,22.4,2205,0.4,44.8,0,3171,3174,21741
1983,33100,36353,41920,533063,531348,7033,17,6255,15.1,115892,54777,61115,10.3,21.8,112462,46196,66266,8.7,21.2,3430,0.6,42.4,0,3946,3964,24861
1984,33100,38863,44663,602870,568196,8079,18.7,5346,12.4,153119,65300,87819,11.5,26.9,83772,34400,49372,6.1,14.7,69347,12.2,29.4,0,3696,3720,21183
1985,33100,40706,46783,636467,621252,8157,17.8,5985,13.1,142952,60615,82337,9.8,23,112521,46912,65609,7.6,18.1,30431,4.9,36.2,0,4050,4060,28622
1986,33100,42984,49325,671703,653220,8873,18.5,6172,12.8,157053,71248,85805,10.9,24,120087,46849,73238,7.2,18.4,36966,5.6,36.8,0,4231,4234,26937
1987,33100,45228,52167,703822,688134,10146,20,6992,13.8,170513,85348,85165,12.4,24.8,139138,59246,79892,8.6,20.2,31375,4.6,40.4,0,4868,4895,33280
1988,33100,47008,54416,736033,720406,9789,18.4,7380,13.8,170803,79072,91731,11,23.7,139548,58077,81471,8.1,19.4,31255,4.3,38.8,0,5202,5202,32826
1989,33100,48743,56650,784508,760587,9637,17.4,7386,13.3,185809,83448,102361,11,24.4,137967,59104,78863,7.8,18.1,47842,6.3,36.2,0,5156,5179,36491
1990,33100,50490,58747,802891,792775,9834,17,7253,12.6,165226,74513,90713,9.4,20.8,144994,56132,88862,7.1,18.3,20232,2.5,36.6,0,5272,5284,34435
1991,33100,52842,61508,810469,808460,10630,17.7,7887,13.1,170987,86837,84150,10.7,21.1,166969,63279,103690,7.8,20.7,4018,0.4,41.4,0,5027,5077,37430
1992,33100,55407,64295,817892,814518,11441,18.2,8308,13.2,177104,83678,93426,10.3,21.7,170358,78868,91490,9.7,20.9,6746,0.8,41.8,0,5553,5648,35715
1993,33100,58809,67602,884364,851759,11249,17.1,7783,11.8,207254,85630,121624,10.1,24.3,142045,59199,82846,7,16.7,65209,7.6,33.4,0,5484,5540,34274
1994,33100,61647,70740,934652,908540,11678,16.9,8222,11.9,201062,89735,111327,9.9,22.1,148838,56499,92339,6.2,16.4,52224,5.7,32.8,0,5767,5790,34214
1995,33100,64481,74005,984693,956384,11973,16.5,8340,11.5,208677,88980,119697,9.3,21.8,152058,63033,89025,6.6,15.9,56619,5.9,31.8,0,5918,5940,40355
1996,33100,67393,77130,1028151,1005667,12105,16,8661,11.5,209820,91259,118561,9.1,20.9,164852,61501,103351,6.1,16.4,44968,4.5,32.8,0,5938,5938,36861
1997,33100,70239,80684,1081102,1055799,13000,16.5,9379,11.9,243164,110819,132345,10.5,23,192559,85451,107108,8.1,18.2,50605,4.8,36.4,0,6219,6219,46200
1998,33100,72906,83867,1153929,1117254,12986,15.8,9546,11.6,253615,108295,145320,9.7,22.7,180264,75354,104910,6.7,16.1,73351,6.6,32.2,0,6492,6492,42391
1999,33100,76173,87912,1233353,1192115,13746,16,9447,11,273110,112546,160564,9.4,22.9,190633,85572,105061,7.2,16,82477,6.9,32,0,6242,6242,42984
2000,33100,79904,92574,1348259,1290834,14572,16.2,9865,10.9,312123,145886,166237,11.3,24.2,197274,83998,113276,6.5,15.3,114849,8.9,30.6,0,6119,6119,41607
2001,33100,86148,100053,1501650,1438507,16645,17.3,10097,10.5,349084,129990,219094,9,24.3,222797,76535,146262,5.3,15.5,126287,8.8,31,0,5918,5918,36369
2002,33100,94500,109516,1544690,1508261,20663,19.7,11171,10.7,340340,173788,166552,11.5,22.6,267484,94610,172874,6.3,17.7,72856,4.9,35.4,0,5833,5839,35774
2003,33100,101165,116523,1598689,1562577,21410,19,12343,11,338040,154973,183067,9.9,21.6,265816,107679,158137,6.9,17,72224,4.6,34,0,8303,8320,53015
2004,33100,107749,123635,1663156,1627668,21868,18.2,13409,11.2,336525,143323,193202,8.8,20.7,265549,110916,154633,6.8,16.3,70976,4.4,32.6,0,9064,9083,64197
2005,33100,114102,131006,1753297,1708878,23099,18.2,14481,11.4,364042,184614,179428,10.8,21.3,275203,105408,169795,6.2,16.1,88839,5.2,32.2,0,10001,10052,66118
2006,33100,118346,135891,1875166,1808336,22181,16.6,15902,11.9,396066,153362,242704,8.5,21.9,262407,111553,150854,6.2,14.5,133659,7.4,29,0,11004,11016,74001
2007,33100,121716,140285,1922731,1895669,22099,16,17527,12.7,369542,151301,218241,8,19.5,315418,114436,200982,6,16.6,54124,2.9,33.2,0,11925,11961,61333
2008,33100,119931,139042,1909736,1909123,19332,13.9,19322,13.9,326878,132486,194392,6.9,17.1,325651,103088,222563,5.4,17.1,1227,0,34.2,0,14284,14303,71166
2009,33100,115329,134363,1771583,1832208,17132,12.6,20202,14.8,252355,110170,142185,6,13.8,373605,112161,261444,6.1,20.4,-121250,-6.6,27.6,0,14176,14222,70523
2010,33100,115607,134497,1751207,1756639,18212,13.6,17479,13,272829,117463,155366,6.7,15.5,283692,105151,178541,6,16.1,-10863,-0.6,31,0,11932,11960,68741
2011,33100,117972,137275,1844967,1796544,19862,14.6,16560,12.2,328297,124939,203358,7,18.3,231450,94788,136662,5.3,12.9,96847,5.4,25.8,0,11191,11211,55266
2012,33100,122493,142382,1966820,1903873,20562,14.7,15620,11.2,380422,125800,254622,6.6,20,254529,113334,141195,6,13.4,125893,6.6,26.8,0,10140,10191,50597
2013,33100,126172,146327,2033405,1999129,19661,13.6,16489,11.4,321404,114621,206783,5.7,16.1,252851,91501,161350,4.6,12.6,68553,3.5,25.2,0,10502,10526,56016
2014,33100,129041,149493,2081408,2050931,20921,14.2,17064,11.6,334827,121710,213117,5.9,16.3,273872,127642,146230,6.2,13.4,60955,2.9,26.8,0,11792,11809,64680
1977,33140,1679,1811,32674,31986,224,12.5,174,9.7,5918,1840,4078,5.8,18.5,4542,1495,3047,4.7,14.2,1376,4.3,28.4,0,115,115,845
1978,33140,1727,1868,35622,34142,242,13.2,187,10.2,6910,2284,4626,6.7,20.2,3950,1474,2476,4.3,11.6,2960,8.6,23.2,0,129,130,483
1979,33140,1714,1868,36860,36219,218,11.7,207,11.1,5986,2518,3468,7,16.5,4704,1917,2787,5.3,13,1282,3.5,26,0,143,143,573
1980,33140,1714,1866,36024,36427,206,11,204,10.9,4819,1447,3372,4,13.2,5624,1474,4150,4,15.4,-805,-2.2,26.4,0,140,140,727
1981,33140,1627,1776,33385,34568,166,9.1,244,13.4,3458,1866,1592,5.4,10,5823,1740,4083,5,16.8,-2365,-6.8,20,0,153,154,935
1982,33140,1642,1799,32238,32817,208,11.6,165,9.2,4320,2056,2264,6.3,13.2,5477,1575,3902,4.8,16.7,-1157,-3.5,26.4,0,91,91,531
1983,33140,1574,1724,30625,31374,172,9.8,225,12.8,3671,1248,2423,4,11.7,5168,1521,3647,4.8,16.5,-1497,-4.8,23.4,0,115,117,725
1984,33140,1696,1856,31550,31124,207,11.6,109,6.1,5024,1453,3571,4.7,16.1,4171,1247,2924,4,13.4,853,2.7,26.8,1,2,2,
1985,33140,1734,1885,32114,32013,212,11.3,194,10.3,4569,1627,2942,5.1,14.3,4366,2159,2207,6.7,13.6,203,0.7,27.2,0,121,121,680
1986,33140,1783,1932,33292,32691,223,11.7,171,9,5770,2524,3246,7.7,17.7,4567,1490,3077,4.6,14,1203,3.7,28,0,115,115,972
1987,33140,1792,1935,32905,33087,230,11.9,218,11.3,5019,1735,3284,5.2,15.2,5383,2215,3168,6.7,16.3,-364,-1.1,30.4,0,133,133,1111
1988,33140,1855,2010,34543,33445,240,12.2,158,8,5766,1953,3813,5.8,17.2,3569,795,2774,2.4,10.7,2197,6.5,21.4,0,101,101,436
1989,33140,1861,2030,37148,35904,214,10.6,196,9.7,6759,2247,4512,6.3,18.8,4271,1142,3129,3.2,11.9,2488,6.9,23.8,0,137,137,690
1990,33140,1887,2068,37090,37061,208,10.2,159,7.8,5205,1833,3372,4.9,14,5147,1719,3428,4.6,13.9,58,0.1,27.8,0,108,108,508
1991,33140,1944,2128,35237,36065,242,11.5,176,8.4,4838,2104,2734,5.8,13.4,6493,2562,3931,7.1,18,-1655,-4.6,26.8,0,109,109,1724
1992,33140,1992,2197,36621,36654,249,11.5,175,8.1,4799,1527,3272,4.2,13.1,4866,1215,3651,3.3,13.3,-67,-0.2,26.2,0,122,122,594
1993,33140,2056,2261,36852,36764,244,10.9,184,8.3,4602,1397,3205,3.8,12.5,4426,1131,3295,3.1,12,176,0.5,24,0,127,127,511
1994,33140,2107,2322,38115,37481,236,10.3,170,7.4,5547,2050,3497,5.5,14.8,4279,1342,2937,3.6,11.4,1268,3.4,22.8,0,128,128,914
1995,33140,2156,2370,39135,38607,259,11,200,8.5,5734,1922,3812,5,14.9,4678,1742,2936,4.5,12.1,1056,2.8,24.2,0,123,126,757
1996,33140,2185,2396,38019,38507,258,10.8,228,9.6,4482,1865,2617,4.8,11.6,5458,1508,3950,3.9,14.2,-976,-2.6,23.2,0,150,150,682
1997,33140,2179,2408,38286,38221,252,10.5,243,10.1,5446,1338,4108,3.5,14.2,5316,2074,3242,5.4,13.9,130,0.3,27.8,0,160,160,918
1998,33140,2196,2432,40051,39147,253,10.5,229,9.5,7147,2736,4411,7,18.3,5339,1927,3412,4.9,13.6,1808,4.7,27.2,0,150,150,1234
1999,33140,2184,2436,40114,40093,221,9.1,215,8.8,5299,2060,3239,5.1,13.2,5257,1784,3473,4.4,13.1,42,0.1,26.2,0,138,138,1026
2000,33140,2139,2381,40489,40259,186,7.7,243,10.1,5263,1297,3966,3.2,13.1,4802,1821,2981,4.5,11.9,461,1.2,23.8,0,151,151,920
2001,33140,2154,2404,39768,40233,205,8.6,204,8.5,4789,1536,3253,3.8,11.9,5719,1527,4192,3.8,14.2,-930,-2.3,23.8,0,129,130,950
2002,33140,2179,2432,38865,39322,252,10.4,223,9.2,5614,2329,3285,5.9,14.3,6527,2020,4507,5.1,16.6,-913,-2.3,28.6,0,116,116,627
2003,33140,2121,2377,37634,38085,208,8.7,218,9.1,4499,1699,2800,4.5,11.8,5400,1726,3674,4.5,14.2,-901,-2.4,23.6,0,146,147,961
2004,33140,2105,2351,37286,37297,177,7.5,169,7.2,4128,1040,3088,2.8,11.1,4150,1321,2829,3.5,11.1,-22,0,22.2,0,105,105,884
2005,33140,2127,2377,37874,37490,223,9.5,180,7.6,5196,1962,3234,5.2,13.9,4427,1155,3272,3.1,11.8,769,2.1,23.6,0,131,131,728
2006,33140,2115,2381,40353,39083,225,9.5,203,8.5,6887,3278,3609,8.4,17.6,4346,1412,2934,3.6,11.1,2541,6.5,22.2,0,120,120,822
2007,33140,2135,2406,37767,38889,210,8.8,184,7.7,4579,1333,3246,3.4,11.8,6822,1886,4936,4.8,17.5,-2243,-5.7,23.6,0,117,118,1159
2008,33140,2077,2357,37929,37750,190,8,216,9.1,4728,1303,3425,3.5,12.5,4370,1115,3255,3,11.6,358,0.9,23.2,0,158,158,694
2009,33140,2010,2293,35665,36713,149,6.4,188,8.1,3089,842,2247,2.3,8.4,5184,905,4279,2.5,14.1,-2095,-5.7,16.8,0,128,128,590
2010,33140,1961,2243,34788,35179,134,5.9,167,7.4,3196,940,2256,2.7,9.1,3978,738,3240,2.1,11.3,-782,-2.2,18.2,0,100,100,474
2011,33140,1919,2180,34613,34585,142,6.5,173,7.9,3610,687,2923,2,10.4,3553,865,2688,2.5,10.3,57,0.1,20.6,0,121,121,571
2012,33140,1913,2172,35332,34946,146,6.7,163,7.5,4066,806,3260,2.3,11.6,3293,781,2512,2.2,9.4,773,2.2,18.8,0,99,99,412
2013,33140,1853,2110,36807,36011,120,5.6,188,8.8,4514,664,3850,1.8,12.5,2921,747,2174,2.1,8.1,1593,4.4,16.2,0,117,117,422
2014,33140,1843,2094,35233,35838,156,7.5,153,7.3,3204,889,2315,2.5,8.9,4413,1067,3346,3,12.3,-1209,-3.4,17.8,0,93,93,350
1977,33260,2144,2292,29533,28660,401,18,277,12.4,7909,3934,3975,13.7,27.6,6162,2296,3866,8,21.5,1747,6.1,43,0,182,182,1035
1978,33260,2140,2294,33559,31503,380,16.6,352,15.4,9268,3251,6017,10.3,29.4,5156,2642,2514,8.4,16.4,4112,13,32.8,0,191,191,898
1979,33260,2414,2575,36176,34885,454,18.6,183,7.5,8555,3807,4748,10.9,24.5,5973,1880,4093,5.4,17.1,2582,7.4,34.2,0,4,4,74
1980,33260,2515,2687,40023,37940,429,16.3,302,11.5,10666,3414,7252,9,28.1,6499,2203,4296,5.8,17.1,4167,11,34.2,0,214,215,1245
1981,33260,2720,2929,48360,44022,615,21.9,367,13.1,15080,5718,9362,13,34.3,6404,2724,3680,6.2,14.5,8676,19.8,29,0,223,223,1861
1982,33260,3087,3347,59162,53733,767,24.4,333,10.6,19679,7628,12051,14.2,36.6,8821,3241,5580,6,16.4,10858,20.2,32.8,0,188,188,1410
1983,33260,3102,3340,48988,53722,524,15.7,532,15.9,10222,5066,5156,9.4,19,19690,5025,14665,9.4,36.7,-9468,-17.7,38,0,363,363,2759
1984,33260,3031,3315,49997,49505,524,15.7,541,16.3,11327,4201,7126,8.5,22.9,10342,3605,6737,7.3,20.9,985,2,41.8,0,387,387,2219
1985,33260,3062,3348,51036,50855,493,14.8,448,13.4,10065,4276,5789,8.4,19.8,9702,3383,6319,6.7,19.1,363,0.7,38.2,0,304,304,1737
1986,33260,3049,3327,47262,48932,458,13.7,455,13.6,8525,3802,4723,7.8,17.4,11865,3605,8260,7.4,24.2,-3340,-6.8,34.8,0,294,296,1476
1987,33260,2805,3091,39591,42762,447,13.9,642,20,6969,3117,3852,7.3,16.3,13311,6288,7023,14.7,31.1,-6342,-14.8,32.6,0,414,416,2663
1988,33260,2816,3112,38922,39227,428,13.8,415,13.4,8084,3490,4594,8.9,20.6,8693,3507,5186,8.9,22.2,-609,-1.6,41.2,0,269,269,1092
1989,33260,2856,3143,39234,39285,433,13.8,411,13.1,8167,3673,4494,9.3,20.8,8268,3425,4843,8.7,21,-101,-0.2,41.6,0,251,253,1933
1990,33260,2876,3169,38215,38632,426,13.5,371,11.8,6273,2309,3964,6,16.2,7106,3264,3842,8.4,18.4,-833,-2.2,32.4,0,242,243,1283
1991,33260,2970,3261,39880,39367,434,13.5,349,10.9,7375,2705,4670,6.9,18.7,6349,2815,3534,7.2,16.1,1026,2.6,32.2,0,222,223,1287
1992,33260,3048,3356,39389,39652,493,14.9,389,11.7,7109,2839,4270,7.2,17.9,7635,2594,5041,6.5,19.3,-526,-1.4,35.8,0,253,253,1712
1993,33260,3111,3419,39735,39496,446,13.2,373,11,7712,3173,4539,8,19.5,7234,2947,4287,7.5,18.3,478,1.2,36.6,0,245,246,1383
1994,33260,3194,3493,41166,40425,449,13,365,10.6,7776,2659,5117,6.6,19.2,6294,1913,4381,4.7,15.6,1482,3.6,31.2,0,237,237,1013
1995,33260,3241,3539,42192,41651,486,13.8,415,11.8,8224,3459,4765,8.3,19.7,7141,2666,4475,6.4,17.1,1083,2.6,34.2,0,297,298,1531
1996,33260,3279,3571,42569,42306,482,13.6,422,11.9,8864,4328,4536,10.2,21,8338,3557,4781,8.4,19.7,526,1.3,39.4,0,283,283,2036
1997,33260,3303,3623,44341,43490,507,14.1,459,12.7,9682,4053,5629,9.3,22.3,7980,3530,4450,8.1,18.3,1702,4,36.6,0,290,290,1432
1998,33260,3365,3676,45745,45124,452,12.4,404,11.1,8942,3477,5465,7.7,19.8,7700,3171,4529,7,17.1,1242,2.7,34.2,0,254,254,1362
1999,33260,3272,3588,43244,45162,376,10.4,450,12.4,6596,3145,3451,7,14.6,10432,4274,6158,9.5,23.1,-3836,-8.5,29.2,0,300,300,1821
2000,33260,3202,3535,44923,44034,378,10.6,433,12.2,9239,3116,6123,7.1,21,7461,3176,4285,7.2,16.9,1778,4.1,33.8,0,254,254,1154
2001,33260,3252,3588,47424,46329,404,11.3,379,10.6,8594,3480,5114,7.5,18.5,6404,2405,3999,5.2,13.8,2190,4.7,27.6,0,210,210,978
2002,33260,3243,3591,46190,46631,403,11.2,393,11,7869,3301,4568,7.1,16.9,8751,4355,4396,9.3,18.8,-882,-1.9,33.8,0,195,195,1423
2003,33260,3294,3655,47932,46693,426,11.8,295,8.2,8884,4064,4820,8.7,19,6406,1900,4506,4.1,13.7,2478,5.3,27.4,0,206,206,1324
2004,33260,3287,3644,49915,48752,354,9.7,328,9,8000,2537,5463,5.2,16.4,5673,1874,3799,3.8,11.6,2327,4.8,23.2,0,219,219,1142
2005,33260,3369,3746,50732,50194,456,12.4,328,8.9,8919,3364,5555,6.7,17.8,7842,3105,4737,6.2,15.6,1077,2.2,31.2,0,219,219,1812
2006,33260,3413,3808,53492,52004,441,11.7,355,9.4,10806,4516,6290,8.7,20.8,7829,3657,4172,7,15.1,2977,5.7,30.2,0,228,228,1659
2007,33260,3542,3948,60214,56790,490,12.7,332,8.6,14998,4723,10275,8.3,26.4,8150,2413,5737,4.2,14.4,6848,12,28.8,0,216,216,1527
2008,33260,3589,4024,62737,61320,442,11.1,317,8,12312,3984,8328,6.5,20.1,9477,2669,6808,4.4,15.5,2835,4.6,31,0,226,226,1942
2009,33260,3612,4068,59998,61078,415,10.3,341,8.4,8738,3264,5474,5.3,14.3,10898,2758,8140,4.5,17.8,-2160,-3.5,28.6,0,233,233,1519
2010,33260,3651,4105,58346,59208,385,9.4,330,8.1,7788,2935,4853,5,13.2,9511,2677,6834,4.5,16.1,-1723,-2.9,26.4,0,217,217,1633
2011,33260,3730,4213,63588,60839,440,10.6,320,7.7,11239,3382,7857,5.6,18.5,5740,2718,3022,4.5,9.4,5499,9.1,18.8,0,232,232,1581
2012,33260,3882,4378,74033,68789,482,11.2,320,7.5,17603,5286,12317,7.7,25.6,7115,2408,4707,3.5,10.3,10488,15.3,20.6,0,200,200,958
2013,33260,4007,4517,80093,77092,516,11.6,393,8.8,15910,4711,11199,6.1,20.6,9907,4076,5831,5.3,12.9,6003,7.7,25.8,0,264,264,1427
2014,33260,4083,4626,86955,83276,528,11.6,387,8.5,17497,6992,10505,8.4,21,10139,3246,6893,3.9,12.2,7358,8.8,24.4,0,294,295,2368
1977,33340,22730,26209,544718,534337,3806,14.8,2879,11.2,87392,33052,54340,6.2,16.4,66629,25077,41552,4.7,12.5,20763,3.9,25,0,1779,1799,12752
1978,33340,23392,27001,575949,559745,3443,12.9,2656,10,92119,25103,67016,4.5,16.5,59710,24179,35531,4.3,10.7,32409,5.8,21.4,0,1782,1786,10382
1979,33340,23820,27563,601583,589313,3168,11.6,2488,9.1,89157,26983,62174,4.6,15.1,64616,20350,44266,3.5,11,24541,4.1,22,0,1694,1699,9515
1980,33340,23913,27713,596333,598625,2871,10.4,2627,9.5,73670,24559,49111,4.1,12.3,78253,23377,54876,3.9,13.1,-4583,-0.8,24.6,0,1796,1805,10473
1981,33340,23336,26978,572921,582951,2748,10.1,3320,12.1,75160,32330,42830,5.5,12.9,95220,30458,64762,5.2,16.3,-20060,-3.4,25.8,0,1781,1791,10668
1982,33340,23572,27591,567428,569535,3607,13.2,2674,9.8,81597,36950,44647,6.5,14.3,85811,24387,61424,4.3,15.1,-4214,-0.8,28.6,0,1446,1447,8351
1983,33340,24110,28144,538650,553827,2885,10.4,2599,9.3,64311,23522,40789,4.2,11.6,94665,21799,72866,3.9,17.1,-30354,-5.5,23.2,0,1585,1590,9574
1984,33340,24688,28778,581927,560584,3372,11.9,2746,9.7,103508,31878,71630,5.7,18.5,60822,20922,39900,3.7,10.8,42686,7.7,21.6,0,1721,1726,9456
1985,33340,25189,29281,574053,574203,3336,11.5,2777,9.6,83875,27507,56368,4.8,14.6,84175,37585,46590,6.5,14.7,-300,-0.1,29.2,0,1795,1808,13610
1986,33340,24150,28361,570874,570717,3289,11.4,3869,13.4,88143,34706,53437,6.1,15.4,87829,39476,48353,6.9,15.4,314,0,30.8,0,2008,2024,12923
1987,33340,26037,30678,604882,591032,4348,14.7,2252,7.6,100910,42594,58316,7.2,17.1,73210,22553,50657,3.8,12.4,27700,4.7,24.8,0,542,556,6331
1988,33340,26426,31274,631289,617138,3604,11.6,2937,9.5,105550,38702,66848,6.3,17.1,77248,27939,49309,4.5,12.5,28302,4.6,25,0,1889,1889,12820
1989,33340,26791,31895,658673,644811,3609,11.4,2993,9.5,110654,33299,77355,5.2,17.2,82930,32186,50744,5,12.9,27724,4.3,25.8,0,1964,1967,16799
1990,33340,27250,32447,675034,666992,3484,10.8,2806,8.7,96646,32304,64342,4.8,14.5,80561,27451,53110,4.1,12.1,16085,2.4,24.2,0,1776,1792,13159
1991,33340,27773,33264,669900,672535,3721,11.3,2915,8.9,89321,35989,53332,5.4,13.3,94590,29785,64805,4.4,14.1,-5269,-0.8,26.6,0,1795,1828,15452
1992,33340,27952,33503,669653,669956,3432,10.3,3119,9.3,87262,28787,58475,4.3,13,87869,27969,59900,4.2,13.1,-607,-0.1,26,0,1866,1887,12392
1993,33340,28469,33982,689191,679546,3456,10.2,2936,8.7,97262,28626,68636,4.2,14.3,77971,26752,51219,3.9,11.5,19291,2.8,23,0,1906,1914,11572
1994,33340,28802,34345,697124,692988,3436,10.1,2975,8.7,89793,28585,61208,4.1,13,81520,24613,56907,3.6,11.8,8273,1.2,23.6,0,1896,1916,12004
1995,33340,28936,34552,720243,708387,3394,9.9,3094,9,96462,28784,67678,4.1,13.6,72750,23966,48784,3.4,10.3,23712,3.3,20.6,0,2014,2035,12617
1996,33340,29259,34988,730097,725740,3513,10.1,3034,8.7,94159,29618,64541,4.1,13,85445,26286,59159,3.6,11.8,8714,1.2,23.6,0,1966,1968,12409
1997,33340,29457,35320,741280,736208,3619,10.3,3321,9.4,106982,36546,70436,5,14.5,96838,32011,64827,4.3,13.2,10144,1.3,26.4,0,1957,1957,12012
1998,33340,29679,35572,760703,750686,3584,10.1,3215,9.1,109303,35304,73999,4.7,14.6,89271,29605,59666,3.9,11.9,20032,2.7,23.8,0,2027,2027,14281
1999,33340,29661,35740,764285,762411,3392,9.5,3205,9,101230,33488,67742,4.4,13.3,97483,31507,65976,4.1,12.8,3747,0.5,25.6,0,1983,1983,12758
2000,33340,29558,35993,781913,772732,3569,10,3296,9.2,112379,40251,72128,5.2,14.5,94017,30567,63450,4,12.2,18362,2.3,24.4,0,1982,1982,11962
2001,33340,29523,36145,779185,781922,3314,9.2,3420,9.5,101521,36982,64539,4.7,13,106994,31969,75025,4.1,13.7,-5473,-0.7,26,0,1918,1922,11949
2002,33340,29356,35947,757326,767448,3787,10.5,3924,10.9,103345,38008,65337,5,13.5,123589,38839,84750,5.1,16.1,-20244,-2.6,27,0,1961,1972,14285
2003,33340,29158,35832,762968,755178,3427,9.6,2987,8.4,106841,33522,73319,4.4,14.1,91261,27111,64150,3.6,12.1,15580,2,24.2,0,1913,1927,13209
2004,33340,29368,36087,775840,766477,3400,9.5,2806,7.8,103645,37259,66386,4.9,13.5,84919,26745,58174,3.5,11.1,18726,2.4,22.2,0,1791,1799,12178
2005,33340,29702,36571,781899,777542,3637,10,2874,7.9,105606,37203,68403,4.8,13.6,96892,29053,67839,3.7,12.5,8714,1.1,25,0,1907,1907,14663
2006,33340,29469,36582,790237,783271,3713,10.2,3355,9.2,104714,38527,66187,4.9,13.4,90781,26875,63906,3.4,11.6,13933,1.8,23.2,0,2151,2152,15354
2007,33340,29582,36798,798033,792668,3713,10.1,3394,9.3,107866,37764,70102,4.8,13.6,97136,31628,65508,4,12.3,10730,1.3,24.6,0,1957,1980,13924
2008,33340,29162,36584,798782,795272,3270,8.9,3171,8.7,96238,31243,64995,3.9,12.1,89218,27317,61901,3.4,11.2,7020,0.9,22.4,0,2123,2132,15812
2009,33340,28283,35724,758353,776275,2812,7.8,3402,9.4,73806,24079,49727,3.1,9.5,109649,29656,79993,3.8,14.1,-35843,-4.6,19,0,2220,2227,14928
2010,33340,27682,35065,740941,747930,2612,7.4,3032,8.6,76683,26630,50053,3.6,10.3,90662,25515,65147,3.4,12.1,-13979,-1.8,20.6,0,1894,1894,13055
2011,33340,27102,34513,749426,743158,2624,7.6,2935,8.5,87007,25722,61285,3.5,11.7,74470,21646,52824,2.9,10,12537,1.7,20,0,1902,1914,14608
2012,33340,27016,34467,757595,752173,2924,8.5,2916,8.5,85515,24525,60990,3.3,11.4,74671,23252,51419,3.1,9.9,10844,1.5,19.8,0,1661,1672,11162
2013,33340,27058,34512,767887,761775,2789,8.1,2663,7.7,85031,25535,59496,3.4,11.2,72809,22764,50045,3,9.6,12222,1.6,19.2,0,1564,1584,12430
2014,33340,27055,34489,773865,769278,2828,8.2,2548,7.4,88387,22893,65494,3,11.5,79214,23004,56210,3,10.3,9173,1.2,20.6,0,1650,1671,10929
1977,33460,33263,39770,833634,794464,6702,17.3,4488,11.6,189955,72431,117524,9.1,23.9,111615,44500,67115,5.6,14,78340,9.9,28,0,2851,2894,26126
1978,33460,34687,41350,887020,860320,6003,14.8,4421,10.9,183272,53358,129914,6.2,21.3,129872,44469,85403,5.2,15.1,53400,6.2,30.2,0,2900,2918,20393
1979,33460,35900,42785,947818,917654,5923,14.1,4286,10.2,179530,58277,121253,6.4,19.6,119204,41516,77688,4.5,13,60326,6.6,26,0,2897,2911,18866
1980,33460,36657,43733,976873,962052,5614,13,4509,10.4,168371,57205,111166,5.9,17.5,138730,47176,91554,4.9,14.4,29641,3.1,28.8,0,3018,3051,22261
1981,33460,36488,43455,965188,968044,5589,12.8,5534,12.7,162418,69715,92703,7.2,16.8,168130,66163,101967,6.8,17.4,-5712,-0.6,33.6,0,3054,3068,25361
1982,33460,37086,45037,959315,961564,6568,14.8,4587,10.4,157529,65620,91909,6.8,16.4,162027,46027,116000,4.8,16.9,-4498,-0.5,32.8,0,2505,2513,17093
1983,33460,38351,46419,940846,946826,5651,12.4,4518,9.9,147258,58708,88550,6.2,15.6,159218,43882,115336,4.6,16.8,-11960,-1.2,31.2,0,2791,2799,19917
1984,33460,40014,48257,1024561,983078,6564,13.9,4773,10.1,204962,70153,134809,7.1,20.8,121996,47488,74508,4.8,12.4,82966,8.4,24.8,0,2928,2956,19448
1985,33460,41300,49750,1072351,1049541,6842,14,5299,10.8,200093,78030,122063,7.4,19.1,154472,69306,85166,6.6,14.7,45621,4.4,29.4,0,3361,3382,37941
1986,33460,42673,51388,1097188,1083724,7335,14.5,5540,11,195790,73930,121860,6.8,18.1,168861,63783,105078,5.9,15.6,26929,2.5,31.2,0,3373,3388,32518
1987,33460,44000,53397,1140677,1124960,8045,15.3,5879,11.2,204018,80404,123614,7.1,18.1,172585,66999,105586,6,15.3,31433,2.8,30.6,0,3461,3490,29851
1988,33460,44487,54339,1184187,1160739,7236,13.4,6056,11.2,223010,75444,147566,6.5,19.2,176115,64260,111855,5.5,15.2,46895,4,30.4,0,3835,3835,27436
1989,33460,45479,55843,1214993,1199024,7333,13.3,5828,10.6,206054,76474,129580,6.4,17.2,174115,70167,103948,5.9,14.5,31939,2.7,29,0,3629,3663,29184
1990,33460,46791,57313,1249917,1231080,7156,12.7,5433,9.6,205557,65571,139986,5.3,16.7,167883,57218,110665,4.6,13.6,37674,3.1,27.2,0,3347,3378,26448
1991,33460,47913,59022,1222565,1237341,7591,13.1,5857,10.1,184244,78886,105358,6.4,14.9,213795,74530,139265,6,17.3,-29551,-2.4,29.8,0,3509,3563,39024
1992,33460,48571,60048,1244760,1232925,7552,12.7,6333,10.6,200835,68202,132633,5.5,16.3,177164,64907,112257,5.3,14.4,23671,1.9,28.8,0,3855,3943,30978
1993,33460,50220,61651,1285463,1264965,7212,11.9,5438,8.9,202526,69723,132803,5.5,16,161530,53061,108469,4.2,12.8,40996,3.2,25.6,0,3357,3387,24054
1994,33460,51918,63758,1322957,1303596,7813,12.5,5551,8.9,201074,65615,135459,5,15.4,162354,57403,104951,4.4,12.5,38720,2.9,25,0,3547,3561,26831
1995,33460,53155,65178,1390844,1355615,7662,11.9,5936,9.2,225197,87548,137649,6.5,16.6,154739,51502,103237,3.8,11.4,70458,5.2,22.8,0,3647,3680,27131
1996,33460,55106,67230,1419218,1407188,8202,12.4,6140,9.3,214637,78066,136571,5.5,15.3,190577,54796,135781,3.9,13.5,24060,1.8,27,0,3812,3814,26726
1997,33460,56279,68867,1459051,1439539,8851,13,7166,10.5,248240,84653,163587,5.9,17.2,209216,82557,126659,5.7,14.5,39024,2.7,29,0,4186,4186,31658
1998,33460,57669,70474,1516526,1487260,8397,12.1,6570,9.4,256206,85826,170380,5.8,17.2,197674,66887,130787,4.5,13.3,58532,3.9,26.6,0,4053,4053,32333
1999,33460,58683,71917,1569029,1543042,8384,11.8,6859,9.6,256672,100615,156057,6.5,16.6,204698,77843,126855,5,13.3,51974,3.3,26.6,0,4060,4060,27616
2000,33460,59429,73147,1619178,1596595,8191,11.3,6998,9.6,256870,85655,171215,5.4,16.1,211704,67955,143749,4.3,13.3,45166,2.8,26.6,0,4083,4083,29772
2001,33460,60322,74965,1630338,1626823,9007,12.2,7649,10.3,246311,100076,146235,6.2,15.1,239282,79118,160164,4.9,14.7,7029,0.4,29.4,0,4232,4232,31086
2002,33460,60319,75184,1598931,1611247,9285,12.4,9006,12,263302,99948,163354,6.2,16.3,287934,98800,189134,6.1,17.9,-24632,-1.6,32.6,0,4328,4336,31172
2003,33460,61382,76500,1606572,1593368,9468,12.5,6887,9.1,259317,103548,155769,6.5,16.3,232909,73446,159463,4.6,14.6,26408,1.7,29.2,0,4149,4151,33163
2004,33460,62689,77903,1612663,1605545,9268,12,7001,9.1,232272,79720,152552,5,14.5,218035,75796,142239,4.7,13.6,14237,0.9,27.2,0,4135,4145,33876
2005,33460,63936,79500,1646766,1625049,9337,11.9,7048,9,244698,91969,152729,5.7,15.1,201264,62315,138949,3.8,12.4,43434,2.7,24.8,0,4405,4411,32098
2006,33460,64805,81278,1681671,1659210,10134,12.6,7565,9.4,258526,96366,162160,5.8,15.6,213605,73508,140097,4.4,12.9,44921,2.7,25.8,0,4810,4816,39337
2007,33460,64967,81676,1711502,1692470,9408,11.6,8731,10.7,277135,97273,179862,5.7,16.4,239071,81610,157461,4.8,14.1,38064,2.3,28.2,0,4979,5015,37535
2008,33460,63910,80761,1691133,1696578,8065,10,8134,10.1,226685,81692,144993,4.8,13.4,237574,65844,171730,3.9,14,-10889,-0.6,26.8,0,5205,5207,38261
2009,33460,61939,78756,1601603,1642121,7255,9.1,8524,10.7,175840,62703,113137,3.8,10.7,256877,64672,192205,3.9,15.6,-81037,-4.9,21.4,0,5148,5182,38339
2010,33460,61066,77852,1583795,1588307,7098,9.1,7452,9.5,196225,73050,123175,4.6,12.4,205249,65581,139668,4.1,12.9,-9024,-0.5,24.8,0,4337,4337,29807
2011,33460,60745,77801,1627068,1603101,7447,9.6,7055,9.1,206679,62168,144511,3.9,12.9,158744,51097,107647,3.2,9.9,47935,3,19.8,0,4270,4286,29755
2012,33460,61579,78635,1677635,1650274,7766,9.9,6905,8.8,228647,55891,172756,3.4,13.9,173924,56022,117902,3.4,10.5,54723,3.4,21,0,3737,3783,29947
2013,33460,62007,79283,1722407,1699285,7298,9.3,6590,8.4,207183,58299,148884,3.4,12.2,160938,47310,113628,2.8,9.5,46245,2.7,19,0,3817,3820,29856
2014,33460,62689,80056,1775207,1745013,7668,9.7,6316,8,229536,88965,140571,5.1,13.2,169148,54129,115019,3.1,9.7,60388,3.5,19.4,0,3978,4011,33902
1977,33540,1763,1853,19774,18827,384,21.5,238,13.3,4646,2376,2270,12.6,24.7,2751,1449,1302,7.7,14.6,1895,10.1,29.2,0,179,179,1087
1978,33540,1765,1864,21777,20710,351,18.9,318,17.1,5144,2001,3143,9.7,24.8,3010,1895,1115,9.2,14.5,2134,10.3,29,0,190,190,1135
1979,33540,1992,2100,24371,23095,405,20.4,177,8.9,5804,2875,2929,12.4,25.1,3252,1066,2186,4.6,14.1,2552,11,28.2,0,3,3,13
1980,33540,1962,2070,23996,24150,316,15.2,330,15.8,4357,1945,2412,8.1,18,4664,1661,3003,6.9,19.3,-307,-1.3,36,0,245,245,1130
1981,33540,1868,1972,22335,22872,280,13.9,341,16.9,3737,1555,2182,6.8,16.3,4811,2144,2667,9.4,21,-1074,-4.7,32.6,0,228,228,1082
1982,33540,1827,1953,22479,22372,280,14.3,266,13.5,4653,3276,1377,14.6,20.8,4438,1321,3117,5.9,19.8,215,1,39.6,0,154,154,739
1983,33540,1925,2054,22661,22596,280,14,202,10.1,4059,1800,2259,8,18,3929,1039,2890,4.6,17.4,130,0.6,34.8,0,133,133,701
1984,33540,1997,2129,23699,23169,299,14.3,219,10.5,4212,1391,2821,6,18.2,3152,1055,2097,4.6,13.6,1060,4.6,27.2,0,158,158,753
1985,33540,2059,2181,24752,24479,293,13.6,249,11.5,4600,1626,2974,6.6,18.8,4053,2128,1925,8.7,16.6,547,2.2,33.2,0,157,159,817
1986,33540,2112,2230,24611,24697,315,14.3,258,11.7,4155,1782,2373,7.2,16.8,4327,1493,2834,6,17.5,-172,-0.7,33.6,0,169,169,976
1987,33540,2169,2294,26316,25509,341,15.1,278,12.3,5574,1856,3718,7.3,21.9,3960,1614,2346,6.3,15.5,1614,6.4,31,0,174,177,999
1988,33540,2135,2273,24911,25194,302,13.3,300,13.2,5111,2150,2961,8.5,20.3,5677,2460,3217,9.8,22.5,-566,-2.2,40.6,0,192,192,1454
1989,33540,2130,2271,26445,25728,279,12.3,282,12.4,5539,2488,3051,9.7,21.5,4105,1542,2563,6,16,1434,5.5,32,0,192,193,1222
1990,33540,2210,2358,27854,27105,293,12.7,199,8.6,5058,1464,3594,5.4,18.7,3560,1417,2143,5.2,13.1,1498,5.6,26.2,0,136,136,850
1991,33540,2289,2461,28135,28012,322,13.4,224,9.3,5021,2136,2885,7.6,17.9,4775,1466,3309,5.2,17,246,0.9,34,0,143,143,751
1992,33540,2357,2555,30500,29310,356,14.2,248,9.9,6359,1983,4376,6.8,21.7,3979,1381,2598,4.7,13.6,2380,8.1,27.2,0,179,182,1071
1993,33540,2458,2649,31208,30842,350,13.5,250,9.6,5396,1760,3636,5.7,17.5,4663,1830,2833,5.9,15.1,733,2.4,30.2,0,181,181,1254
1994,33540,2551,2734,31549,31287,351,13,254,9.4,5175,2027,3148,6.5,16.5,4651,1268,3383,4.1,14.9,524,1.6,29.8,0,179,179,818
1995,33540,2602,2798,33443,32492,379,13.7,291,10.5,5685,2247,3438,6.9,17.5,3782,1374,2408,4.2,11.6,1903,5.9,23.2,0,214,216,966
1996,33540,2695,2887,34232,33952,394,13.9,296,10.4,5447,2166,3281,6.4,16,4886,1698,3188,5,14.4,561,1.6,28.8,0,212,212,1107
1997,33540,2753,2969,35829,34981,408,13.9,320,10.9,6913,2623,4290,7.5,19.8,5216,1950,3266,5.6,14.9,1697,4.9,29.8,0,223,223,1102
1998,33540,2848,3079,37222,36507,411,13.6,289,9.6,6408,2723,3685,7.5,17.6,4977,1540,3437,4.2,13.6,1431,4,27.2,0,202,202,835
1999,33540,2880,3107,38145,37675,366,11.8,343,11.1,6611,2534,4077,6.7,17.5,5671,2088,3583,5.5,15.1,940,2.4,30.2,0,229,229,1051
2000,33540,2904,3144,40417,39258,379,12.1,340,10.9,7177,2718,4459,6.9,18.3,4858,1639,3219,4.2,12.4,2319,5.9,24.8,0,207,207,866
2001,33540,2954,3224,41730,41135,391,12.3,338,10.6,6839,3311,3528,8,16.6,5648,1674,3974,4.1,13.7,1191,2.9,27.4,0,196,196,929
2002,33540,3038,3302,41852,41759,414,12.7,336,10.3,6728,2660,4068,6.4,16.1,6541,2041,4500,4.9,15.7,187,0.4,31.4,0,191,191,1092
2003,33540,3145,3421,43782,42700,447,13.3,289,8.6,7400,2794,4606,6.5,17.3,5236,1523,3713,3.6,12.3,2164,5,24.6,0,198,198,1092
2004,33540,3241,3513,45963,44646,443,12.8,315,9.1,7110,2142,4968,4.8,15.9,4476,1445,3031,3.2,10,2634,5.9,20,0,199,199,831
2005,33540,3341,3619,46323,46000,442,12.4,300,8.4,5792,2173,3619,4.7,12.6,5145,1437,3708,3.1,11.2,647,1.4,22.4,0,215,215,928
2006,33540,3435,3730,48422,47292,487,13.3,361,9.8,9642,3817,5825,8.1,20.4,7382,3112,4270,6.6,15.6,2260,4.8,31.2,0,242,242,2477
2007,33540,3539,3852,48687,48537,473,12.5,341,9,8609,4140,4469,8.5,17.7,8309,2007,6302,4.1,17.1,300,0.6,34.2,0,221,222,1077
2008,33540,3531,3855,49304,48692,385,10,343,8.9,7112,2092,5020,4.3,14.6,5888,2249,3639,4.6,12.1,1224,2.5,24.2,0,245,245,1774
2009,33540,3440,3745,46973,47985,321,8.5,395,10.4,4800,1323,3477,2.8,10,6823,1479,5344,3.1,14.2,-2023,-4.2,20,0,250,250,885
2010,33540,3370,3681,45393,45932,306,8.3,351,9.5,5433,1769,3664,3.9,11.8,6510,1647,4863,3.6,14.2,-1077,-2.4,23.6,0,218,218,870
2011,33540,3329,3636,44911,44993,324,8.9,330,9,5091,1657,3434,3.7,11.3,5254,1495,3759,3.3,11.7,-163,-0.4,22.6,0,212,212,954
2012,33540,3348,3672,45419,45162,362,9.9,330,9,5952,2342,3610,5.2,13.2,5437,1557,3880,3.4,12,515,1.2,24,0,202,202,956
2013,33540,3352,3671,46062,45638,327,8.9,324,8.9,5640,2113,3527,4.6,12.4,4792,1478,3314,3.2,10.5,848,1.9,21,0,210,210,1021
2014,33540,3381,3713,46938,46365,352,9.6,291,7.9,6370,2460,3910,5.3,13.7,5223,1635,3588,3.5,11.3,1147,2.4,22.6,0,186,187,738
1977,33660,5628,6442,98784,96618,1099,17.3,872,13.7,21905,10302,11603,10.7,22.7,17573,7212,10361,7.5,18.2,4332,4.5,36.4,0,613,614,4155
1978,33660,5932,6777,109719,104245,1086,16.4,751,11.4,24634,7175,17459,6.9,23.6,13686,4753,8933,4.6,13.1,10948,10.5,26.2,0,519,519,2800
1979,33660,6016,6894,117437,113036,981,14.4,815,11.9,27800,8619,19181,7.6,24.6,18998,5684,13314,5,16.8,8802,7.8,33.6,0,581,581,3773
1980,33660,6111,6985,115393,115965,986,14.2,857,12.4,21682,7344,14338,6.3,18.7,22826,5914,16912,5.1,19.7,-1144,-1,37.4,0,594,596,3054
1981,33660,5978,6861,111230,112588,904,13.1,952,13.8,21268,8661,12607,7.7,18.9,23983,10402,13581,9.2,21.3,-2715,-2.4,37.8,0,632,632,5478
1982,33660,5837,6817,108182,110215,901,13.2,869,12.7,20322,8101,12221,7.4,18.4,24387,8050,16337,7.3,22.1,-4065,-3.7,36.8,0,509,511,3362
1983,33660,5860,6829,105854,106486,785,11.5,826,12.1,21870,8248,13622,7.7,20.5,23134,7755,15379,7.3,21.7,-1264,-1.2,41,0,512,512,3619
1984,33660,6021,7002,106451,106335,987,14.3,815,11.8,20093,7420,12673,7,18.9,19861,7728,12133,7.3,18.7,232,0.2,37.4,0,545,548,2816
1985,33660,6198,7189,109495,108351,991,14,813,11.4,19944,7824,12120,7.2,18.4,17656,6890,10766,6.4,16.3,2288,2.1,32.6,0,532,535,3629
1986,33660,6310,7321,115426,112354,1035,14.3,872,12,24639,9653,14986,8.6,21.9,18495,6646,11849,5.9,16.5,6144,5.4,33,0,561,566,3204
1987,33660,6512,7564,114924,115479,1212,16.3,920,12.4,21265,8654,12611,7.5,18.4,22375,7601,14774,6.6,19.4,-1110,-1,36.8,0,583,584,3701
1988,33660,6542,7639,117200,115490,1058,13.9,941,12.4,23338,9914,13424,8.6,20.2,19917,7911,12006,6.8,17.2,3421,3,34.4,0,602,602,3882
1989,33660,6557,7730,121576,119583,971,12.6,883,11.5,24453,9835,14618,8.2,20.4,20466,8176,12290,6.8,17.1,3987,3.3,34.2,0,605,607,4275
1990,33660,6574,7766,125430,123220,894,11.5,814,10.5,21604,6859,14745,5.6,17.5,17183,6580,10603,5.3,13.9,4421,3.6,27.8,0,579,583,4723
1991,33660,6683,7871,133093,129447,946,12.1,865,11.1,26915,11394,15521,8.8,20.8,19622,7108,12514,5.5,15.2,7293,5.6,30.4,0,495,506,3072
1992,33660,6764,7956,135386,134280,941,11.9,836,10.5,22396,7652,14744,5.7,16.7,20183,7611,12572,5.7,15,2213,1.7,30,0,525,534,4996
1993,33660,6835,8011,145248,141473,885,11.1,800,10,25574,7783,17791,5.5,18.1,18024,6644,11380,4.7,12.7,7550,5.4,25.4,0,541,543,3636
1994,33660,6982,8182,142947,142443,1011,12.5,821,10.1,24231,10233,13998,7.2,17,23223,7230,15993,5.1,16.3,1008,0.7,32.6,0,525,526,3454
1995,33660,7066,8312,146479,144327,969,11.8,797,9.7,24064,7610,16454,5.3,16.7,19759,5945,13814,4.1,13.7,4305,3,27.4,0,537,545,3240
1996,33660,7148,8426,149395,147974,969,11.6,855,10.2,25524,9483,16041,6.4,17.2,22681,8123,14558,5.5,15.3,2843,1.9,30.6,0,614,614,4696
1997,33660,7161,8428,153494,151508,976,11.6,974,11.5,28023,9053,18970,6,18.5,24051,8725,15326,5.8,15.9,3972,2.6,31.8,0,590,590,3856
1998,33660,7113,8418,159470,156513,917,10.9,912,10.8,29668,9491,20177,6.1,19,23753,8292,15461,5.3,15.2,5915,3.8,30.4,0,588,588,4159
1999,33660,7109,8435,160334,159862,928,11,896,10.6,27685,11626,16059,7.3,17.3,26741,9285,17456,5.8,16.7,944,0.6,33.4,0,530,530,4953
2000,33660,7030,8407,163176,162019,884,10.5,930,11,29700,7695,22005,4.7,18.3,27386,11588,15798,7.2,16.9,2314,1.4,33.8,0,557,557,6497
2001,33660,6920,8334,155831,159697,810,9.7,938,11.2,23477,9509,13968,6,14.7,31209,13056,18153,8.2,19.5,-7732,-4.8,29.4,0,530,530,6505
2002,33660,6939,8362,155136,156836,1042,12.5,1003,12,29031,10954,18077,7,18.5,32431,16253,16178,10.4,20.7,-3400,-2.2,37,0,504,505,3382
2003,33660,6895,8356,147774,150666,860,10.3,704,8.5,21628,7110,14518,4.7,14.4,27412,10094,17318,6.7,18.2,-5784,-3.8,28.8,0,506,506,4823
2004,33660,6920,8386,152329,149306,854,10.2,740,8.9,27468,11191,16277,7.5,18.4,21421,8533,12888,5.7,14.3,6047,4.1,28.6,0,495,496,3109
2005,33660,6954,8443,159976,155758,850,10.1,733,8.7,28368,8707,19661,5.6,18.2,19931,5418,14513,3.5,12.8,8437,5.4,25.6,0,479,485,2666
2006,33660,6949,8532,161324,160253,936,11.1,750,8.9,25040,9418,15622,5.9,15.6,22897,8282,14615,5.2,14.3,2143,1.3,28.6,0,501,501,5004
2007,33660,7098,8728,166147,163670,886,10.3,721,8.4,28108,9897,18211,6,17.2,23154,6980,16174,4.3,14.1,4954,3.1,28.2,0,429,446,3286
2008,33660,6997,8618,167740,165888,703,8.2,698,8.1,23826,6871,16955,4.1,14.4,20122,5517,14605,3.3,12.1,3704,2.3,24.2,0,517,517,3499
2009,33660,6835,8451,157293,161988,653,7.7,778,9.1,17338,5981,11357,3.7,10.7,26727,6196,20531,3.8,16.5,-9389,-5.8,21.4,0,531,531,3660
2010,33660,6641,8254,152633,154630,613,7.4,735,8.8,17499,5507,11992,3.6,11.3,21492,5029,16463,3.3,13.9,-3993,-2.6,22.6,0,492,493,2902
2011,33660,6452,8047,153631,152893,593,7.3,730,9,19723,5961,13762,3.9,12.9,18247,5358,12889,3.5,11.9,1476,1,23.8,0,477,477,2797
2012,33660,6424,8044,153066,152882,670,8.3,670,8.3,19891,5580,14311,3.6,13,19523,7094,12429,4.6,12.8,368,0.2,25.6,0,410,413,5134
2013,33660,6386,7987,155779,153870,572,7.2,625,7.8,20670,4963,15707,3.2,13.4,16851,4668,12183,3,11,3819,2.4,22,0,387,389,2685
2014,33660,6339,7936,152312,152792,619,7.8,611,7.7,18500,5620,12880,3.7,12.1,19460,6018,13442,3.9,12.7,-960,-0.6,24.2,0,401,404,2909
1977,33700,4147,4577,56665,54064,932,21,632,14.3,14081,7191,6890,13.3,26,8878,4493,4385,8.3,16.4,5203,9.6,32.8,0,409,409,2403
1978,33700,4400,4866,65098,60830,995,21.1,708,15,17235,6034,11201,9.9,28.3,8698,4354,4344,7.2,14.3,8537,14,28.6,0,423,424,2270
1979,33700,4631,5129,69455,67222,996,19.9,699,14,17576,8452,9124,12.6,26.1,13110,5337,7773,7.9,19.5,4466,6.6,39,0,498,498,2182
1980,33700,4745,5241,70115,69678,918,17.7,766,14.8,13792,5282,8510,7.6,19.8,12917,4841,8076,6.9,18.5,875,1.3,37,0,552,553,2970
1981,33700,4661,5134,68426,69185,793,15.3,841,16.2,13050,6098,6952,8.8,18.9,14568,7112,7456,10.3,21.1,-1518,-2.2,37.8,0,503,504,2333
1982,33700,4704,5263,70971,69755,912,17.5,707,13.6,15308,8861,6447,12.7,21.9,12876,5235,7641,7.5,18.5,2432,3.4,37,0,416,416,2473
1983,33700,4813,5366,68643,69587,708,13.3,632,11.9,11256,4430,6826,6.4,16.2,13144,4145,8999,6,18.9,-1888,-2.7,32.4,0,409,410,1937
1984,33700,4973,5517,74280,71504,785,14.4,648,11.9,16007,6469,9538,9,22.4,10455,4973,5482,7,14.6,5552,7.8,29.2,0,438,438,2178
1985,33700,5142,5696,76646,75593,818,14.6,642,11.4,13491,4662,8829,6.2,17.8,11385,4655,6730,6.2,15.1,2106,2.7,30.2,0,393,393,2000
1986,33700,5358,5895,81395,78970,939,16.2,718,12.4,16645,7541,9104,9.5,21.1,11794,4658,7136,5.9,14.9,4851,6.2,29.8,0,444,444,2446
1987,33700,5611,6192,86991,84646,1016,16.8,690,11.4,17881,6634,11247,7.8,21.1,13191,5064,8127,6,15.6,4690,5.5,31.2,0,441,442,2462
1988,33700,5707,6308,91445,88921,861,13.8,708,11.3,17378,6264,11114,7,19.5,12329,4304,8025,4.8,13.9,5049,5.6,27.8,0,470,470,2192
1989,33700,5397,6023,93178,92325,892,14.5,1160,18.8,16894,6261,10633,6.8,18.3,15188,7773,7415,8.4,16.5,1706,1.8,33,0,489,489,3056
1990,33700,6070,6735,103632,98283,1346,21.1,597,9.4,22349,10062,12287,10.2,22.7,11651,3602,8049,3.7,11.9,10698,10.8,23.8,0,430,432,2387
1991,33700,6255,6967,102545,103246,928,13.5,700,10.2,18459,7270,11189,7,17.9,19861,5232,14629,5.1,19.2,-1402,-1.3,35.8,0,465,465,3039
1992,33700,6175,6942,99934,101047,898,12.9,853,12.3,15732,5509,10223,5.5,15.6,17957,5530,12427,5.5,17.8,-2225,-2.2,31.2,0,573,574,3308
1993,33700,6103,6856,100494,99974,785,11.4,825,12,16436,5065,11371,5.1,16.4,15396,6093,9303,6.1,15.4,1040,1,30.8,0,546,546,3047
1994,33700,5997,6756,99657,99990,765,11.2,828,12.2,16859,5630,11229,5.6,16.9,17524,5761,11763,5.8,17.5,-665,-0.6,33.8,0,561,563,3168
1995,33700,6000,6784,101439,100628,792,11.7,748,11,15085,4530,10555,4.5,15,13463,4879,8584,4.8,13.4,1622,1.6,26.8,0,489,493,2963
1996,33700,6062,6853,101473,101452,824,12.1,741,10.9,15108,5337,9771,5.3,14.9,15066,5481,9585,5.4,14.9,42,0,29.8,0,484,484,2569
1997,33700,6180,6990,107161,104475,904,13,752,10.9,19385,6258,13127,6,18.6,14013,5389,8624,5.2,13.4,5372,5.2,26.8,0,471,471,2759
1998,33700,6235,7087,111483,109430,821,11.7,721,10.2,18176,6275,11901,5.7,16.6,14069,4167,9902,3.8,12.9,4107,3.7,25.8,0,473,473,2306
1999,33700,6354,7237,115306,113641,804,11.2,657,9.2,17750,5811,11939,5.1,15.6,14419,4786,9633,4.2,12.7,3331,2.9,25.4,0,429,429,2448
2000,33700,6368,7265,119697,117499,782,10.8,756,10.4,20114,6968,13146,5.9,17.1,15717,5955,9762,5.1,13.4,4397,3.7,26.8,0,451,451,2684
2001,33700,6490,7446,124729,122691,905,12.3,808,11,22592,8855,13737,7.2,18.4,18516,7719,10797,6.3,15.1,4076,3.3,30.2,0,500,501,3144
2002,33700,6624,7677,130908,127644,1053,14,795,10.5,26091,10935,15156,8.6,20.4,19564,6640,12924,5.2,15.3,6527,5.1,30.6,0,486,486,3046
2003,33700,6720,7781,130219,128747,1004,13.1,752,9.8,20631,7261,13370,5.6,16,17687,5594,12093,4.3,13.7,2944,2.3,27.4,0,536,545,3501
2004,33700,6754,7847,131406,130124,960,12.3,794,10.2,20416,7422,12994,5.7,15.7,17851,6247,11604,4.8,13.7,2565,2,27.4,0,553,553,4226
2005,33700,6856,7979,134913,133054,932,11.8,731,9.3,19355,7152,12203,5.4,14.5,15636,4524,11112,3.4,11.8,3719,2.7,23.6,0,516,519,3138
2006,33700,6994,8177,140921,137597,1029,12.8,796,9.9,22197,8649,13548,6.3,16.1,15549,5329,10220,3.9,11.3,6648,4.8,22.6,0,575,575,3216
2007,33700,7106,8342,139236,139699,1035,12.5,848,10.3,21301,7861,13440,5.6,15.2,22226,5654,16572,4,15.9,-925,-0.7,30.4,0,585,585,3729
2008,33700,6933,8178,137265,137746,833,10.1,901,11,19480,6141,13339,4.5,14.1,20441,5808,14633,4.2,14.8,-961,-0.7,28.2,0,672,672,4244
2009,33700,6640,7894,126950,131485,736,9.2,919,11.5,13469,5871,7598,4.5,10.2,22538,5871,16667,4.5,17.1,-9069,-6.9,20.4,0,660,660,3917
2010,33700,6457,7683,123083,124424,640,8.2,761,9.8,13848,4835,9013,3.9,11.1,16530,3561,12969,2.9,13.3,-2682,-2.2,22.2,0,521,521,2331
2011,33700,6333,7620,123731,123076,660,8.6,686,9,14996,5125,9871,4.2,12.2,13686,4435,9251,3.6,11.1,1310,1.1,22.2,0,476,476,2964
2012,33700,6319,7600,125576,124516,673,8.9,690,9.1,16251,4048,12203,3.3,13.1,14131,4647,9484,3.7,11.3,2120,1.8,22.6,0,419,422,2351
2013,33700,6465,7758,129545,127292,730,9.5,592,7.7,16553,5241,11312,4.1,13,12046,3203,8843,2.5,9.5,4507,3.5,19,0,380,381,1804
2014,33700,6490,7791,133585,131112,756,9.8,650,8.4,17382,6075,11307,4.6,13.3,12435,3320,9115,2.5,9.5,4947,3.8,19,0,485,485,2103
1977,33740,2837,3106,40352,38594,532,17.6,362,12,9014,3508,5506,9.1,23.4,5498,2257,3241,5.8,14.2,3516,9.2,28.4,0,247,247,1465
1978,33740,2791,3064,43249,41685,431,14,441,14.3,8781,2485,6296,6,21.1,5652,2699,2953,6.5,13.6,3129,7.5,27.2,0,257,257,1556
1979,33740,3040,3319,46028,44755,472,14.8,243,7.6,8579,3098,5481,6.9,19.2,6032,1733,4299,3.9,13.5,2547,5.7,27,1,1,1,
1980,33740,3054,3337,45021,45345,460,13.8,419,12.6,7272,2790,4482,6.2,16,7920,2801,5119,6.2,17.5,-648,-1.5,32,0,304,304,2028
1981,33740,2990,3248,44280,44458,447,13.6,507,15.4,7464,3348,4116,7.5,16.8,7820,3255,4565,7.3,17.6,-356,-0.8,33.6,0,318,318,1682
1982,33740,3091,3359,44651,44403,534,16.2,373,11.3,7665,3366,4299,7.6,17.3,7169,2176,4993,4.9,16.1,496,1.2,32.2,0,204,204,874
1983,33740,3158,3433,44923,44595,445,13.1,390,11.5,8046,3684,4362,8.3,18,7390,2534,4856,5.7,16.6,656,1.4,33.2,0,278,278,1553
1984,33740,3271,3541,46467,45686,527,15.1,416,11.9,8545,3543,5002,7.8,18.7,6982,3039,3943,6.7,15.3,1563,3.4,30.6,0,283,284,1657
1985,33740,3326,3594,47786,47197,469,13.1,406,11.4,8461,3708,4753,7.9,17.9,7282,2596,4686,5.5,15.4,1179,2.5,30.8,0,270,271,1381
1986,33740,3358,3644,50920,49330,528,14.6,468,12.9,10628,4715,5913,9.6,21.5,7447,2982,4465,6,15.1,3181,6.4,30.2,0,323,323,1642
1987,33740,3363,3660,53601,52168,504,13.8,465,12.7,11607,3780,7827,7.2,22.2,8741,3557,5184,6.8,16.8,2866,5.4,33.6,0,310,310,1903
1988,33740,3226,3535,51415,52295,442,12.3,529,14.7,7968,3461,4507,6.6,15.2,9728,3777,5951,7.2,18.6,-1760,-3.4,30.4,0,365,365,2184
1989,33740,3144,3460,49385,50598,406,11.6,486,13.9,8540,3437,5103,6.8,16.9,10966,6505,4461,12.9,21.7,-2426,-4.8,33.8,0,340,342,2706
1990,33740,3169,3476,51565,50379,395,11.4,353,10.2,9017,2278,6739,4.5,17.9,6645,2846,3799,5.6,13.2,2372,4.7,26.4,0,246,247,2093
1991,33740,3204,3539,51799,51564,430,12.3,373,10.6,9186,4112,5074,8,17.8,8715,3900,4815,7.6,16.9,471,0.9,33.8,0,257,258,2155
1992,33740,3255,3610,54364,53135,410,11.5,330,9.2,9516,2809,6707,5.3,17.9,7058,2721,4337,5.1,13.3,2458,4.6,26.6,0,226,226,1379
1993,33740,3320,3676,54718,54591,416,11.4,341,9.4,8337,2572,5765,4.7,15.3,8083,2643,5440,4.8,14.8,254,0.5,29.6,0,246,246,1575
1994,33740,3320,3690,56063,55368,455,12.4,429,11.6,9179,3200,5979,5.8,16.6,7789,3109,4680,5.6,14.1,1390,2.5,28.2,0,310,310,2010
1995,33740,3408,3803,57602,56661,491,13.1,360,9.6,9629,3995,5634,7.1,17,7747,2739,5008,4.8,13.7,1882,3.3,27.4,0,252,252,1399
1996,33740,3482,3882,59172,58384,453,11.8,366,9.5,9113,3597,5516,6.2,15.6,7536,1954,5582,3.3,12.9,1577,2.7,25.8,0,262,262,1343
1997,33740,3582,3988,60390,59886,524,13.3,429,10.9,9955,3997,5958,6.7,16.6,8947,3011,5936,5,14.9,1008,1.7,29.8,0,280,280,1356
1998,33740,3558,3970,65093,62929,413,10.4,423,10.6,12597,5011,7586,8,20,8269,2955,5314,4.7,13.1,4328,6.9,26.2,0,294,294,1658
1999,33740,3531,3964,66649,66322,429,10.8,441,11.1,11871,3917,7954,5.9,17.9,11217,5286,5931,8,16.9,654,1,33.8,0,297,297,2625
2000,33740,3516,4000,68745,67709,466,11.7,429,10.8,11989,5339,6650,7.9,17.7,9917,4421,5496,6.5,14.6,2072,3.1,29.2,0,269,269,2397
2001,33740,3508,3979,65752,67416,421,10.5,489,12.2,9037,4192,4845,6.2,13.4,12364,5609,6755,8.3,18.3,-3327,-4.9,26.8,0,289,289,1942
2002,33740,3563,4062,63097,63631,494,12.3,403,10,10031,4422,5609,6.9,15.8,11099,3695,7404,5.8,17.4,-1068,-1.6,31.6,0,223,223,1432
2003,33740,3621,4156,71948,67781,463,11.3,285,7,15963,4001,11962,5.9,23.6,7629,2261,5368,3.3,11.3,8334,12.3,22.6,0,206,206,1095
2004,33740,3705,4243,68604,70073,434,10.4,313,7.5,9815,3423,6392,4.9,14,12752,6745,6007,9.6,18.2,-2937,-4.2,28,0,226,226,6157
2005,33740,3717,4237,66906,67381,411,9.7,369,8.7,8754,2815,5939,4.2,13,9703,2483,7220,3.7,14.4,-949,-1.4,26,0,242,242,1671
2006,33740,3699,4264,67038,66750,468,11,395,9.3,10612,4005,6607,6,15.9,10036,2532,7504,3.8,15,576,0.9,30,0,262,262,1519
2007,33740,3723,4302,66806,66712,421,9.8,369,8.6,11559,5224,6335,7.8,17.3,11371,4148,7223,6.2,17,188,0.3,34,0,247,248,1493
2008,33740,3688,4271,65952,66281,355,8.3,348,8.1,8985,2868,6117,4.3,13.6,9642,3376,6266,5.1,14.5,-657,-0.9,27.2,0,269,269,2329
2009,33740,3632,4207,64492,65029,308,7.3,348,8.2,7610,2547,5063,3.9,11.7,8684,2280,6404,3.5,13.4,-1074,-1.7,23.4,0,249,249,1648
2010,33740,3614,4185,63855,63981,313,7.5,300,7.2,8451,2398,6053,3.7,13.2,8703,1849,6854,2.9,13.6,-252,-0.4,26.4,0,200,203,1164
2011,33740,3615,4186,64580,64120,337,8.1,312,7.5,10080,3127,6953,4.9,15.7,9159,3421,5738,5.3,14.3,921,1.4,28.6,0,209,211,1320
2012,33740,3661,4257,63148,63826,366,8.7,315,7.5,8341,2912,5429,4.6,13.1,9696,3123,6573,4.9,15.2,-1355,-2.1,26.2,0,208,215,2282
2013,33740,3649,4231,65005,64071,302,7.1,342,8.1,7561,1997,5564,3.1,11.8,5693,1644,4049,2.6,8.9,1868,2.9,17.8,0,237,238,1229
2014,33740,3592,4197,64355,64602,310,7.4,312,7.4,7481,1907,5574,3,11.6,7975,2723,5252,4.2,12.3,-494,-0.7,23.2,0,222,222,1165
1977,33780,1365,1452,25288,24532,199,13.9,155,10.8,3515,1550,1965,6.3,14.3,2003,699,1304,2.8,8.2,1512,6.1,16.4,0,100,100,415
1978,33780,1405,1495,23753,24316,207,14,164,11.1,4258,1276,2982,5.2,17.5,5384,4367,1017,18,22.1,-1126,-4.6,35,0,112,112,3647
1979,33780,1426,1512,24778,24232,184,12.2,159,10.6,4235,1144,3091,4.7,17.5,3142,1777,1365,7.3,13,1093,4.5,26,0,112,114,1423
1980,33780,1421,1512,23502,24147,171,11.3,167,11,2998,995,2003,4.1,12.4,4287,988,3299,4.1,17.8,-1289,-5.4,24.8,0,120,120,506
1981,33780,1342,1435,21887,22663,149,10.1,210,14.3,2549,1069,1480,4.7,11.2,4101,2237,1864,9.9,18.1,-1552,-6.9,22.4,0,114,114,491
1982,33780,1300,1406,23561,22706,164,11.5,170,12,4851,3001,1850,13.2,21.4,3141,948,2193,4.2,13.8,1710,7.6,27.6,0,98,98,405
1983,33780,1348,1465,22930,23266,169,11.8,126,8.8,3436,1497,1939,6.4,14.8,4107,1050,3057,4.5,17.7,-671,-2.9,29.6,0,73,73,676
1984,33780,1407,1523,23889,23410,190,12.7,134,9,3486,1211,2275,5.2,14.9,2528,1075,1453,4.6,10.8,958,4.1,21.6,0,78,78,307
1985,33780,1457,1575,23314,23599,192,12.4,138,8.9,2537,714,1823,3,10.8,3106,829,2277,3.5,13.2,-569,-2.4,21.6,0,95,95,425
1986,33780,1491,1612,25533,24407,195,12.2,149,9.4,4524,1111,3413,4.6,18.5,2272,995,1277,4.1,9.3,2252,9.2,18.6,0,89,89,316
1987,33780,1556,1681,26223,25899,227,13.8,149,9,3539,1609,1930,6.2,13.7,2891,840,2051,3.2,11.2,648,2.5,22.4,0,93,93,389
1988,33780,1629,1763,27319,26780,228,13.3,145,8.4,3972,1156,2816,4.3,14.8,2893,1128,1765,4.2,10.8,1079,4,21.6,0,106,106,610
1989,33780,1716,1877,29515,28425,261,14.3,149,8.2,5226,1971,3255,6.9,18.4,3046,613,2433,2.2,10.7,2180,7.7,21.4,0,111,111,415
1990,33780,1763,1933,30457,29981,235,12.3,171,9,5320,1602,3718,5.3,17.7,4367,1382,2985,4.6,14.6,953,3.1,29.2,0,109,109,581
1991,33780,1788,1966,29787,30084,220,11.3,186,9.5,3596,1534,2062,5.1,12,4190,1001,3189,3.3,13.9,-594,-1.9,24,0,128,128,547
1992,33780,1813,1991,30789,30281,194,9.8,160,8.1,4370,1471,2899,4.9,14.4,3353,902,2451,3,11.1,1017,3.3,22.2,0,96,96,470
1993,33780,1818,2003,30662,30719,230,11.5,212,10.6,4535,1500,3035,4.9,14.8,4648,2086,2562,6.8,15.1,-113,-0.3,29.6,0,136,136,727
1994,33780,1850,2040,32934,31715,200,9.9,156,7.7,5842,1949,3893,6.1,18.4,3404,934,2470,2.9,10.7,2438,7.7,21.4,0,100,100,523
1995,33780,1916,2099,34982,33952,215,10.4,156,7.5,5064,2092,2972,6.2,14.9,3003,960,2043,2.8,8.8,2061,6.1,17.6,0,100,100,491
1996,33780,1933,2115,33968,34112,204,9.7,180,8.5,4209,1348,2861,4,12.3,4497,1032,3465,3,13.2,-288,-0.9,24.6,0,131,131,611
1997,33780,1948,2130,35641,34829,211,9.9,195,9.2,5594,1401,4193,4,16.1,3969,1255,2714,3.6,11.4,1625,4.7,22.8,0,122,122,596
1998,33780,1979,2159,36112,35900,233,10.9,211,9.8,4760,1819,2941,5.1,13.3,4335,1057,3278,2.9,12.1,425,1.2,24.2,0,145,145,579
1999,33780,2009,2202,36785,36466,248,11.4,211,9.7,5348,1884,3464,5.2,14.7,4709,1983,2726,5.4,12.9,639,1.8,25.8,0,136,136,676
2000,33780,2035,2226,39165,38023,226,10.2,203,9.2,5706,1547,4159,4.1,15,3422,1352,2070,3.6,9,2284,6,18,0,119,119,686
2001,33780,2045,2246,39741,39511,221,9.9,215,9.6,5918,2491,3427,6.3,15,5457,1750,3707,4.4,13.8,461,1.2,27.6,0,132,132,974
2002,33780,2041,2257,38049,38864,275,12.2,262,11.6,5170,2204,2966,5.7,13.3,6799,1912,4887,4.9,17.5,-1629,-4.2,26.6,0,140,140,739
2003,33780,2023,2246,37476,37627,224,10,201,9,4429,1528,2901,4.1,11.8,4730,1588,3142,4.2,12.6,-301,-0.8,23.6,0,132,132,988
2004,33780,2060,2277,38325,37600,236,10.5,177,7.9,5207,2063,3144,5.5,13.8,3757,1077,2680,2.9,10,1450,3.8,20,0,111,111,674
2005,33780,2064,2289,38521,38345,225,9.9,199,8.7,4856,1940,2916,5.1,12.7,4503,992,3511,2.6,11.7,353,1,23.4,0,138,138,695
2006,33780,2098,2326,39153,38648,247,10.7,191,8.3,6205,1679,4526,4.3,16.1,5195,969,4226,2.5,13.4,1010,2.7,26.8,0,123,123,645
2007,33780,2080,2309,38552,38795,233,10.1,239,10.3,4970,1538,3432,4,12.8,5456,1532,3924,3.9,14.1,-486,-1.3,25.6,0,149,149,465
2008,33780,2015,2258,39390,38753,233,10.3,245,10.8,5674,2792,2882,7.2,14.6,4400,1522,2878,3.9,11.4,1274,3.2,22.8,0,160,160,810
2009,33780,1929,2153,35401,37331,149,6.8,240,10.9,3778,1522,2256,4.1,10.1,7638,3227,4411,8.6,20.5,-3860,-10.4,20.2,0,145,148,1029
2010,33780,1903,2117,33993,34598,163,7.7,183,8.6,3740,1072,2668,3.1,10.8,4949,1023,3926,3,14.3,-1209,-3.5,21.6,0,111,111,610
2011,33780,1856,2074,34069,33899,161,7.7,186,8.9,4048,1207,2841,3.6,11.9,3708,1303,2405,3.8,10.9,340,1,21.8,0,131,131,630
2012,33780,1843,2054,33630,33597,171,8.3,183,8.9,4336,1131,3205,3.4,12.9,4270,1922,2348,5.7,12.7,66,0.2,25.4,0,115,116,430
2013,33780,1826,2043,34767,34115,170,8.3,179,8.8,4426,1023,3403,3,13,3121,796,2325,2.3,9.1,1305,3.9,18.2,0,118,118,577
2014,33780,1789,2009,35326,34972,151,7.5,174,8.6,3904,812,3092,2.3,11.2,3195,1139,2056,3.3,9.1,709,2.1,18.2,0,125,125,807
1977,33860,4369,4970,71872,70354,854,17.6,614,12.6,14614,7251,7363,10.3,20.8,11577,4852,6725,6.9,16.5,3037,4.3,33,0,398,400,2941
1978,33860,4609,5238,81814,76832,892,17.5,614,12,20206,7880,12326,10.3,26.3,10242,4747,5495,6.2,13.3,9964,13,26.6,0,422,425,2220
1979,33860,4616,5274,82954,82326,709,13.5,630,12,16278,5717,10561,6.9,19.8,15022,7027,7995,8.5,18.2,1256,1.6,36.4,0,454,454,2795
1980,33860,4656,5321,83576,83264,707,13.3,667,12.6,14294,5408,8886,6.5,17.2,13669,4914,8755,5.9,16.4,625,0.8,32.8,0,466,468,3303
1981,33860,4426,5055,82275,82345,636,12.3,836,16.1,14510,5172,9338,6.3,17.6,14649,6755,7894,8.2,17.8,-139,-0.2,35.2,0,520,521,3385
1982,33860,4438,5148,86222,84276,728,14.2,606,11.9,19194,6665,12529,7.9,22.8,15301,4315,10986,5.1,18.2,3893,4.6,36.4,0,366,366,2230
1983,33860,4495,5202,78123,81676,633,12.2,614,11.9,13199,5618,7581,6.9,16.2,20304,4930,15374,6,24.9,-7105,-8.7,32.4,0,416,417,2621
1984,33860,4641,5355,84688,81507,738,14,587,11.1,17234,5500,11734,6.7,21.1,10872,4859,6013,6,13.3,6362,7.8,26.6,0,362,362,1927
1985,33860,4783,5480,92012,88632,726,13.4,615,11.3,19005,6320,12685,7.1,21.4,12244,5586,6658,6.3,13.8,6761,7.6,27.6,0,347,350,3144
1986,33860,4950,5671,99254,95537,814,14.6,608,10.9,23937,8887,15050,9.3,25.1,16503,5718,10785,6,17.3,7434,7.8,34.6,0,391,398,3223
1987,33860,5070,5858,101219,100821,877,15.2,664,11.5,19323,7123,12200,7.1,19.2,18527,6604,11923,6.6,18.4,796,0.8,36.8,0,400,403,2332
1988,33860,5075,5904,105455,102972,755,12.9,680,11.6,23196,7224,15972,7,22.5,18229,6229,12000,6,17.7,4967,4.8,35.4,0,436,436,2110
1989,33860,5259,6168,105925,105940,822,13.6,572,9.5,17793,6703,11090,6.3,16.8,17822,3758,14064,3.5,16.8,-29,0,33.6,0,399,405,2486
1990,33860,5348,6287,107214,106433,773,12.4,616,9.9,18737,7658,11079,7.2,17.6,17175,5041,12134,4.7,16.1,1562,1.5,32.2,0,410,410,3215
1991,33860,5446,6416,102325,104578,785,12.4,660,10.4,16151,6784,9367,6.5,15.4,20657,6789,13868,6.5,19.8,-4506,-4.4,30.8,0,391,399,3386
1992,33860,5543,6570,106554,104496,827,12.7,663,10.2,19728,6815,12913,6.5,18.9,15612,6155,9457,5.9,14.9,4116,4,29.8,0,426,429,3138
1993,33860,5688,6703,108937,107818,756,11.4,612,9.2,16423,5187,11236,4.8,15.2,14184,4295,9889,4,13.2,2239,2,26.4,0,406,407,2052
1994,33860,5826,6838,112961,110933,835,12.3,673,9.9,18466,5199,13267,4.7,16.6,14410,4830,9580,4.4,13,4056,3.6,26,0,452,453,2391
1995,33860,5971,7017,117339,115100,806,11.6,596,8.6,18350,6031,12319,5.2,15.9,13872,4373,9499,3.8,12.1,4478,3.8,24.2,0,415,417,2230
1996,33860,6093,7166,119220,118234,845,11.9,675,9.5,17468,6851,10617,5.8,14.8,15496,4470,11026,3.8,13.1,1972,1.7,26.2,0,448,448,2457
1997,33860,6220,7337,121049,120048,904,12.5,757,10.4,20961,8056,12905,6.7,17.5,18958,6242,12716,5.2,15.8,2003,1.7,31.6,0,480,480,2951
1998,33860,6167,7279,122511,121715,821,11.2,846,11.6,21068,8008,13060,6.6,17.3,19476,7713,11763,6.3,16,1592,1.3,32,0,554,554,3504
1999,33860,6162,7331,127547,125132,817,11.2,750,10.3,23477,10070,13407,8,18.8,18647,7538,11109,6,14.9,4830,3.9,29.8,0,477,477,2917
2000,33860,6128,7303,133603,130448,764,10.4,797,10.9,23722,6776,16946,5.2,18.2,17411,6055,11356,4.6,13.3,6311,4.9,26.6,0,483,483,3011
2001,33860,6020,7243,130857,132539,684,9.4,798,11,18223,6614,11609,5,13.7,21587,6992,14595,5.3,16.3,-3364,-2.6,27.4,0,438,438,3022
2002,33860,5983,7285,126103,128308,901,12.4,840,11.6,20927,9980,10947,7.8,16.3,25336,7961,17375,6.2,19.7,-4409,-3.4,32.6,0,488,488,2907
2003,33860,6002,7331,126683,125612,825,11.4,646,8.9,21232,7773,13459,6.2,16.9,19089,4116,14973,3.3,15.2,2143,1.7,30.4,0,468,468,2608
2004,33860,6079,7377,126559,125556,753,10.3,620,8.5,20055,6679,13376,5.3,16,18049,6304,11745,5,14.4,2006,1.6,28.8,0,377,377,3083
2005,33860,6182,7524,132045,129408,820,11,619,8.3,22609,8736,13873,6.8,17.5,17335,5405,11930,4.2,13.4,5274,4.1,26.8,0,430,430,3273
2006,33860,6239,7603,137083,134309,814,10.8,662,8.8,23664,9286,14378,6.9,17.6,18116,5719,12397,4.3,13.5,5548,4.1,27,0,431,431,3330
2007,33860,6216,7687,139676,138184,827,10.8,734,9.6,23048,7019,16029,5.1,16.7,20063,6276,13787,4.5,14.5,2985,2.2,29,0,459,470,3715
2008,33860,6178,7651,141959,140235,713,9.4,658,8.6,21197,7590,13607,5.4,15.1,17748,4443,13305,3.2,12.7,3449,2.4,25.4,0,474,474,2858
2009,33860,5953,7404,130615,135405,555,7.4,733,9.8,12799,4610,8189,3.4,9.5,22378,5410,16968,4,16.5,-9579,-7,19,0,524,524,3004
2010,33860,5764,7215,126191,128082,500,6.9,631,8.7,14393,4770,9623,3.7,11.2,18175,5890,12285,4.6,14.2,-3782,-3,22.4,0,436,436,2299
2011,33860,5650,7077,126438,125982,543,7.6,615,8.6,14782,5841,8941,4.6,11.7,13870,3902,9968,3.1,11,912,0.7,22,0,405,411,2385
2012,33860,5696,7120,126644,126485,592,8.4,544,7.7,14601,4410,10191,3.5,11.5,14283,3679,10604,2.9,11.3,318,0.2,22.6,0,316,318,1734
2013,33860,5658,7093,127854,127059,569,8,593,8.4,15381,4424,10957,3.5,12.1,13791,3817,9974,3,10.9,1590,1.2,21.8,0,393,405,2256
2014,33860,5649,7100,129283,128220,542,7.7,468,6.6,14489,4412,10077,3.4,11.3,12362,2693,9669,2.1,9.6,2127,1.7,19.2,0,329,330,1805
1977,34060,1501,1617,19728,19999,243,15.3,170,10.7,3224,1720,1504,8.6,16.1,3765,1928,1837,9.6,18.8,-541,-2.7,32.2,0,112,112,592
1978,34060,1558,1672,18750,18978,229,13.9,167,10.2,3108,1001,2107,5.3,16.4,3565,1135,2430,6,18.8,-457,-2.4,32.8,0,96,96,451
1979,34060,1593,1704,20756,19706,243,14.4,192,11.4,4227,1164,3063,5.9,21.5,2128,784,1344,4,10.8,2099,10.7,21.6,0,132,135,501
1980,34060,1597,1703,21033,20901,207,12.2,206,12.1,3540,1307,2233,6.3,16.9,3275,960,2315,4.6,15.7,265,1.2,31.4,0,150,150,646
1981,34060,1507,1611,20401,20719,177,10.7,255,15.4,2698,976,1722,4.7,13,3334,1163,2171,5.6,16.1,-636,-3.1,26,0,160,160,676
1982,34060,1501,1625,20051,20210,227,14,188,11.6,3342,1408,1934,7,16.5,3660,1672,1988,8.3,18.1,-318,-1.6,33,0,106,106,1029
1983,34060,1535,1650,19775,19974,179,10.9,182,11.1,3120,1212,1908,6.1,15.6,3517,1075,2442,5.4,17.6,-397,-2,31.2,0,115,115,600
1984,34060,1492,1605,20920,20309,200,12.3,230,14.1,4024,1686,2338,8.3,19.8,2802,1466,1336,7.2,13.8,1222,6,27.6,0,113,113,485
1985,34060,1657,1773,22967,22172,237,14,95,5.6,4173,2438,1735,11,18.8,2583,533,2050,2.4,11.6,1590,7.2,23.2,0,4,4,33
1986,34060,1687,1818,24682,23819,250,13.9,205,11.4,5231,2109,3122,8.9,22,3504,1229,2275,5.2,14.7,1727,7.3,29.4,0,121,121,650
1987,34060,1761,1920,25425,25159,292,15.6,185,9.9,4658,1890,2768,7.5,18.5,4125,1675,2450,6.7,16.4,533,2.1,32.8,0,128,129,718
1988,34060,1775,1943,25878,25509,246,12.8,217,11.3,4427,1855,2572,7.3,17.4,3689,1418,2271,5.6,14.5,738,2.9,29,0,146,146,514
1989,34060,1800,1981,27947,27469,248,12.6,205,10.4,4261,2005,2256,7.3,15.5,3304,970,2334,3.5,12,957,3.5,24,0,146,146,658
1990,34060,1847,2049,29344,28723,240,11.9,153,7.6,4568,1403,3165,4.9,15.9,3325,917,2408,3.2,11.6,1243,4.3,23.2,0,104,104,529
1991,34060,1888,2113,30079,29569,265,12.7,203,9.8,5160,2270,2890,7.7,17.5,4140,1230,2910,4.2,14,1020,3.5,28,0,129,129,807
1992,34060,1888,2122,29618,29813,234,11,214,10.1,4843,1803,3040,6,16.2,5232,1815,3417,6.1,17.5,-389,-1.3,32.4,0,136,136,992
1993,34060,1920,2163,30401,30011,240,11.2,195,9.1,4933,1425,3508,4.7,16.4,4153,1238,2915,4.1,13.8,780,2.6,27.6,0,138,138,945
1994,34060,1986,2238,31194,30768,261,11.9,183,8.3,4960,1961,2999,6.4,16.1,4108,1497,2611,4.9,13.4,852,2.7,26.8,0,120,120,593
1995,34060,2014,2270,32715,31910,264,11.7,227,10.1,5715,2646,3069,8.3,17.9,4105,1565,2540,4.9,12.9,1610,5,25.8,0,166,166,902
1996,34060,2028,2283,32252,32560,236,10.4,221,9.7,4203,1616,2587,5,12.9,4818,1590,3228,4.9,14.8,-615,-1.9,25.8,0,153,153,759
1997,34060,2033,2288,32309,32263,263,11.5,249,10.9,5244,2289,2955,7.1,16.3,5152,1762,3390,5.5,16,92,0.3,32,0,146,146,916
1998,34060,2018,2278,33438,32901,229,10,232,10.2,5169,2250,2919,6.8,15.7,4095,1477,2618,4.5,12.4,1074,3.3,24.8,0,153,153,694
1999,34060,2055,2314,33822,33623,270,11.8,238,10.4,4528,2145,2383,6.4,13.5,4130,1355,2775,4,12.3,398,1.2,24.6,0,157,157,731
2000,34060,2107,2367,34747,34206,267,11.4,208,8.9,5680,2418,3262,7.1,16.6,4598,1426,3172,4.2,13.4,1082,3.2,26.8,0,131,131,669
2001,34060,2068,2329,36056,35536,210,8.9,268,11.4,5155,1432,3723,4,14.5,4115,1404,2711,4,11.6,1040,2.9,23.2,0,157,157,631
2002,34060,2094,2349,37174,36613,261,11.2,234,10,5407,1733,3674,4.7,14.8,4285,1094,3191,3,11.7,1122,3.1,23.4,0,125,127,504
2003,34060,2096,2370,37288,37036,250,10.6,190,8.1,5025,1416,3609,3.8,13.6,4521,1188,3333,3.2,12.2,504,1.4,24.4,0,128,128,722
2004,34060,2150,2424,38955,37947,252,10.5,182,7.6,5172,1465,3707,3.9,13.6,3155,769,2386,2,8.3,2017,5.3,16.6,0,135,136,500
2005,34060,2174,2462,39182,39026,275,11.3,212,8.7,5391,1881,3510,4.8,13.8,5079,1306,3773,3.3,13,312,0.8,26,0,158,158,793
2006,34060,2182,2483,40479,39748,276,11.2,234,9.5,6102,2117,3985,5.3,15.4,4640,1541,3099,3.9,11.7,1462,3.7,23.4,0,157,158,878
2007,34060,2192,2530,42679,41589,259,10.3,229,9.1,7406,3313,4093,8,17.8,5225,1297,3928,3.1,12.6,2181,5.2,25.2,0,148,149,819
2008,34060,2157,2506,42523,42484,205,8.2,208,8.3,5289,1726,3563,4.1,12.4,5210,1759,3451,4.1,12.3,79,0.1,24.6,0,143,143,922
2009,34060,2178,2551,44663,43617,229,9.1,180,7.1,6281,2146,4135,4.9,14.4,4188,1023,3165,2.3,9.6,2093,4.8,19.2,0,126,126,836
2010,34060,2146,2523,43908,44257,201,7.9,207,8.2,4407,1394,3013,3.1,10,5104,1184,3920,2.7,11.5,-697,-1.5,20,0,126,128,758
2011,34060,2152,2536,45725,44760,218,8.6,188,7.4,5944,1786,4158,4,13.3,4014,1269,2745,2.8,9,1930,4.3,18,0,130,130,730
2012,34060,2190,2562,48918,47269,234,9.2,212,8.3,7899,1975,5924,4.2,16.7,4600,1524,3076,3.2,9.7,3299,7,19.4,0,125,125,642
2013,34060,2183,2567,48526,48674,223,8.7,225,8.8,5975,2075,3900,4.3,12.3,6271,3080,3191,6.3,12.9,-296,-0.6,24.6,0,133,133,1414
2014,34060,2193,2588,49521,48936,223,8.7,188,7.3,5962,2584,3378,5.3,12.2,4791,1347,3444,2.8,9.8,1171,2.4,19.6,0,131,131,866
1977,34100,1332,1411,26539,26785,251,18.3,163,11.9,3591,1266,2325,4.7,13.4,4083,1876,2207,7,15.2,-492,-1.8,26.8,0,108,108,1116
1978,34100,1344,1425,30485,28513,208,14.7,193,13.6,6545,2385,4160,8.4,23,2600,1124,1476,3.9,9.1,3945,13.9,18.2,0,145,145,810
1979,34100,1360,1444,31241,30861,197,13.7,171,11.9,4324,1223,3101,4,14,3563,937,2626,3,11.5,761,2.5,23,0,117,117,565
1980,34100,1376,1456,30042,30631,189,13,170,11.7,3550,1088,2462,3.6,11.6,4728,1815,2913,5.9,15.4,-1178,-3.8,23.2,0,120,120,546
1981,34100,1309,1389,27037,27838,164,11.6,199,14.1,3577,1600,1977,5.7,12.8,5179,2334,2845,8.4,18.6,-1602,-5.8,25.6,0,140,141,810
1982,34100,1313,1403,27345,27140,207,14.8,177,12.7,4383,2382,2001,8.8,16.1,3972,1110,2862,4.1,14.6,411,1.5,29.2,0,107,107,713
1983,34100,1332,1425,27525,27413,187,13.2,168,11.9,4020,2075,1945,7.6,14.7,3796,1282,2514,4.7,13.8,224,0.9,27.6,0,111,111,709
1984,34100,1412,1514,29944,28685,257,17.5,164,11.2,5344,1786,3558,6.2,18.6,2826,1566,1260,5.5,9.9,2518,8.7,19.8,0,128,128,709
1985,34100,1476,1573,31246,31220,222,14.3,186,12,3740,1429,2311,4.6,12,3687,1828,1859,5.9,11.8,53,0.2,23.6,0,126,126,1202
1986,34100,1524,1631,30160,30630,237,14.8,175,10.9,3837,1834,2003,6,12.5,4777,1811,2966,5.9,15.6,-940,-3.1,25,0,126,126,801
1987,34100,1558,1669,31380,30871,200,12.1,158,9.6,4732,1493,3239,4.8,15.3,3713,1492,2221,4.8,12,1019,3.3,24,0,119,119,995
1988,34100,1553,1687,31974,31466,237,14.2,202,12.1,5397,2611,2786,8.3,17.2,4381,1854,2527,5.9,13.9,1016,3.3,27.8,0,138,138,611
1989,34100,1616,1754,34182,33129,218,12.7,151,8.8,5740,1680,4060,5.1,17.3,3634,1888,1746,5.7,11,2106,6.3,22,0,111,111,778
1990,34100,1653,1806,37491,35837,213,12,152,8.5,6299,1979,4320,5.5,17.6,2990,934,2056,2.6,8.3,3309,9.3,16.6,0,126,126,664
1991,34100,1657,1824,36469,36890,200,11,182,10,5241,2167,3074,5.9,14.2,6083,1743,4340,4.7,16.5,-842,-2.3,28.4,0,122,122,740
1992,34100,1687,1855,38233,37250,209,11.3,175,9.5,6374,2606,3768,7,17.1,4407,1963,2444,5.3,11.8,1967,5.3,23.6,0,107,107,760
1993,34100,1715,1885,38565,38356,207,11.1,171,9.1,5659,1886,3773,4.9,14.8,5241,2121,3120,5.5,13.7,418,1.1,27.4,0,126,126,1574
1994,34100,1786,1961,38419,38497,229,11.9,151,7.9,4662,1358,3304,3.5,12.1,4818,2104,2714,5.5,12.5,-156,-0.4,24.2,0,104,104,1694
1995,34100,1819,1994,39111,38705,249,12.6,204,10.3,7842,4479,3363,11.6,20.3,7030,1581,5449,4.1,18.2,812,2.1,36.4,0,151,151,605
1996,34100,1837,2019,39662,39391,250,12.5,224,11.2,5692,2440,3252,6.2,14.5,5150,1957,3193,5,13.1,542,1.4,26.2,0,169,169,1205
1997,34100,1859,2056,40310,40018,254,12.4,212,10.4,6134,1776,4358,4.4,15.3,5549,3104,2445,7.8,13.9,585,1.4,27.8,0,140,140,1212
1998,34100,1889,2105,40604,40444,241,11.6,188,9,5203,2033,3170,5,12.9,4882,1449,3433,3.6,12.1,321,0.8,24.2,0,143,143,798
1999,34100,1860,2073,43365,42098,207,9.9,241,11.5,6891,2354,4537,5.6,16.4,4356,1699,2657,4,10.3,2535,6.1,20.6,0,151,151,573
2000,34100,1877,2103,44496,43937,204,9.8,175,8.4,6437,2323,4114,5.3,14.7,5318,2193,3125,5,12.1,1119,2.6,24.2,0,126,126,533
2001,34100,1871,2100,43887,44199,198,9.4,208,9.9,5289,2393,2896,5.4,12,5913,1227,4686,2.8,13.4,-624,-1.4,24,0,126,126,743
2002,34100,1845,2078,40481,42163,213,10.2,239,11.4,4968,1786,3182,4.2,11.8,8332,3691,4641,8.8,19.8,-3364,-8,23.6,0,129,129,1303
2003,34100,1849,2105,41052,40639,235,11.3,177,8.5,5490,1441,4049,3.5,13.5,4663,1365,3298,3.4,11.5,827,2,23,0,132,132,1000
2004,34100,1841,2113,41657,40918,185,8.8,155,7.4,5116,1272,3844,3.1,12.5,3637,923,2714,2.3,8.9,1479,3.6,17.8,0,112,112,565
2005,34100,1857,2150,42786,41883,202,9.5,153,7.2,5569,2120,3449,5.1,13.3,3763,752,3011,1.8,9,1806,4.3,18,0,113,113,528
2006,34100,1877,2190,44536,43803,237,10.9,181,8.4,6316,2653,3663,6.1,14.4,4850,1715,3135,3.9,11.1,1466,3.3,22.2,0,128,128,1211
2007,34100,1896,2210,43571,43681,219,10,202,9.2,7071,2396,4675,5.5,16.2,7291,2396,4895,5.5,16.7,-220,-0.5,32.4,0,128,128,1090
2008,34100,1898,2215,43182,43165,181,8.2,160,7.3,4650,1232,3418,2.9,10.8,4616,926,3690,2.1,10.7,34,0.1,21.4,0,135,136,836
2009,34100,1802,2123,39016,41085,156,7.2,228,10.5,3689,1122,2567,2.7,9,7826,1576,6250,3.8,19,-4137,-10,18,0,169,169,1166
2010,34100,1733,2048,37522,38191,139,6.7,200,9.6,3689,844,2845,2.2,9.7,5027,1376,3651,3.6,13.2,-1338,-3.5,19.4,0,156,156,1141
2011,34100,1689,2005,37172,37264,146,7.2,163,8.1,4154,1257,2897,3.4,11.1,4338,959,3379,2.6,11.6,-184,-0.5,22.2,0,117,118,637
2012,34100,1698,2018,37623,37416,164,8.2,164,8.2,5132,1754,3378,4.7,13.7,4717,1364,3353,3.6,12.6,415,1.1,25.2,0,114,115,424
2013,34100,1704,2019,38061,37769,162,8.1,147,7.3,4819,1491,3328,3.9,12.8,4234,1263,2971,3.3,11.2,585,1.6,22.4,0,104,104,994
2014,34100,1689,2008,38880,38375,159,7.9,151,7.5,4269,1290,2979,3.4,11.1,3259,1047,2212,2.7,8.5,1010,2.6,17,0,113,113,666
1977,34580,1298,1381,13890,13709,283,21.1,193,14.4,2872,1463,1409,10.7,20.9,2509,1077,1432,7.9,18.3,363,2.6,36.6,0,119,119,484
1978,34580,1418,1495,17339,15622,314,21.8,202,14,5630,2646,2984,16.9,36,2196,1090,1106,7,14.1,3434,21.9,28.2,0,118,120,438
1979,34580,1516,1597,17359,17338,303,19.6,194,12.5,4397,1382,3015,8,25.4,4355,1275,3080,7.4,25.1,42,0.3,50.2,0,135,135,953
1980,34580,1550,1626,16707,17004,255,15.8,217,13.5,3038,1306,1732,7.7,17.9,3631,1457,2174,8.6,21.4,-593,-3.5,35.8,0,164,164,942
1981,34580,1485,1563,14386,14603,225,14.2,249,15.7,3011,1208,1803,8.3,20.6,3445,1696,1749,11.6,23.6,-434,-3,41.2,0,152,152,660
1982,34580,1495,1591,16067,15226,273,17.3,214,13.6,5134,3335,1799,21.9,33.7,3451,1801,1650,11.8,22.7,1683,11,45.4,0,119,119,476
1983,34580,1551,1655,15401,15752,237,14.6,192,11.8,3446,1687,1759,10.7,21.9,4147,1009,3138,6.4,26.3,-701,-4.4,43.8,0,135,135,656
1984,34580,1609,1711,17281,16343,260,15.4,202,12,5130,2509,2621,15.4,31.4,3253,1573,1680,9.6,19.9,1877,11.5,39.8,0,123,123,1080
1985,34580,1671,1777,17834,18535,273,15.6,214,12.2,3749,1839,1910,9.9,20.2,5151,1358,3793,7.3,27.8,-1402,-7.6,40.4,0,147,148,1030
1986,34580,1729,1831,18720,18269,270,15,210,11.6,4086,1789,2297,9.8,22.4,3184,1077,2107,5.9,17.4,902,5,34.8,0,136,136,680
1987,34580,1780,1887,19583,18750,288,15.5,217,11.7,4788,1841,2947,9.8,25.5,3122,1186,1936,6.3,16.7,1666,8.8,33.4,0,146,146,635
1988,34580,1796,1906,18781,18492,267,14.1,229,12.1,4282,1711,2571,9.3,23.2,3703,988,2715,5.3,20,579,3.2,40,0,148,148,590
1989,34580,1596,1706,19641,19194,275,15.2,466,25.8,5613,2117,3496,11,29.2,4718,3217,1501,16.8,24.6,895,4.6,49.2,0,146,146,694
1990,34580,2008,2133,23135,21384,615,32,178,9.3,7499,4453,3046,20.8,35.1,3996,1190,2806,5.6,18.7,3503,16.4,37.4,0,109,109,720
1991,34580,2112,2262,24513,23795,367,16.7,227,10.3,5784,2467,3317,10.4,24.3,4348,1495,2853,6.3,18.3,1436,6,36.6,0,143,143,880
1992,34580,2219,2392,25674,25048,404,17.4,250,10.7,6106,2938,3168,11.7,24.4,4853,1820,3033,7.3,19.4,1253,5,38.8,0,171,172,1004
1993,34580,2307,2464,26821,26197,359,14.8,272,11.2,5536,2165,3371,8.3,21.1,4288,1383,2905,5.3,16.4,1248,4.7,32.8,0,167,167,738
1994,34580,2384,2553,27936,27375,398,15.9,297,11.8,5671,2133,3538,7.8,20.7,4549,1630,2919,6,16.6,1122,4.1,33.2,0,205,205,928
1995,34580,2453,2622,28100,28004,389,15,301,11.6,5584,2343,3241,8.4,19.9,5391,2328,3063,8.3,19.3,193,0.6,38.6,0,192,192,986
1996,34580,2512,2684,28167,28111,398,15,321,12.1,5277,2183,3094,7.8,18.8,5165,1707,3458,6.1,18.4,112,0.4,36.8,0,200,200,945
1997,34580,2556,2730,29794,29311,378,13.9,331,12.2,6082,2235,3847,7.6,20.7,5116,1961,3155,6.7,17.5,966,3.2,35,0,206,206,917
1998,34580,2576,2748,31595,30809,363,13.3,337,12.3,6401,2719,3682,8.8,20.8,4828,1597,3231,5.2,15.7,1573,5.1,31.4,0,220,220,769
1999,34580,2582,2757,32853,31721,340,12.4,327,11.9,6589,2496,4093,7.9,20.8,4325,1605,2720,5.1,13.6,2264,7.2,27.2,0,207,207,816
2000,34580,2606,2784,34981,34016,358,12.9,338,12.2,6668,3110,3558,9.1,19.6,4738,1876,2862,5.5,13.9,1930,5.7,27.8,0,219,219,850
2001,34580,2679,2875,34811,34962,369,13,315,11.1,5294,2303,2991,6.6,15.1,5595,1847,3748,5.3,16,-301,-0.9,30.2,0,202,202,1018
2002,34580,2692,2900,34589,34663,381,13.2,346,12,5732,2269,3463,6.5,16.5,5879,1541,4338,4.4,17,-147,-0.5,33,0,179,179,733
2003,34580,2730,2948,38868,36433,377,13,275,9.4,9325,5383,3942,14.8,25.6,4454,1340,3114,3.7,12.2,4871,13.4,24.4,0,184,184,900
2004,34580,2773,3001,40259,39459,380,12.8,301,10.1,6284,2282,4002,5.8,15.9,4683,1287,3396,3.3,11.9,1601,4,23.8,0,203,203,1005
2005,34580,2874,3112,37970,38885,430,14.1,295,9.7,6456,2367,4089,6.1,16.6,8285,5021,3264,12.9,21.3,-1829,-4.7,33.2,0,216,216,4604
2006,34580,2918,3176,39049,38412,433,13.8,336,10.7,6232,2472,3760,6.4,16.2,4958,1964,2994,5.1,12.9,1274,3.3,25.8,0,245,245,1309
2007,34580,2980,3242,40057,39491,408,12.7,325,10.1,6535,2761,3774,7,16.5,5402,1922,3480,4.9,13.7,1133,2.8,27.4,0,205,206,847
2008,34580,2978,3238,40510,40178,367,11.4,334,10.4,5513,1957,3556,4.9,13.7,4848,1413,3435,3.5,12.1,665,1.6,24.2,0,240,240,921
2009,34580,2851,3112,36938,38644,269,8.5,367,11.6,3542,1009,2533,2.6,9.2,6953,1797,5156,4.7,18,-3411,-8.8,18.4,0,256,256,1361
2010,34580,2776,3056,37431,37108,262,8.5,290,9.4,5072,1772,3300,4.8,13.7,4425,936,3489,2.5,11.9,647,1.8,23.8,0,200,200,646
2011,34580,2676,2952,35730,36417,251,8.4,332,11.1,3860,1151,2709,3.2,10.6,5233,1939,3294,5.3,14.4,-1373,-3.8,21.2,0,229,229,1026
2012,34580,2653,2921,36250,35960,274,9.4,305,10.4,4835,1405,3430,3.9,13.4,4255,1325,2930,3.7,11.8,580,1.6,23.6,0,175,175,711
2013,34580,2680,2940,37004,36572,259,8.9,243,8.3,4986,1175,3811,3.2,13.6,4122,1004,3118,2.7,11.3,864,2.3,22.6,0,144,144,742
2014,34580,2694,2949,37056,36601,271,9.2,241,8.2,4921,1094,3827,3,13.4,4011,1183,2828,3.2,11,910,2.4,22,0,160,160,722
1977,34620,2058,2278,38462,37730,341,15.3,248,11.1,6841,2629,4212,7,18.1,5377,1814,3563,4.8,14.3,1464,3.8,28.6,0,164,164,1209
1978,34620,2045,2265,38268,38357,267,11.8,278,12.2,6394,1854,4540,4.8,16.7,6572,2801,3771,7.3,17.1,-178,-0.4,33.4,0,187,187,1956
1979,34620,2044,2280,41184,39721,268,11.8,249,11,6952,1693,5259,4.3,17.5,4026,1457,2569,3.7,10.1,2926,7.4,20.2,0,191,191,990
1980,34620,2034,2270,41416,41264,246,10.8,240,10.6,5590,2781,2809,6.7,13.5,5285,1277,4008,3.1,12.8,305,0.7,25.6,0,171,172,661
1981,34620,1974,2199,38061,39289,245,11,294,13.2,4609,2126,2483,5.4,11.7,7064,1720,5344,4.4,18,-2455,-6.3,23.4,0,170,171,980
1982,34620,1946,2197,35095,36572,241,11,229,10.4,4618,1905,2713,5.2,12.6,7572,2249,5323,6.1,20.7,-2954,-8.1,25.2,0,135,137,1336
1983,34620,1844,2098,33682,34310,235,10.9,311,14.5,4422,1805,2617,5.3,12.9,5677,2242,3435,6.5,16.5,-1255,-3.6,25.8,0,169,169,1130
1984,34620,1982,2235,38377,36313,245,11.3,152,7,7595,1845,5750,5.1,20.9,3467,982,2485,2.7,9.5,4128,11.4,19,0,4,4,6
1985,34620,2034,2290,38565,38840,281,12.4,240,10.6,5712,2424,3288,6.2,14.7,6262,1965,4297,5.1,16.1,-550,-1.4,29.4,0,153,154,985
1986,34620,2051,2312,38976,38715,263,11.4,236,10.3,5596,2202,3394,5.7,14.5,5073,1684,3389,4.3,13.1,523,1.4,26.2,0,151,151,936
1987,34620,2083,2356,40335,39652,283,12.1,234,10,6499,2162,4337,5.5,16.4,5133,2435,2698,6.1,12.9,1366,3.5,25.8,0,148,148,1371
1988,34620,2046,2292,40279,39857,217,9.4,270,11.6,6660,2344,4316,5.9,16.7,5815,2485,3330,6.2,14.6,845,2.1,29.2,0,175,175,901
1989,34620,2054,2323,42524,41441,233,10.1,206,8.9,6888,2343,4545,5.7,16.6,4721,1847,2874,4.5,11.4,2167,5.2,22.8,0,136,136,1054
1990,34620,2037,2315,44118,43289,194,8.4,190,8.2,6342,2043,4299,4.7,14.7,4684,1096,3588,2.5,10.8,1658,3.9,21.6,0,126,126,671
1991,34620,2107,2417,44168,44079,280,11.8,179,7.6,6354,2756,3598,6.3,14.4,6175,1732,4443,3.9,14,179,0.4,28,0,104,104,910
1992,34620,2098,2425,45519,44849,231,9.5,221,9.1,8134,2028,6106,4.5,18.1,6794,3648,3146,8.1,15.1,1340,3,30.2,0,160,161,1903
1993,34620,2111,2433,50958,48233,200,8.2,189,7.8,11163,1481,9682,3.1,23.1,5712,1745,3967,3.6,11.8,5451,11.3,23.6,0,130,130,1004
1994,34620,2133,2461,48036,49490,238,9.7,206,8.4,7698,2479,5219,5,15.6,10605,1724,8881,3.5,21.4,-2907,-5.8,31.2,0,133,133,862
1995,34620,2168,2525,49743,48851,286,11.5,207,8.3,6732,2509,4223,5.1,13.8,4948,1584,3364,3.2,10.1,1784,3.7,20.2,0,158,158,978
1996,34620,2154,2505,49966,49917,228,9.1,245,9.7,9308,4469,4839,9,18.6,9210,2521,6689,5.1,18.5,98,0.1,37,0,164,164,806
1997,34620,2159,2524,49172,49624,288,11.4,280,11.1,8428,3310,5118,6.7,17,9332,4740,4592,9.6,18.8,-904,-1.8,34,0,157,157,3232
1998,34620,2155,2523,49259,49222,256,10.1,241,9.6,6996,2394,4602,4.9,14.2,6921,1997,4924,4.1,14.1,75,0.1,28.2,0,157,157,1205
1999,34620,2162,2525,48648,48998,225,8.9,228,9,6913,2419,4494,4.9,14.1,7613,2917,4696,6,15.5,-700,-1.4,28.2,0,138,138,1239
2000,34620,2132,2503,50947,49754,224,8.9,249,9.9,7385,2381,5004,4.8,14.8,4998,1754,3244,3.5,10,2387,4.8,20,0,148,148,943
2001,34620,2086,2448,49219,50192,186,7.5,259,10.4,5378,1429,3949,2.8,10.7,7324,2761,4563,5.5,14.6,-1946,-3.9,21.4,0,135,135,1092
2002,34620,2060,2408,45470,47333,257,10.6,299,12.3,6879,2994,3885,6.3,14.5,10605,5206,5399,11,22.4,-3726,-7.9,29,0,136,136,1080
2003,34620,2046,2394,44359,44529,213,8.9,176,7.4,6498,2228,4270,5,14.6,6838,2097,4741,4.7,15.4,-340,-0.8,29.2,0,120,122,1458
2004,34620,2055,2405,44456,44286,216,9,177,7.4,6021,1949,4072,4.4,13.6,5681,1654,4027,3.7,12.8,340,0.8,25.6,0,119,119,766
2005,34620,2052,2403,42784,43388,191,8,177,7.4,4534,1453,3081,3.3,10.4,5741,1517,4224,3.5,13.2,-1207,-2.8,20.8,0,113,113,747
2006,34620,2039,2405,45242,43938,210,8.8,193,8.1,7998,3532,4466,8,18.2,5389,1386,4003,3.2,12.3,2609,5.9,24.6,0,120,121,671
2007,34620,2032,2398,42300,43459,184,7.7,174,7.3,6096,2476,3620,5.7,14,8414,1631,6783,3.8,19.4,-2318,-5.4,28,0,101,101,931
2008,34620,1991,2356,39950,41103,156,6.6,181,7.6,3892,1176,2716,2.9,9.5,6197,1538,4659,3.7,15.1,-2305,-5.6,19,0,140,140,1192
2009,34620,1919,2274,38827,39275,135,5.9,193,8.4,4853,1551,3302,3.9,12.4,5749,1557,4192,4,14.6,-896,-2.2,24.8,0,126,126,957
2010,34620,1887,2233,35550,36796,137,6.1,159,7.1,3172,782,2390,2.1,8.6,5664,1488,4176,4,15.4,-2492,-6.8,17.2,0,102,102,1112
2011,34620,1852,2198,36118,35761,152,6.9,168,7.6,5159,2243,2916,6.3,14.4,4445,1032,3413,2.9,12.4,714,2,24.8,0,103,103,534
2012,34620,1849,2207,37052,36547,179,8.1,163,7.4,5896,1524,4372,4.2,16.1,4885,1472,3413,4,13.4,1011,2.7,26.8,0,85,87,627
2013,34620,1824,2164,38091,37546,125,5.7,169,7.8,4898,1278,3620,3.4,13,3808,1306,2502,3.5,10.1,1090,2.9,20.2,0,100,101,796
2014,34620,1812,2144,39427,38655,152,7.1,146,6.8,4698,1028,3670,2.7,12.2,3154,805,2349,2.1,8.2,1544,4,16.4,0,96,96,464
1977,34740,2259,2455,46481,45679,373,15.5,276,11.5,6641,2953,3688,6.5,14.5,5037,1688,3349,3.7,11,1604,3.5,22,0,175,175,1074
1978,34740,2311,2494,49580,47986,297,12,252,10.2,7771,1887,5884,3.9,16.2,4583,2068,2515,4.3,9.6,3188,6.6,19.2,0,159,159,925
1979,34740,2296,2506,51724,50639,267,10.7,244,9.8,7767,2499,5268,4.9,15.3,5598,1465,4133,2.9,11.1,2169,4.2,22.2,0,176,176,834
1980,34740,2316,2534,49850,50769,284,11.3,250,9.9,5467,2633,2834,5.2,10.8,7306,1785,5521,3.5,14.4,-1839,-3.6,21.6,0,187,187,1197
1981,34740,2229,2432,47849,48543,250,10.1,327,13.2,7102,2418,4684,5,14.6,8490,2588,5902,5.3,17.5,-1388,-2.9,29.2,0,184,184,857
1982,34740,2214,2449,46441,47364,310,12.7,271,11.1,4810,2050,2760,4.3,10.2,6655,2115,4540,4.5,14.1,-1845,-3.9,20.4,0,149,149,713
1983,34740,2282,2516,40751,43674,278,11.2,246,9.9,4300,1817,2483,4.2,9.8,10145,2237,7908,5.1,23.2,-5845,-13.4,19.6,0,161,161,987
1984,34740,2395,2631,45335,43047,336,13.1,224,8.7,8608,2169,6439,5,20,4032,1564,2468,3.6,9.4,4576,10.6,18.8,0,156,157,812
1985,34740,2433,2682,45661,45478,301,11.3,239,9,6158,2000,4158,4.4,13.5,5792,2609,3183,5.7,12.7,366,0.8,25.4,0,161,161,1100
1986,34740,2504,2754,49619,47631,326,12,245,9,9023,3724,5299,7.8,18.9,5047,1996,3051,4.2,10.6,3976,8.3,21.2,0,159,159,1044
1987,34740,2527,2784,48280,48816,324,11.7,282,10.2,7088,2383,4705,4.9,14.5,8159,2866,5293,5.9,16.7,-1071,-2.2,29,0,185,186,1073
1988,34740,2567,2822,48957,48727,317,11.3,278,9.9,8028,3190,4838,6.5,16.5,7568,2085,5483,4.3,15.5,460,1,31,0,177,177,922
1989,34740,2582,2828,50615,49761,292,10.3,286,10.1,7747,2101,5646,4.2,15.6,6039,2251,3788,4.5,12.1,1708,3.5,24.2,0,197,197,1299
1990,34740,2629,2889,51332,50944,311,10.9,230,8,6930,2705,4225,5.3,13.6,6154,1563,4591,3.1,12.1,776,1.5,24.2,0,158,158,962
1991,34740,2673,2955,48037,49571,321,11,248,8.5,6858,3559,3299,7.2,13.8,9925,3120,6805,6.3,20,-3067,-6.2,27.6,0,159,160,1172
1992,34740,2668,2972,47134,47567,264,8.9,246,8.3,5646,1877,3769,3.9,11.9,6512,1995,4517,4.2,13.7,-866,-1.8,23.8,0,165,166,1401
1993,34740,2666,2965,46454,46778,231,7.8,229,7.7,5020,1017,4003,2.2,10.7,5668,1803,3865,3.9,12.1,-648,-1.4,21.4,0,156,156,921
1994,34740,2685,2985,48543,47436,278,9.3,238,8,7425,2343,5082,4.9,15.7,5210,1719,3491,3.6,11,2215,4.7,22,0,161,161,1027
1995,34740,2759,3078,52273,50359,330,10.9,220,7.3,9215,3589,5626,7.1,18.3,5386,1857,3529,3.7,10.7,3829,7.6,21.4,0,152,153,960
1996,34740,2814,3139,52715,52606,311,10,257,8.3,7761,3111,4650,5.9,14.8,7542,2519,5023,4.8,14.3,219,0.5,28.6,0,168,168,1618
1997,34740,2876,3216,53770,53257,360,11.3,269,8.5,8348,3685,4663,6.9,15.7,7322,1761,5561,3.3,13.7,1026,2,27.4,0,182,182,1167
1998,34740,2832,3178,55424,54578,279,8.7,308,9.6,8263,1756,6507,3.2,15.1,6570,3487,3083,6.4,12,1693,3.1,24,0,194,194,1131
1999,34740,2803,3161,56634,55989,274,8.6,289,9.1,8662,3863,4799,6.9,15.5,7372,2923,4449,5.2,13.2,1290,2.3,26.4,0,189,189,2270
2000,34740,2784,3121,56760,55913,298,9.5,332,10.6,8274,3065,5209,5.5,14.8,6579,2712,3867,4.9,11.8,1695,3,23.6,0,187,187,1134
2001,34740,2790,3131,56267,56596,305,9.7,321,10.3,7253,3127,4126,5.5,12.8,7910,2421,5489,4.3,14,-657,-1.2,25.6,0,177,177,1272
2002,34740,2821,3191,55525,55722,421,13.3,356,11.3,9465,5352,4113,9.6,17,9859,3256,6603,5.8,17.7,-394,-0.7,34,0,187,187,1047
2003,34740,2807,3188,54139,54509,327,10.3,277,8.7,7252,2394,4858,4.4,13.3,7991,2468,5523,4.5,14.7,-739,-1.4,26.6,0,175,175,1450
2004,34740,2835,3235,55531,54696,298,9.3,224,7,7744,3107,4637,5.7,14.2,6074,1837,4237,3.4,11.1,1670,3.1,22.2,0,143,143,1047
2005,34740,2811,3227,54143,54703,291,9,283,8.8,6558,2416,4142,4.4,12,7678,2562,5116,4.7,14,-1120,-2,24,0,202,202,1814
2006,34740,2766,3200,54237,54043,291,9.1,292,9.1,6488,2257,4231,4.2,12,6099,1731,4368,3.2,11.3,389,0.7,22.6,0,201,201,1229
2007,34740,2715,3162,52786,53460,261,8.2,294,9.3,6175,2354,3821,4.4,11.6,7522,2094,5428,3.9,14.1,-1347,-2.5,23.2,0,189,189,1165
2008,34740,2677,3123,53036,52737,237,7.6,268,8.6,5932,1796,4136,3.4,11.2,5334,1441,3893,2.7,10.1,598,1.1,20.2,0,178,178,934
2009,34740,2576,3015,49937,51375,198,6.5,288,9.4,4813,1651,3162,3.2,9.4,7688,1262,6426,2.5,15,-2875,-5.6,18.8,0,197,197,857
2010,34740,2491,2923,48228,48909,180,6.1,261,8.8,4589,1057,3532,2.2,9.4,5951,1591,4360,3.3,12.2,-1362,-2.8,18.8,0,168,168,893
2011,34740,2456,2880,49075,48571,219,7.6,237,8.2,5040,1293,3747,2.7,10.4,4031,1396,2635,2.9,8.3,1009,2.1,16.6,0,141,141,830
2012,34740,2442,2854,51096,50278,217,7.6,243,8.5,7259,1404,5855,2.8,14.4,5622,2380,3242,4.7,11.2,1637,3.2,22.4,0,138,141,801
2013,34740,2417,2817,50887,50928,176,6.2,201,7.1,4470,1019,3451,2,8.8,4551,1287,3264,2.5,8.9,-81,-0.1,17.6,0,122,122,441
2014,34740,2397,2811,52012,51238,208,7.4,192,6.8,5314,1528,3786,3,10.4,3766,1369,2397,2.7,7.4,1548,3,14.8,0,128,128,1092
1977,34820,2192,2320,25565,24171,515,23.2,324,14.6,6519,2455,4064,10.2,27,3730,1549,2181,6.4,15.4,2789,11.6,30.8,0,216,216,824
1978,34820,2343,2476,29522,27544,497,20.7,343,14.3,7803,3138,4665,11.4,28.3,3847,1799,2048,6.5,14,3956,14.3,28,0,245,245,1260
1979,34820,2358,2515,29685,29581,443,17.8,383,15.4,6191,3313,2878,11.2,20.9,5982,2222,3760,7.5,20.2,209,0.7,40.4,0,273,273,1474
1980,34820,2397,2553,30459,30037,432,17,371,14.6,6305,2891,3414,9.6,21,5460,2250,3210,7.5,18.2,845,2.8,36.4,0,251,253,1438
1981,34820,2389,2542,31756,31059,410,16.1,405,15.9,6944,3010,3934,9.7,22.4,5550,2174,3376,7,17.9,1394,4.5,35.8,0,238,238,1357
1982,34820,2564,2766,35315,33532,564,21.2,325,12.2,8571,3808,4763,11.4,25.6,5004,1949,3055,5.8,14.9,3567,10.7,29.8,0,199,199,1308
1983,34820,2567,2767,34639,34908,466,16.8,433,15.7,7452,2729,4723,7.8,21.3,7989,2756,5233,7.9,22.9,-537,-1.6,42.6,0,250,252,1392
1984,34820,2977,3193,41396,38112,635,21.3,253,8.5,10698,4025,6673,10.6,28.1,4130,1282,2848,3.4,10.8,6568,17.3,21.6,1,6,6,
1985,34820,3247,3513,44902,43166,734,21.9,415,12.4,11540,5498,6042,12.7,26.7,8068,3166,4902,7.3,18.7,3472,8,37.4,0,298,299,2034
1986,34820,3374,3663,44813,44819,721,20.1,541,15.1,10320,5125,5195,11.4,23,10332,4623,5709,10.3,23.1,-12,-0.1,46,0,330,330,2495
1987,34820,3580,3935,46307,45514,856,22.5,555,14.6,11331,5753,5578,12.6,24.9,9745,4814,4931,10.6,21.4,1586,3.5,42.8,0,366,369,2677
1988,34820,3698,4109,49347,47646,778,19.3,581,14.4,12552,6624,5928,13.9,26.3,9149,4175,4974,8.8,19.2,3403,7.1,38.4,0,409,409,2071
1989,34820,3846,4303,52562,51110,703,16.7,512,12.2,11977,5759,6218,11.3,23.4,9073,3653,5420,7.1,17.8,2904,5.6,35.6,0,364,365,2400
1990,34820,3932,4417,54933,53642,690,15.8,546,12.5,12235,4707,7528,8.8,22.8,9653,3885,5768,7.2,18,2582,4.8,36,0,376,376,2259
1991,34820,4072,4611,54099,54447,756,16.8,547,12.1,11211,5688,5523,10.4,20.6,11907,4203,7704,7.7,21.9,-696,-1.3,41.2,0,368,372,2774
1992,34820,4126,4723,56391,55363,698,14.9,575,12.3,10853,4390,6463,7.9,19.6,8797,3069,5728,5.5,15.9,2056,3.7,31.8,0,404,404,1969
1993,34820,4325,4928,58266,57238,699,14.5,486,10.1,10627,4359,6268,7.6,18.6,8570,2824,5746,4.9,15,2057,3.6,30,0,333,334,1941
1994,34820,4443,5054,61567,59709,725,14.5,567,11.4,12890,5340,7550,8.9,21.6,9174,3558,5616,6,15.4,3716,6.2,30.8,0,405,406,2186
1995,34820,4675,5310,68009,64732,813,15.7,526,10.2,14839,6692,8147,10.3,22.9,8285,3197,5088,4.9,12.8,6554,10.1,25.6,0,355,357,2024
1996,34820,4930,5609,74326,71145,928,17,609,11.2,17415,8007,9408,11.3,24.5,11053,4526,6527,6.4,15.5,6362,9,31,0,431,431,2722
1997,34820,5094,5824,77258,75960,918,16,707,12.3,15806,6728,9078,8.9,20.8,13209,5634,7575,7.4,17.4,2597,3.4,34.8,0,459,459,2935
1998,34820,5273,6022,80424,78850,903,15.2,690,11.6,14971,5989,8982,7.6,19,11823,4283,7540,5.4,15,3148,4,30,0,482,482,2533
1999,34820,5411,6182,81894,81151,907,14.9,745,12.2,15529,7157,8372,8.8,19.1,14043,5407,8636,6.7,17.3,1486,1.8,34.6,0,485,485,2946
2000,34820,5488,6312,86123,84037,904,14.5,772,12.4,18145,8659,9486,10.3,21.6,13972,6302,7670,7.5,16.6,4173,5,33.2,0,509,509,3889
2001,34820,5434,6335,87949,87155,842,13.3,872,13.8,18181,9039,9142,10.4,20.9,16593,6403,10190,7.3,19,1588,1.9,38,0,520,520,2858
2002,34820,5541,6448,85146,86560,958,15,853,13.3,16208,7934,8274,9.2,18.7,19035,6931,12104,8,22,-2827,-3.3,37.4,0,471,471,3318
2003,34820,5618,6556,85761,84912,911,14.1,681,10.5,14834,5621,9213,6.6,17.5,13136,4828,8308,5.7,15.5,1698,2,31,0,477,479,2990
2004,34820,5881,6882,91673,88473,1025,15.3,629,9.4,18162,9450,8712,10.7,20.5,11761,4109,7652,4.6,13.3,6401,7.2,26.6,0,418,418,2534
2005,34820,6221,7284,97684,94487,1120,15.9,666,9.4,19931,9000,10931,9.5,21.1,13536,3844,9692,4.1,14.3,6395,6.8,28.6,0,484,484,2982
2006,34820,6431,7553,104451,100872,1092,14.8,764,10.3,20497,9044,11453,9,20.3,13338,5803,7535,5.8,13.2,7159,7.1,26.4,0,539,539,4201
2007,34820,6674,7879,106935,105164,1173,15.2,846,11,20992,8416,12576,8,20,17449,7068,10381,6.7,16.6,3543,3.4,33.2,0,586,598,4184
2008,34820,6522,7791,108383,107302,883,11.3,901,11.5,18469,6523,11946,6.1,17.2,16306,4274,12032,4,15.2,2163,2,30.4,0,688,688,3250
2009,34820,6066,7350,95364,101522,712,9.4,1053,14,11313,5387,5926,5.3,11.1,23628,6363,17265,6.3,23.3,-12315,-12.2,22.2,0,739,740,3989
2010,34820,5919,7164,90912,92738,748,10.3,887,12.3,11803,4731,7072,5.1,12.7,15455,4953,10502,5.3,16.7,-3652,-4,25.4,0,578,578,2977
2011,34820,5727,6989,91230,90810,715,10.1,828,11.7,12960,5338,7622,5.9,14.3,12120,4884,7236,5.4,13.3,840,1,26.6,0,560,561,3556
2012,34820,5858,7151,94034,92654,803,11.4,670,9.5,13832,5523,8309,6,14.9,11072,3712,7360,4,11.9,2760,3,23.8,0,425,427,2397
2013,34820,5935,7231,96767,95390,744,10.4,686,9.6,14134,5295,8839,5.6,14.8,11380,4480,6900,4.7,11.9,2754,2.9,23.8,0,431,434,2425
2014,34820,5984,7308,98450,97341,774,10.7,637,8.8,13331,5368,7963,5.5,13.7,11112,3911,7201,4,11.4,2219,2.3,22.8,0,465,465,2902
1977,34900,1731,1827,18339,17831,375,21.3,231,13.1,3950,1807,2143,10.1,22.2,2933,1417,1516,7.9,16.4,1017,5.8,32.8,0,162,162,980
1978,34900,1775,1869,21034,19685,316,17.1,274,14.8,5841,1692,4149,8.6,29.7,3142,1621,1521,8.2,16,2699,13.7,32,0,170,172,990
1979,34900,1862,1961,22277,21622,380,19.8,267,13.9,4647,1908,2739,8.8,21.5,3337,974,2363,4.5,15.4,1310,6.1,30.8,0,190,190,647
1980,34900,1951,2053,23493,22871,387,19.3,285,14.2,4986,2324,2662,10.2,21.8,3741,1369,2372,6,16.4,1245,5.4,32.8,0,202,202,939
1981,34900,1964,2058,24798,24133,327,15.9,300,14.6,4881,1741,3140,7.2,20.2,3551,1398,2153,5.8,14.7,1330,5.5,29.4,0,190,190,753
1982,34900,2014,2134,24364,24515,350,16.7,244,11.6,4265,2312,1953,9.4,17.4,4567,1682,2885,6.9,18.6,-302,-1.2,34.8,0,130,131,730
1983,34900,2058,2172,24631,24295,294,13.7,270,12.5,5015,2377,2638,9.8,20.6,4342,1356,2986,5.6,17.9,673,2.7,35.8,0,171,171,798
1984,34900,2170,2288,26509,25586,351,15.8,235,10.5,5576,2090,3486,8.2,21.8,3730,1403,2327,5.5,14.6,1846,7.2,29.2,0,139,140,637
1985,34900,2268,2385,27634,27027,323,13.8,219,9.4,4936,1728,3208,6.4,18.3,3722,965,2757,3.6,13.8,1214,4.5,27.6,0,146,147,553
1986,34900,2353,2475,29170,28281,372,15.3,261,10.7,5735,2031,3704,7.2,20.3,3956,1533,2423,5.4,14,1779,6.3,28,0,176,176,746
1987,34900,2491,2635,32548,32515,432,16.9,267,10.4,5429,2182,3247,6.7,16.7,5362,1844,3518,5.7,16.5,67,0.2,33,0,179,181,934
1988,34900,2558,2714,34659,33613,382,14.3,286,10.7,6868,2664,4204,7.9,20.4,4776,1703,3073,5.1,14.2,2092,6.2,28.4,0,191,191,1074
1989,34900,2477,2618,33830,34298,381,14.3,487,18.3,5437,2040,3397,5.9,15.9,6373,3306,3067,9.6,18.6,-936,-2.7,31.8,0,209,210,1093
1990,34900,2700,2852,37337,35558,527,19.3,272,9.9,7592,3709,3883,10.4,21.4,4034,1388,2646,3.9,11.3,3558,10.1,22.6,0,183,191,863
1991,34900,2781,2946,37561,37388,384,13.3,294,10.1,6135,2542,3593,6.8,16.4,5788,1677,4111,4.5,15.5,347,0.9,31,0,201,201,1036
1992,34900,2772,2949,37394,37388,383,13,347,11.8,6231,2450,3781,6.6,16.7,6219,2484,3735,6.6,16.6,12,0.1,33.2,0,222,223,1122
1993,34900,2719,2890,37670,37545,326,11.2,355,12.2,6779,2184,4595,5.8,18.1,6528,2476,4052,6.6,17.4,251,0.7,34.8,0,242,242,1202
1994,34900,2718,2886,37402,37483,335,11.6,313,10.8,5527,1891,3636,5,14.7,5689,1823,3866,4.9,15.2,-162,-0.5,29.4,0,214,214,1240
1995,34900,2731,2906,38917,38188,342,11.8,291,10,6131,2214,3917,5.8,16.1,4673,1322,3351,3.5,12.2,1458,3.9,24.4,0,207,207,948
1996,34900,2778,2959,41020,39924,372,12.7,293,10,6970,2145,4825,5.4,17.5,4778,1205,3573,3,12,2192,5.5,24,0,199,199,737
1997,34900,2868,3041,44496,42696,400,13.3,316,10.5,8958,3066,5892,7.2,21,5358,1892,3466,4.4,12.5,3600,8.5,25,0,187,187,1107
1998,34900,2908,3080,46556,45541,361,11.8,315,10.3,8133,2821,5312,6.2,17.9,6102,2552,3550,5.6,13.4,2031,4.5,26.8,0,216,216,1329
1999,34900,2986,3158,48916,47743,353,11.3,286,9.2,8216,2813,5403,5.9,17.2,5870,2588,3282,5.4,12.3,2346,4.9,24.6,0,187,187,1505
2000,34900,3081,3266,49287,49103,400,12.5,290,9,7594,3324,4270,6.8,15.5,7225,2074,5151,4.2,14.7,369,0.8,29.4,0,191,191,1386
2001,34900,3184,3390,52057,50925,401,12,339,10.1,8560,2646,5914,5.2,16.8,6296,2328,3968,4.6,12.4,2264,4.4,24.8,0,196,196,1205
2002,34900,3243,3459,52545,52161,470,13.8,384,11.2,8605,3337,5268,6.4,16.5,7837,2654,5183,5.1,15,768,1.5,30,0,225,225,1352
2003,34900,3289,3511,53374,52585,432,12.5,310,8.9,8144,3185,4959,6.1,15.5,6566,1798,4768,3.4,12.5,1578,3,25,0,209,209,1161
2004,34900,3286,3520,54395,53674,398,11.3,346,9.9,7485,2924,4561,5.4,13.9,6042,2053,3989,3.8,11.3,1443,2.6,22.6,0,228,228,1137
2005,34900,3334,3583,54695,54413,417,11.8,334,9.4,7584,2879,4705,5.3,13.9,7019,2347,4672,4.3,12.9,565,1,25.8,0,242,242,1443
2006,34900,3337,3608,55406,54972,417,11.6,366,10.2,8278,2958,5320,5.4,15.1,7409,2421,4988,4.4,13.5,869,1.6,27,0,269,269,1605
2007,34900,3397,3678,58578,56926,440,12.1,357,9.8,10534,3824,6710,6.7,18.5,7230,2375,4855,4.2,12.7,3304,5.8,25.4,0,234,234,1079
2008,34900,3406,3672,58916,58550,397,10.8,359,9.8,8456,2596,5860,4.4,14.4,7723,2800,4923,4.8,13.2,733,1.2,26.4,0,242,242,1687
2009,34900,3314,3584,53144,55847,327,9,378,10.4,4602,1961,2641,3.5,8.2,10007,2365,7642,4.2,17.9,-5405,-9.7,16.4,0,265,265,1786
2010,34900,3260,3539,52994,52959,316,8.9,340,9.6,6483,2222,4261,4.2,12.2,6412,2154,4258,4.1,12.1,71,0.1,24.2,0,233,234,1516
2011,34900,3190,3467,54388,53654,277,7.9,346,9.9,7113,2170,4943,4,13.3,5644,2020,3624,3.8,10.5,1469,2.8,21,0,232,232,1367
2012,34900,3244,3522,56710,55537,351,10,296,8.5,8178,2570,5608,4.6,14.7,5831,2055,3776,3.7,10.5,2347,4.2,21,0,178,179,1137
2013,34900,3293,3583,58633,57664,350,9.9,301,8.5,8145,2594,5551,4.5,14.1,6207,1746,4461,3,10.8,1938,3.3,21.6,0,200,200,1024
2014,34900,3341,3640,60285,59048,380,10.5,305,8.5,7222,2421,4801,4.1,12.2,4747,1891,2856,3.2,8,2475,4.2,16,0,229,230,1430
1977,34940,1957,2062,17833,16908,524,27.1,259,13.4,5393,3331,2062,19.7,31.9,3543,1487,2056,8.8,21,1850,10.9,42,0,190,191,1233
1978,34940,2124,2238,21038,19435,480,22.3,301,14,6698,2985,3713,15.4,34.5,3491,1962,1529,10.1,18,3207,16.5,36,0,225,225,1242
1979,34940,2280,2407,24174,22573,513,22.1,325,14,7458,3569,3889,15.8,33,4255,1847,2408,8.2,18.8,3203,14.2,37.6,0,262,264,1385
1980,34940,2465,2603,27533,25860,529,21.1,325,13,7358,3604,3754,13.9,28.5,4011,1755,2256,6.8,15.5,3347,13,31,0,256,256,1416
1981,34940,2564,2709,28515,27968,528,19.9,407,15.3,6833,3269,3564,11.7,24.4,5739,2359,3380,8.4,20.5,1094,3.9,41,0,268,269,1499
1982,34940,2785,2961,30044,29256,623,22,350,12.3,7806,4001,3805,13.7,26.7,6229,2193,4036,7.5,21.3,1577,5.4,42.6,0,235,235,1284
1983,34940,2831,3037,29673,29847,562,18.7,490,16.3,7308,3967,3341,13.3,24.5,7655,2891,4764,9.7,25.6,-347,-1.1,49,0,309,309,1447
1984,34940,3063,3278,34920,32264,682,21.6,433,13.7,10503,4909,5594,15.2,32.6,5190,2334,2856,7.2,16.1,5313,16.5,32.2,0,297,299,1300
1985,34940,3254,3499,38207,36545,652,19.2,425,12.5,9571,3549,6022,9.7,26.2,6247,2429,3818,6.6,17.1,3324,9.1,34.2,0,294,294,1655
1986,34940,3483,3745,41057,39590,732,20.2,457,12.6,10956,4878,6078,12.3,27.7,8021,2930,5091,7.4,20.3,2935,7.4,40.6,0,307,307,2127
1987,34940,3816,4114,45258,43169,870,22.1,483,12.3,12375,6316,6059,14.6,28.7,8197,3613,4584,8.4,19,4178,9.7,38,0,319,326,2478
1988,34940,4119,4446,50443,47708,856,20,516,12.1,13481,5258,8223,11,28.3,8010,3356,4654,7,16.8,5471,11.5,33.6,0,358,358,2048
1989,34940,4364,4712,55764,53253,825,18,560,12.2,13300,5617,7683,10.5,25,8277,3239,5038,6.1,15.5,5023,9.5,31,0,426,426,2565
1990,34940,4614,4974,59919,57790,846,17.5,555,11.5,13342,5736,7606,9.9,23.1,9084,3639,5445,6.3,15.7,4258,7.4,31.4,0,426,426,2895
1991,34940,4839,5235,60932,60416,910,17.8,641,12.6,12516,6080,6436,10.1,20.7,11484,4672,6812,7.7,19,1032,1.7,38,0,427,430,3176
1992,34940,4951,5393,59948,59602,939,17.7,724,13.6,13157,7093,6064,11.9,22.1,12464,4720,7744,7.9,20.9,693,1.2,41.8,0,534,535,3287
1993,34940,5152,5595,63276,61567,905,16.5,698,12.7,14257,6856,7401,11.1,23.2,10839,4427,6412,7.2,17.6,3418,5.6,35.2,0,524,525,2998
1994,34940,5272,5725,64587,63661,924,16.3,752,13.3,12596,4947,7649,7.8,19.8,10743,4915,5828,7.7,16.9,1853,2.9,33.8,0,566,566,3207
1995,34940,5478,5948,68884,66700,962,16.5,709,12.2,16047,8059,7988,12.1,24.1,11679,5117,6562,7.7,17.5,4368,6.6,35,0,494,497,3056
1996,34940,5713,6180,69928,69461,1001,16.5,745,12.3,12504,5657,6847,8.1,18,11569,5022,6547,7.2,16.7,935,1.3,33.4,0,543,543,3244
1997,34940,5947,6457,73900,71879,1078,17,789,12.5,15890,6082,9808,8.5,22.1,11847,5253,6594,7.3,16.5,4043,5.6,33,0,541,541,3294
1998,34940,6134,6665,78327,76097,1022,15.6,804,12.3,16169,7013,9156,9.2,21.2,11708,5346,6362,7,15.4,4461,5.8,30.8,0,568,568,3369
1999,34940,6319,6935,83505,80965,1101,16.2,808,11.9,16877,6950,9927,8.6,20.8,11796,5075,6721,6.3,14.6,5081,6.2,29.2,0,553,553,2888
2000,34940,6434,7051,90200,87884,1005,14.4,883,12.6,17827,7309,10518,8.3,20.3,13196,5169,8027,5.9,15,4631,5.3,30,0,572,572,2735
2001,34940,6729,7384,96738,93579,1135,15.7,860,11.9,19307,7711,11596,8.2,20.6,12988,6378,6610,6.8,13.9,6319,6.7,27.8,0,522,522,2559
2002,34940,6963,7662,94893,93953,1294,17.2,1003,13.3,18937,9066,9871,9.6,20.2,17056,6657,10399,7.1,18.2,1881,2,36.4,0,565,566,3018
2003,34940,7227,7969,98584,96108,1311,16.8,861,11,19265,7894,11371,8.2,20,14313,5282,9031,5.5,14.9,4952,5.1,29.8,0,609,609,3464
2004,34940,7504,8228,101309,99480,1276,15.8,926,11.5,18293,6568,11725,6.6,18.4,14635,6218,8417,6.3,14.7,3658,3.7,29.4,0,627,627,3190
2005,34940,7926,8723,136107,118582,1452,17.2,887,10.5,48787,9612,39175,8.1,41.1,13736,5236,8500,4.4,11.6,35051,29.5,23.2,0,655,655,3498
2006,34940,8221,9052,143497,139575,1459,16.4,1045,11.8,25006,9064,15942,6.5,17.9,17161,5596,11565,4,12.3,7845,5.6,24.6,0,715,715,3881
2007,34940,8228,9118,114037,128516,1362,15,1237,13.6,20353,9414,10939,7.3,15.8,49311,35208,14103,27.4,38.4,-28958,-22.6,31.6,0,874,877,4651
2008,34940,7935,8843,104534,109087,1097,12.3,1282,14.3,15222,7877,7345,7.2,14,24328,7092,17236,6.5,22.3,-9106,-8.3,28,0,988,991,5868
2009,34940,7516,8437,98499,100975,987,11.5,1254,14.6,15638,7146,8492,7.1,15.5,20589,6446,14143,6.4,20.4,-4951,-4.9,31,0,879,880,4694
2010,34940,7488,8366,97964,97661,1052,12.6,1043,12.5,15963,8411,7552,8.6,16.3,15357,4713,10644,4.8,15.7,606,0.6,31.4,0,696,696,2917
2011,34940,7555,8477,99526,98541,1080,12.8,939,11.2,16064,6598,9466,6.7,16.3,14094,4573,9521,4.6,14.3,1970,2,28.6,0,629,629,2668
2012,34940,7863,8800,103689,101587,1154,13.4,878,10.2,15431,6590,8841,6.5,15.2,11226,4980,6246,4.9,11.1,4205,4.1,22.2,0,563,567,3094
2013,34940,8101,9040,108389,106832,1090,12.3,873,9.8,14934,5951,8983,5.6,14,11820,4581,7239,4.3,11.1,3114,2.9,22.2,0,584,587,3541
2014,34940,8393,9360,113285,110704,1236,13.5,879,9.6,17120,6637,10483,6,15.5,11958,5140,6818,4.6,10.8,5162,4.7,21.6,0,608,608,3471
1977,34980,14435,16779,293967,285763,3077,18.9,2094,12.8,59241,25571,33670,8.9,20.7,42832,16281,26551,5.7,15,16409,5.7,30,0,1430,1433,8581
1978,34980,14921,17288,319858,308244,2748,16.1,2235,13.1,69734,21049,48685,6.8,22.6,46506,21557,24949,7,15.1,23228,7.5,30.2,0,1555,1558,9807
1979,34980,15121,17656,337314,328335,2756,15.8,2260,12.9,65209,22709,42500,6.9,19.9,47253,15381,31872,4.7,14.4,17956,5.5,28.8,0,1625,1627,9259
1980,34980,15419,18053,335117,336048,2609,14.6,2137,12,56011,20339,35672,6.1,16.7,57873,17815,40058,5.3,17.2,-1862,-0.5,33.4,0,1517,1521,9397
1981,34980,15001,17633,334558,332444,2398,13.5,2558,14.4,59063,22461,36602,6.8,17.8,54834,20135,34699,6.1,16.5,4229,1.3,33,0,1642,1649,9717
1982,34980,15175,18087,332246,333154,2869,16.1,2208,12.4,57448,26662,30786,8,17.2,59263,16968,42295,5.1,17.8,-1815,-0.6,34.4,0,1261,1265,8781
1983,34980,15918,18851,347864,336617,2654,14.4,2042,11.1,75585,27940,47645,8.3,22.5,53090,16357,36733,4.9,15.8,22495,6.7,31.6,0,1341,1352,8185
1984,34980,16779,19750,368802,359484,3096,16,2226,11.5,77446,30033,47413,8.4,21.5,58810,19632,39178,5.5,16.4,18636,5.1,32.8,0,1431,1440,8540
1985,34980,17708,20784,393796,383111,3126,15.4,2141,10.5,72477,26056,46421,6.8,18.9,51106,19370,31736,5.1,13.3,21371,5.6,26.6,0,1388,1391,7639
1986,34980,18417,21661,423059,407901,3396,16,2411,11.4,86681,32281,54400,7.9,21.3,56365,20715,35650,5.1,13.8,30316,7.5,27.6,0,1604,1604,11231
1987,34980,19248,22883,437986,432863,3973,17.8,2653,11.9,83887,33860,50027,7.8,19.4,73640,30192,43448,7,17,10247,2.4,34,0,1798,1802,14402
1988,34980,19659,23449,451111,441909,3469,15,2754,11.9,95815,45015,50800,10.2,21.7,77410,29639,47771,6.7,17.5,18405,4.2,35,0,1816,1816,12086
1989,34980,20103,24216,468746,460689,3501,14.7,2762,11.6,94393,36919,57474,8,20.5,78278,28514,49764,6.2,17,16115,3.5,34,0,1872,1906,16042
1990,34980,20320,24550,478001,472975,3278,13.4,2773,11.4,82271,30278,51993,6.4,17.4,72221,25416,46805,5.4,15.3,10050,2.1,30.6,0,1886,1892,11775
1991,34980,20635,25167,471496,474396,3460,13.9,2878,11.6,82224,38811,43413,8.2,17.3,88025,29022,59003,6.1,18.6,-5801,-1.3,34.6,0,1867,1874,14391
1992,34980,20969,25732,481280,476106,3508,13.8,2842,11.2,81512,30938,50574,6.5,17.1,71164,23945,47219,5,14.9,10348,2.2,29.8,0,1833,1852,13340
1993,34980,21722,26399,501430,491438,3406,13.1,2697,10.3,83437,26647,56790,5.4,17,63452,23504,39948,4.8,12.9,19985,4.1,25.8,0,1732,1752,11456
1994,34980,22483,27335,526986,513620,3643,13.6,2621,9.8,87964,33852,54112,6.6,17.1,61231,21132,40099,4.1,11.9,26733,5.2,23.8,0,1749,1755,11998
1995,34980,23406,28387,569118,548063,3820,13.7,2698,9.7,104436,38308,66128,7,19.1,62325,22321,40004,4.1,11.4,42111,7.7,22.8,0,1773,1779,10553
1996,34980,24014,29173,580481,574726,3870,13.5,3050,10.6,87826,32181,55645,5.6,15.3,76316,27133,49183,4.7,13.3,11510,2,26.6,0,2043,2043,13737
1997,34980,24499,30092,599269,590536,4207,14.2,3337,11.2,112251,45069,67182,7.6,19,94784,34381,60403,5.8,16.1,17467,2.9,32.2,0,2118,2118,15530
1998,34980,24732,30578,619011,608525,3967,13.1,3378,11.1,109645,47591,62054,7.8,18,88673,32019,56654,5.3,14.6,20972,3.4,29.2,0,2183,2183,15608
1999,34980,24747,30829,620932,620086,3835,12.5,3527,11.5,104677,41861,62816,6.8,16.9,102985,42267,60718,6.8,16.6,1692,0.3,33.2,0,2205,2205,13649
2000,34980,24661,30940,643357,631837,3817,12.4,3708,12,120928,49039,71889,7.8,19.1,97887,40296,57591,6.4,15.5,23041,3.6,31,0,2136,2136,14435
2001,34980,24647,31126,647898,646883,3730,12,3813,12.3,107814,41356,66458,6.4,16.7,105784,36200,69584,5.6,16.4,2030,0.3,32.8,0,2197,2200,14042
2002,34980,24792,31315,641900,644232,4154,13.3,3917,12.6,110712,47056,63656,7.3,17.2,115377,38419,76958,6,17.9,-4665,-0.7,34.4,0,2045,2049,12246
2003,34980,25093,31750,648969,639352,3977,12.7,2947,9.4,109970,40481,69489,6.3,17.2,90736,28005,62731,4.4,14.2,19234,3,28.4,0,2003,2003,13814
2004,34980,25619,32297,662869,653523,3907,12.2,2992,9.4,102875,38825,64050,5.9,15.7,84183,27454,56729,4.2,12.9,18692,2.8,25.8,0,1919,1925,14294
2005,34980,26149,33082,670093,664916,4155,12.7,3039,9.3,107683,38378,69305,5.8,16.2,97331,29460,67871,4.4,14.6,10352,1.6,29.2,0,2078,2085,16367
2006,34980,26749,33922,713984,690006,4433,13.3,3240,9.7,125496,49837,75659,7.2,18.2,77541,26016,51525,3.8,11.2,47955,7,22.4,0,2071,2071,12660
2007,34980,27401,35040,723474,717422,4502,13.1,3340,9.7,123017,45372,77645,6.3,17.1,110913,34854,76059,4.9,15.5,12104,1.6,31,0,2104,2121,14562
2008,34980,27501,35550,729091,723156,4134,11.8,3277,9.3,118056,42480,75576,5.9,16.3,106186,26854,79332,3.7,14.7,11870,1.6,29.4,0,2350,2350,16309
2009,34980,26670,34774,672859,698331,3430,9.8,3817,10.9,80342,30404,49938,4.4,11.5,131285,34764,96521,5,18.8,-50943,-7.3,23,0,2622,2634,17149
2010,34980,26302,34330,658028,663244,3225,9.4,3368,9.8,83559,32328,51231,4.9,12.6,93992,27813,66179,4.2,14.2,-10433,-1.6,25.2,0,2239,2246,15096
2011,34980,26015,34006,668325,661127,3332,9.8,3267,9.6,89999,26244,63755,4,13.6,75603,26751,48852,4,11.4,14396,2.2,22.8,0,2215,2225,12607
2012,34980,26300,34431,688530,678281,3572,10.5,3165,9.3,96575,31757,64818,4.7,14.2,76076,24423,51653,3.6,11.2,20499,3,22.4,0,1955,1968,12466
2013,34980,26757,35009,725227,705698,3609,10.4,3000,8.7,117442,36766,80676,5.2,16.6,78383,23651,54732,3.4,11.1,39059,5.5,22.2,0,1909,1917,13648
2014,34980,27073,35482,747740,734211,3767,10.7,3020,8.6,109332,37244,72088,5.1,14.9,82273,23661,58612,3.2,11.2,27059,3.7,22.4,0,2055,2055,12490
1977,35300,13536,14949,271232,258114,2147,14.6,1626,11,53262,19714,33548,7.6,20.6,27025,11177,15848,4.3,10.5,26237,10.1,21,0,1042,1044,5311
1978,35300,13870,15311,272180,271686,1903,12.6,1545,10.2,46483,12874,33609,4.7,17.1,45494,22661,22833,8.3,16.7,989,0.4,33.4,0,1075,1079,16509
1979,35300,14228,15720,286707,279294,1863,12,1380,8.9,46359,15885,30474,5.7,16.6,31532,11632,19900,4.2,11.3,14827,5.3,22.6,0,953,954,6504
1980,35300,14349,15884,288968,287136,1797,11.4,1580,10,41488,14403,27085,5,14.4,37823,13213,24610,4.6,13.2,3665,1.2,26.4,0,1102,1111,6428
1981,35300,14030,15473,278174,281629,1726,11,2012,12.8,35028,14588,20440,5.2,12.4,41937,16262,25675,5.8,14.9,-6909,-2.5,24.8,0,1177,1177,5858
1982,35300,14234,15865,275492,276773,2113,13.5,1547,9.9,36829,18269,18560,6.6,13.3,39390,13103,26287,4.7,14.2,-2561,-0.9,26.6,0,911,914,5345
1983,35300,14715,16355,272834,274247,1780,11,1455,9,35221,12875,22346,4.7,12.8,38046,11880,26166,4.3,13.9,-2825,-1.1,25.6,0,960,962,4750
1984,35300,15128,16820,295290,283797,1985,12,1542,9.3,55432,18003,37429,6.3,19.5,32445,12420,20025,4.4,11.4,22987,8.1,22.8,0,1053,1056,6059
1985,35300,15519,17246,304590,300853,2055,12.1,1633,9.6,47100,16327,30773,5.4,15.7,39626,16516,23110,5.5,13.2,7474,2.5,26.4,0,1110,1111,7976
1986,35300,16184,17935,318274,311345,2366,13.5,1625,9.2,54221,23884,30337,7.7,17.4,40362,12516,27846,4,13,13859,4.4,26,0,1096,1098,6868
1987,35300,16856,18750,330803,325844,2730,14.9,1866,10.2,56118,19246,36872,5.9,17.2,46199,18130,28069,5.6,14.2,9919,3,28.4,0,1278,1285,9254
1988,35300,17254,19242,334222,330640,2546,13.4,1958,10.3,58130,20823,37307,6.3,17.6,50966,18221,32745,5.5,15.4,7164,2.2,30.8,0,1339,1339,7387
1989,35300,17412,19467,333283,334079,2322,12,2122,11,49853,19416,30437,5.8,14.9,51444,16382,35062,4.9,15.4,-1591,-0.5,29.8,0,1476,1488,8846
1990,35300,17252,19383,327607,330658,2076,10.7,2027,10.4,41923,15707,26216,4.8,12.7,48024,14194,33830,4.3,14.5,-6101,-1.8,25.4,0,1446,1449,7742
1991,35300,16888,19096,316721,321771,1903,9.9,2180,11.3,46446,17815,28631,5.5,14.4,56545,16407,40138,5.1,17.6,-10099,-3.2,28.8,0,1412,1413,8612
1992,35300,16441,18692,309416,312927,1913,10.1,2193,11.6,43652,15462,28190,4.9,13.9,50673,18179,32494,5.8,16.2,-7021,-2.3,27.8,0,1428,1439,9182
1993,35300,16451,18637,308317,308831,1756,9.4,1771,9.5,44116,14993,29123,4.9,14.3,45143,14119,31024,4.6,14.6,-1027,-0.3,28.6,0,1165,1174,6144
1994,35300,16438,18665,304670,305179,1810,9.7,1732,9.3,39202,13508,25694,4.4,12.8,40220,13143,27077,4.3,13.2,-1018,-0.4,25.6,0,1153,1159,5990
1995,35300,16554,18803,312707,308583,1918,10.2,1727,9.2,49019,21307,27712,6.9,15.9,40770,13293,27477,4.3,13.2,8249,2.7,26.4,0,1170,1176,6397
1996,35300,16587,18818,316009,314603,1767,9.4,1741,9.3,43972,16699,27273,5.3,14,41160,14059,27101,4.5,13.1,2812,0.9,26.2,0,1140,1140,6900
1997,35300,16527,18826,324332,320274,1983,10.5,1963,10.4,51402,16575,34827,5.2,16,43285,18568,24717,5.8,13.5,8117,2.5,27,0,1229,1229,8068
1998,35300,16444,18758,332353,328252,1804,9.6,1840,9.8,50695,20874,29821,6.4,15.4,42492,15634,26858,4.8,12.9,8203,2.5,25.8,0,1230,1230,7794
1999,35300,16310,18723,337822,335256,1754,9.4,1766,9.4,50642,18445,32197,5.5,15.1,45510,16164,29346,4.8,13.6,5132,1.5,27.2,0,1153,1153,6705
2000,35300,16303,18691,336971,337653,1707,9.1,1763,9.4,46837,16180,30657,4.8,13.9,48201,17597,30604,5.2,14.3,-1364,-0.4,27.8,0,1100,1100,6372
2001,35300,16228,18712,334334,336160,1700,9.1,1812,9.7,43402,14917,28485,4.4,12.9,47054,13162,33892,3.9,14,-3652,-1.1,25.8,0,1098,1098,6055
2002,35300,16196,18817,332321,332927,2016,10.7,1893,10.1,52526,21799,30727,6.5,15.8,53737,16624,37113,5,16.1,-1211,-0.3,31.6,0,1025,1025,5956
2003,35300,16046,18651,336937,333183,1647,8.8,1575,8.4,46076,11740,34336,3.5,13.8,38568,9731,28837,2.9,11.6,7508,2.2,23.2,0,1070,1072,5466
2004,35300,16131,18713,332393,333881,1716,9.2,1517,8.1,38908,11526,27382,3.5,11.7,41883,16226,25657,4.9,12.5,-2975,-0.8,23.4,0,997,999,5040
2005,35300,16293,18913,335206,332880,1864,9.9,1532,8.2,42117,16916,25201,5.1,12.7,37464,11520,25944,3.5,11.3,4653,1.4,22.6,0,1040,1041,7544
2006,35300,16119,18864,338523,336355,1862,9.9,1790,9.5,41873,15714,26159,4.7,12.4,37537,14584,22953,4.3,11.2,4336,1.2,22.4,0,1239,1239,7371
2007,35300,16069,18898,338959,338243,1805,9.6,1757,9.3,46710,15809,30901,4.7,13.8,45278,13592,31686,4,13.4,1432,0.4,26.8,0,1168,1178,8302
2008,35300,15900,18798,335759,336299,1573,8.4,1556,8.3,42496,14225,28271,4.2,12.6,43576,12366,31210,3.7,13,-1080,-0.4,25.2,0,1128,1128,6306
2009,35300,15396,18200,321119,327581,1276,6.9,1739,9.4,31174,9711,21463,3,9.5,44098,12759,31339,3.9,13.5,-12924,-4,19,0,1160,1166,6851
2010,35300,15086,17891,318219,318811,1321,7.3,1507,8.4,34235,12714,21521,4,10.7,35419,11001,24418,3.5,11.1,-1184,-0.4,21.4,0,1025,1025,6280
2011,35300,14816,17584,322996,320307,1290,7.3,1471,8.3,35529,8779,26750,2.7,11.1,30151,9755,20396,3,9.4,5378,1.7,18.8,0,972,974,5266
2012,35300,14869,17670,325669,323992,1498,8.5,1413,8,38582,9645,28937,3,11.9,35227,10726,24501,3.3,10.9,3355,1,21.8,0,887,890,5220
2013,35300,14870,17659,332301,328389,1351,7.7,1371,7.8,38051,12015,26036,3.7,11.6,30226,9987,20239,3,9.2,7825,2.4,18.4,0,841,844,5871
2014,35300,14895,17692,336215,333153,1483,8.4,1329,7.5,38444,8412,30032,2.5,11.5,32319,10542,21777,3.2,9.7,6125,1.8,19.4,0,901,902,5247
1977,35380,18866,22050,388399,378994,3633,16.9,2472,11.5,81017,35879,45138,9.5,21.4,62207,22945,39262,6.1,16.4,18810,5,32.8,0,1689,1707,13138
1978,35380,18093,21366,418727,402470,2830,13,3279,15.1,94602,25649,68953,6.4,23.5,62088,28075,34013,7,15.4,32514,8.1,30.8,0,1913,1926,12733
1979,35380,19699,23129,457588,438927,3335,15,1724,7.7,98694,31832,66862,7.3,22.5,61372,19352,42020,4.4,14,37322,8.5,28,0,33,36,952
1980,35380,19983,23492,470736,463990,3158,13.6,2702,11.6,91994,25430,66564,5.5,19.8,78501,24092,54409,5.2,16.9,13493,2.9,33.8,0,1914,1928,12001
1981,35380,19861,23306,472550,470923,3177,13.6,3212,13.7,91857,35011,56846,7.4,19.5,88602,29493,59109,6.3,18.8,3255,0.7,37.6,0,1942,1945,11800
1982,35380,20677,24656,484796,477914,4105,17.1,2607,10.9,99789,40367,59422,8.4,20.9,86025,28227,57798,5.9,18,13764,2.9,36,0,1428,1435,13545
1983,35380,21368,25220,455279,469889,3263,13.1,2816,11.3,81535,32034,49501,6.8,17.4,110754,33514,77240,7.1,23.6,-29219,-6.2,34.8,0,1829,1831,14143
1984,35380,21703,25777,459977,458039,3515,13.8,2979,11.7,83432,32257,51175,7,18.2,79555,27691,51864,6,17.4,3877,0.8,34.8,0,1910,1921,11726
1985,35380,21893,26059,457622,458925,3535,13.6,3215,12.4,81465,32032,49433,7,17.8,84070,29497,54573,6.4,18.3,-2605,-0.5,35.6,0,2040,2047,13851
1986,35380,21822,26154,458981,457907,3643,14,3432,13.1,86413,36737,49676,8,18.9,84264,30005,54259,6.6,18.4,2149,0.5,36.8,0,2275,2275,14772
1987,35380,21276,25715,437751,449813,3512,13.5,3805,14.7,73072,32498,40574,7.2,16.2,97197,34979,62218,7.8,21.6,-24125,-5.4,32.4,0,2375,2397,16021
1988,35380,20845,25370,436335,433595,3115,12.2,3381,13.2,79209,30868,48341,7.1,18.3,73729,28575,45154,6.6,17,5480,1.3,34,0,2231,2231,13006
1989,35380,20621,25200,447687,441461,2822,11.2,3033,12,82241,29333,52908,6.6,18.6,69788,24455,45333,5.5,15.8,12453,2.8,31.6,0,1942,1951,13919
1990,35380,20669,25255,457923,452386,2906,11.5,2731,10.8,79862,28948,50914,6.4,17.7,68787,27011,41776,6,15.2,11075,2.5,30.4,0,1785,1804,14348
1991,35380,21091,25892,458701,458739,3185,12.5,2607,10.2,77575,29247,48328,6.4,16.9,77651,29753,47898,6.5,16.9,-76,0,33.8,0,1630,1634,14429
1992,35380,21383,26249,462261,460383,3287,12.6,2835,10.9,82917,31586,51331,6.9,18,79161,30063,49098,6.5,17.2,3756,0.8,34.4,0,1715,1764,15198
1993,35380,21803,26523,466763,464173,2856,10.8,2558,9.7,80315,28585,51730,6.2,17.3,75136,26082,49054,5.6,16.2,5179,1.1,32.4,0,1640,1654,13394
1994,35380,22362,27126,472125,469237,3218,12,2564,9.6,76376,29105,47271,6.2,16.3,70600,22731,47869,4.8,15,5776,1.3,30,0,1644,1648,11579
1995,35380,22729,27503,483146,477213,3119,11.4,2622,9.6,82889,31140,51749,6.5,17.4,71022,28277,42745,5.9,14.9,11867,2.5,29.8,0,1642,1654,12585
1996,35380,23065,27847,494027,489298,3006,10.9,2591,9.4,82581,28731,53850,5.9,16.9,73122,22908,50214,4.7,14.9,9459,2,29.8,0,1673,1673,11968
1997,35380,23281,28103,498807,496030,3233,11.5,2982,10.6,88358,30435,57923,6.1,17.8,82803,34050,48753,6.9,16.7,5555,1.1,33.4,0,1767,1767,11291
1998,35380,23337,28137,508678,503564,3101,11,2986,10.6,86865,30750,56115,6.1,17.3,76637,29835,46802,5.9,15.2,10228,2.1,30.4,0,1853,1853,15289
1999,35380,23253,28278,527371,522859,2860,10.1,2721,9.6,82420,27640,54780,5.3,15.8,73396,26582,46814,5.1,14,9024,1.8,28,0,1753,1753,11847
2000,35380,23095,28285,538905,532905,2906,10.3,2927,10.4,94684,41038,53646,7.7,17.8,82685,30170,52515,5.7,15.5,11999,2.3,31,0,1694,1694,13881
2001,35380,23206,28536,533742,537042,3038,10.7,3010,10.6,79712,30704,49008,5.7,14.8,86312,27278,59034,5.1,16.1,-6600,-1.3,29.6,0,1660,1661,11001
2002,35380,23347,28642,524175,527627,3334,11.7,3202,11.2,81398,31715,49683,6,15.4,88301,30087,58214,5.7,16.7,-6903,-1.3,30.8,0,1670,1672,10698
2003,35380,23441,28603,523541,517919,2886,10.2,2358,8.3,84692,28384,56308,5.5,16.4,73448,23054,50394,4.5,14.2,11244,2.2,28.4,0,1602,1602,14140
2004,35380,23688,28859,533653,527371,2902,10.1,2438,8.5,81498,28379,53119,5.4,15.5,68934,21986,46948,4.2,13.1,12564,2.4,26.2,0,1616,1620,10091
2005,35380,23579,28845,522129,523425,2867,10,2533,8.8,73770,27506,46264,5.3,14.1,76362,23209,53153,4.4,14.6,-2592,-0.5,28.2,0,1810,1812,11979
2006,35380,19830,24691,428768,470423,2588,9.7,5758,21.6,65816,25172,40644,5.4,14,149125,46390,102735,9.9,31.7,-83309,-17.7,28,0,3399,3401,24574
2007,35380,21712,26589,469420,448925,4068,15.9,2306,9,107460,36353,71107,8.1,23.9,66470,19445,47025,4.3,14.8,40990,9.1,29.6,0,1255,1272,7942
2008,35380,21946,26835,470643,468013,2737,10.3,2333,8.8,72544,22121,50423,4.7,15.5,67284,17983,49301,3.8,14.4,5260,1.1,28.8,0,1581,1582,11650
2009,35380,21772,26687,467624,468008,2414,9,2416,9.1,59921,19883,40038,4.2,12.8,60688,15901,44787,3.4,13,-767,-0.2,25.6,0,1688,1688,8502
2010,35380,21605,26535,455355,459810,2337,8.8,2364,8.9,53686,20468,33218,4.5,11.7,62595,16437,46158,3.6,13.6,-8909,-1.9,23.4,0,1572,1575,10997
2011,35380,21576,26646,463093,458805,2374,8.9,2166,8.2,61293,21441,39852,4.7,13.4,52716,15337,37379,3.3,11.5,8577,1.9,23,0,1444,1446,8597
2012,35380,21827,26968,475436,469077,2590,9.7,2316,8.6,68906,22374,46532,4.8,14.7,56187,16609,39578,3.5,12,12719,2.7,24,0,1339,1350,8243
2013,35380,21997,27125,482763,477480,2372,8.8,2232,8.3,68216,23353,44863,4.9,14.3,57651,22287,35364,4.7,12.1,10565,2.2,24.2,0,1412,1418,14336
2014,35380,22033,27157,485994,479661,2467,9.1,2201,8.1,67339,23024,44315,4.8,14,54674,21960,32714,4.6,11.4,12665,2.6,22.8,0,1518,1519,11010
1977,35620,315266,351531,5469547,5391537,48105,13.7,45295,12.9,1021632,418411,603221,7.8,18.9,865612,330793,534819,6.1,16.1,156020,2.8,32.2,0,31606,31707,185581
1978,35620,315930,352106,5689777,5574427,44013,12.5,43598,12.4,1117533,328677,788856,5.9,20,886832,368088,518744,6.6,15.9,230701,4.1,31.8,0,30989,31078,171000
1979,35620,319394,355642,5844133,5763476,44767,12.7,39471,11.2,1060977,341373,719604,5.9,18.4,899663,321715,577948,5.6,15.6,161314,2.8,31.2,0,28630,28739,163442
1980,35620,321569,357890,5947561,5896535,42345,11.9,39338,11,998999,331796,667203,5.6,16.9,896948,308225,588723,5.2,15.2,102051,1.7,30.4,0,29044,29131,162216
1981,35620,315471,350132,5874384,5881518,40800,11.5,46140,13,1020853,363714,657139,6.2,17.4,1035122,419511,615611,7.1,17.6,-14269,-0.2,34.8,0,28855,28971,156217
1982,35620,319753,357864,6015297,5943271,48448,13.7,37640,10.6,1069367,441618,627749,7.4,18,925316,325255,600061,5.5,15.6,144051,2.4,31.2,0,22482,22499,132842
1983,35620,329132,367143,6077168,6047568,43364,12,37654,10.4,1055037,355274,699763,5.9,17.4,995838,338955,656883,5.6,16.5,59199,0.9,33,0,26394,26428,148304
1984,35620,335355,374005,6309527,6190673,46260,12.5,39585,10.7,1133864,407580,726284,6.6,18.3,896155,302539,593616,4.9,14.5,237709,3.8,29,0,27204,27256,168317
1985,35620,343817,383265,6510814,6413009,49779,13.1,40911,10.8,1127910,362118,765792,5.6,17.6,932301,352277,580024,5.5,14.5,195609,3.1,29,0,28428,28521,171527
1986,35620,352342,392073,6663113,6585868,53050,13.7,43169,11.1,1201344,448766,752578,6.8,18.2,1046855,371377,675478,5.6,15.9,154489,2.3,31.8,0,29755,29815,175250
1987,35620,359264,400978,6890601,6821386,56881,14.3,46407,11.7,1266490,462708,803782,6.8,18.6,1128059,436104,691955,6.4,16.5,138431,2.1,33,0,32516,32638,216363
1988,35620,362210,405759,6982568,6925202,52916,13.1,46741,11.6,1270375,435419,834956,6.3,18.3,1155643,384922,770721,5.6,16.7,114732,1.6,33.4,0,33281,33282,181845
1989,35620,363984,410020,7060741,7021188,51858,12.7,48099,11.8,1224132,446017,778115,6.4,17.4,1145027,379421,765606,5.4,16.3,79105,1.1,32.6,0,33556,33652,204563
1990,35620,362789,409872,7017403,7031647,48331,11.8,45688,11.1,1107211,388209,719002,5.5,15.7,1135699,368535,767164,5.2,16.2,-28488,-0.5,31.4,0,33182,33271,205229
1991,35620,359147,408239,6713619,6866053,47896,11.7,49734,12.2,993201,377564,615637,5.5,14.5,1298069,397403,900666,5.8,18.9,-304868,-4.4,29,0,33261,33426,214349
1992,35620,354890,404827,6659018,6667007,48158,11.8,48763,12,1137966,392719,745247,5.9,17.1,1153944,395339,758605,5.9,17.3,-15978,-0.2,34.2,0,33311,33700,199367
1993,35620,357622,406847,6595502,6619741,47539,11.7,44625,11,1077285,361025,716260,5.5,16.3,1125762,347964,777798,5.3,17,-48477,-0.7,32.6,0,31179,31342,174147
1994,35620,359958,410604,6581227,6583950,49693,12.2,44883,11,1027409,367241,660168,5.6,15.6,1032855,347712,685143,5.3,15.7,-5446,-0.1,31.2,0,31173,31361,188135
1995,35620,366530,417897,6702669,6641328,51603,12.5,43146,10.4,1054395,374977,679418,5.6,15.9,931713,316619,615094,4.8,14,122682,1.9,28,0,30384,30526,173531
1996,35620,371811,423359,6746457,6727427,52278,12.4,46174,11,1062763,398076,664687,5.9,15.8,1024703,358477,666226,5.3,15.2,38060,0.6,30.4,0,32439,32444,184620
1997,35620,377692,430734,6931628,6843078,56521,13.2,48793,11.4,1269299,443903,825396,6.5,18.5,1092199,428462,663737,6.3,16,177100,2.5,32,0,32872,32872,196399
1998,35620,383200,437257,7096478,7011972,53979,12.4,46578,10.7,1262942,445374,817568,6.4,18,1093930,392361,701569,5.6,15.6,169012,2.4,31.2,0,32710,32710,193072
1999,35620,385293,441462,7236307,7162225,51850,11.8,47119,10.7,1185355,441759,743596,6.2,16.6,1037191,387611,649580,5.4,14.5,148164,2.1,29,0,32928,32928,196293
2000,35620,387631,446674,7499112,7368078,52479,11.8,47280,10.6,1306230,463085,843145,6.3,17.7,1044162,402901,641261,5.5,14.2,262068,3.5,28.4,0,31305,31305,189581
2001,35620,393291,453350,7650300,7592126,52809,11.7,50134,11.1,1237888,472631,765257,6.2,16.3,1121540,413857,707683,5.5,14.8,116348,1.5,29.6,0,31310,31316,196785
2002,35620,394389,455204,7533821,7581717,57718,12.7,55074,12.1,1340635,538070,802565,7.1,17.7,1436428,535600,900828,7.1,18.9,-95793,-1.2,35.4,0,31890,31920,199541
2003,35620,398403,459361,7575374,7514584,57620,12.6,47757,10.5,1250825,431910,818915,5.7,16.6,1129247,357810,771437,4.8,15,121578,1.6,30,0,32835,32866,199109
2004,35620,402970,463730,7603714,7554591,58034,12.6,50218,10.9,1202391,412864,789527,5.5,15.9,1104145,371503,732642,4.9,14.6,98246,1.3,29.2,0,33561,33615,203367
2005,35620,409607,469384,7582513,7566990,58844,12.6,50120,10.8,1149580,461090,688490,6.1,15.2,1118533,398059,720474,5.3,14.8,31047,0.4,29.6,0,34095,34140,219128
2006,35620,410993,472935,7700448,7621164,58739,12.5,51712,11,1198015,441288,756727,5.8,15.7,1039448,375243,664205,4.9,13.6,158567,2.1,27.2,0,37570,37613,228643
2007,35620,413028,476341,7754450,7719061,56424,11.9,52032,11,1223261,438600,784661,5.7,15.8,1152483,407379,745104,5.3,14.9,70778,0.9,29.8,0,35636,35807,201634
2008,35620,413545,478177,7841407,7782349,53566,11.2,49399,10.4,1162831,425902,736929,5.5,14.9,1044715,334757,709958,4.3,13.4,118116,1.5,26.8,0,36273,36308,213381
2009,35620,404049,469301,7463908,7631746,48792,10.3,54311,11.5,897793,346561,551232,4.5,11.8,1233468,337065,896403,4.4,16.2,-335675,-4.4,23.6,0,37826,37872,206683
2010,35620,402692,467372,7352358,7393559,50269,10.8,50253,10.7,932822,346128,586694,4.7,12.6,1015225,338608,676617,4.6,13.7,-82403,-1.1,25.2,0,33942,33993,198720
2011,35620,403584,469250,7449965,7387120,52453,11.2,48865,10.5,1014422,347929,666493,4.7,13.7,888732,309792,578940,4.2,12,125690,1.7,24,0,33377,33428,181621
2012,35620,410626,476505,7631102,7535049,54821,11.6,47271,10,1074874,338218,736656,4.5,14.3,882768,301722,581046,4,11.7,192106,2.6,23.4,0,31033,31205,161492
2013,35620,415818,481324,7798295,7709849,52270,10.9,48511,10.1,1069903,339827,730076,4.4,13.9,893012,317051,575961,4.1,11.6,176891,2.3,23.2,0,30564,30739,180440
2014,35620,419265,485737,7940061,7846478,54894,11.4,48537,10.1,1102531,383564,718967,4.9,14.1,915364,310044,605320,4,11.7,187167,2.4,23.4,0,33387,33450,193111
1977,35660,2772,3013,54595,53640,443,14.9,349,11.8,8342,3217,5125,6,15.6,6432,2433,3999,4.5,12,1910,3.6,24,0,217,217,1251
1978,35660,2806,3070,56215,55392,414,13.6,356,11.7,9143,3559,5584,6.4,16.5,7496,3944,3552,7.1,13.5,1647,3,27,0,258,259,3056
1979,35660,2795,3068,57750,56912,357,11.6,330,10.8,8165,1952,6213,3.4,14.3,6489,2833,3656,5,11.4,1676,2.9,22.8,0,222,222,1336
1980,35660,2810,3090,54439,56008,395,12.8,360,11.7,6878,3289,3589,5.9,12.3,10016,2744,7272,4.9,17.9,-3138,-5.6,24.6,0,241,241,1076
1981,35660,2632,2895,49616,51843,293,9.8,451,15.1,5600,2844,2756,5.5,10.8,10053,3341,6712,6.4,19.4,-4453,-8.6,21.6,0,251,253,1352
1982,35660,2583,2887,49155,49323,349,12.1,332,11.5,6433,2725,3708,5.5,13,6768,2000,4768,4.1,13.7,-335,-0.7,26,0,175,175,999
1983,35660,2622,2927,46656,47729,297,10.2,285,9.8,6123,2592,3531,5.4,12.8,8268,2940,5328,6.2,17.3,-2145,-4.5,25.6,0,180,180,970
1984,35660,2737,3038,49468,48108,377,12.6,270,9.1,8368,2428,5940,5,17.4,5648,3327,2321,6.9,11.7,2720,5.7,23.4,0,170,170,744
1985,35660,2798,3100,50292,49789,365,11.9,301,9.8,7450,2258,5192,4.5,15,6444,2999,3445,6,12.9,1006,2.1,25.8,0,195,195,1144
1986,35660,2824,3142,53675,51960,359,11.5,304,9.7,9301,3136,6165,6,17.9,5871,2682,3189,5.2,11.3,3430,6.6,22.6,0,217,219,1737
1987,35660,2840,3164,56991,56189,434,13.8,380,12,9103,3299,5804,5.9,16.2,7498,3027,4471,5.4,13.3,1605,2.9,26.6,0,239,240,1495
1988,35660,2849,3190,57081,56685,370,11.7,330,10.4,8941,3488,5453,6.2,15.8,8149,3327,4822,5.9,14.4,792,1.4,28.8,0,220,220,2450
1989,35660,2907,3266,59442,58273,368,11.4,303,9.4,9866,3668,6198,6.3,16.9,7528,1905,5623,3.3,12.9,2338,4,25.8,0,211,212,1276
1990,35660,2945,3322,58708,59004,358,10.9,284,8.6,7433,2707,4726,4.6,12.6,8024,2062,5962,3.5,13.6,-591,-1,25.2,0,197,197,1323
1991,35660,2987,3361,56918,57510,333,10,287,8.6,7379,2499,4880,4.3,12.8,8562,2715,5847,4.7,14.9,-1183,-2.1,25.6,0,177,177,1054
1992,35660,3019,3384,56864,57063,308,9.1,268,7.9,8554,2350,6204,4.1,15,8952,3059,5893,5.4,15.7,-398,-0.7,30,0,160,161,1889
1993,35660,3072,3434,57003,56931,315,9.2,264,7.7,7260,1680,5580,3,12.8,7116,2002,5114,3.5,12.5,144,0.3,25,0,179,179,962
1994,35660,3124,3492,59497,58227,346,10,279,8.1,9251,3537,5714,6.1,15.9,6711,1941,4770,3.3,11.5,2540,4.4,23,0,202,202,1358
1995,35660,3189,3570,62724,61289,388,11,291,8.2,9518,2964,6554,4.8,15.5,6647,2292,4355,3.7,10.8,2871,4.7,21.6,0,182,183,1087
1996,35660,3260,3640,62626,62706,364,10.1,290,8,8037,3370,4667,5.4,12.8,8197,2396,5801,3.8,13.1,-160,-0.3,25.6,0,195,195,1249
1997,35660,3282,3668,59867,61270,390,10.7,362,9.9,7667,2440,5227,4,12.5,10472,4246,6226,6.9,17.1,-2805,-4.6,25,0,217,217,1454
1998,35660,3276,3662,60522,60174,370,10.1,368,10,9487,4570,4917,7.6,15.8,8791,3349,5442,5.6,14.6,696,1.2,29.2,0,245,245,1643
1999,35660,3240,3624,61271,60943,337,9.3,368,10.1,9146,3009,6137,4.9,15,8489,3126,5363,5.1,13.9,657,1.1,27.8,0,248,248,1658
2000,35660,3235,3607,62438,61799,312,8.6,335,9.3,9642,2389,7253,3.9,15.6,8364,2584,5780,4.2,13.5,1278,2.1,27,0,186,186,921
2001,35660,3237,3617,59793,61198,334,9.2,358,9.9,7479,2834,4645,4.6,12.2,10289,5407,4882,8.8,16.8,-2810,-4.6,24.4,0,217,217,1200
2002,35660,3226,3619,60077,59907,368,10.2,361,10,9109,3996,5113,6.7,15.2,8769,3365,5404,5.6,14.6,340,0.6,29.2,0,188,188,1142
2003,35660,3243,3638,58958,59090,372,10.3,313,8.7,7819,2378,5441,4,13.2,8083,2651,5432,4.5,13.7,-264,-0.5,26.4,0,218,219,1301
2004,35660,3211,3608,58613,58576,308,8.5,301,8.3,6508,1907,4601,3.3,11.1,6433,1709,4724,2.9,11,75,0.1,22,0,212,212,1336
2005,35660,3174,3569,57641,57594,310,8.7,305,8.5,7406,2252,5154,3.9,12.9,7311,1648,5663,2.9,12.7,95,0.2,25.4,0,209,209,1040
2006,35660,3090,3501,57781,57569,323,9.2,353,10,7087,2115,4972,3.7,12.3,6662,2169,4493,3.8,11.6,425,0.7,23.2,0,248,248,1750
2007,35660,3124,3553,57737,57629,340,9.7,300,8.5,7394,2338,5056,4.1,12.8,7178,2156,5022,3.7,12.5,216,0.3,25,0,201,201,1092
2008,35660,3100,3535,55596,56374,327,9.3,317,9,6817,2456,4361,4.4,12.1,8372,1944,6428,3.4,14.9,-1555,-2.8,24.2,0,232,232,1121
2009,35660,2985,3416,51852,53631,231,6.7,323,9.3,5174,1929,3245,3.6,9.6,8732,1889,6843,3.5,16.3,-3558,-6.7,19.2,0,214,214,1250
2010,35660,2914,3342,50203,50699,244,7.2,305,9.1,5974,2051,3923,4,11.8,6966,2110,4856,4.2,13.7,-992,-1.9,23.6,0,196,196,1087
2011,35660,2863,3306,50460,50130,247,7.5,265,8,6663,2367,4296,4.7,13.3,6003,2233,3770,4.5,12,660,1.3,24,0,193,193,1682
2012,35660,2873,3319,52014,51275,276,8.3,272,8.2,6625,1729,4896,3.4,12.9,5146,1640,3506,3.2,10,1479,2.9,20,0,153,154,807
2013,35660,2802,3243,50558,51206,187,5.7,258,7.9,5288,1332,3956,2.6,10.3,6584,1517,5067,3,12.9,-1296,-2.6,20.6,0,170,170,869
2014,35660,2767,3218,52955,51568,231,7.2,239,7.4,6315,1526,4789,3,12.2,3541,931,2610,1.8,6.9,2774,5.3,13.8,0,164,164,630
1977,35840,6396,7029,74474,70834,1507,22.2,993,14.6,19423,10401,9022,14.7,27.4,12143,6043,6100,8.5,17.1,7280,10.3,34.2,0,731,735,4057
1978,35840,6824,7498,82603,78579,1460,20.1,993,13.7,21625,9684,11941,12.3,27.5,13577,6630,6947,8.4,17.3,8048,10.2,34.6,0,723,726,3983
1979,35840,7229,7970,92045,87234,1531,19.8,1004,13,23297,9627,13670,11,26.7,13674,6429,7245,7.4,15.7,9623,11,31.4,0,773,773,3953
1980,35840,7661,8428,95801,93880,1551,18.9,1054,12.9,22082,10585,11497,11.3,23.5,18239,8362,9877,8.9,19.4,3843,4.1,38.8,0,802,803,5530
1981,35840,7799,8593,102676,99069,1538,18.1,1317,15.5,25098,12822,12276,12.9,25.3,17884,8625,9259,8.7,18.1,7214,7.2,36.2,0,884,886,4930
1982,35840,8196,9130,105919,104096,1702,19.2,1100,12.4,23153,11332,11821,10.9,22.2,19507,6725,12782,6.5,18.7,3646,3.5,37.4,0,681,681,4013
1983,35840,8399,9391,103395,104682,1562,16.9,1337,14.4,20822,9643,11179,9.2,19.9,23395,10389,13006,9.9,22.3,-2573,-2.4,39.8,0,847,849,5081
1984,35840,9148,10208,120549,111928,1949,19.9,1124,11.5,31027,12576,18451,11.2,27.7,13785,6110,7675,5.5,12.3,17242,15.4,24.6,0,819,819,3638
1985,35840,9675,10789,125946,123370,1908,18.2,1319,12.6,27699,13224,14475,10.7,22.5,22547,8844,13703,7.2,18.3,5152,4.2,36.6,0,927,932,5279
1986,35840,10109,11261,134895,130883,1973,17.9,1453,13.2,30926,13653,17273,10.4,23.6,22902,9284,13618,7.1,17.5,8024,6.1,35,0,1055,1055,5737
1987,35840,10421,11699,139729,137220,2156,18.8,1664,14.5,29895,13273,16622,9.7,21.8,24877,11289,13588,8.2,18.1,5018,3.7,36.2,0,1198,1206,6721
1988,35840,10544,11926,145657,142348,1950,16.5,1676,14.2,32420,14340,18080,10.1,22.8,25802,11612,14190,8.2,18.1,6618,4.7,36.2,0,1217,1217,7528
1989,35840,10712,12176,154744,150435,1843,15.3,1588,13.2,33078,14203,18875,9.4,22,24459,10625,13834,7.1,16.3,8619,5.7,32.6,0,1169,1169,7027
1990,35840,10881,12419,161662,157936,1810,14.7,1466,11.9,34253,13451,20802,8.5,21.7,26800,9965,16835,6.3,17,7453,4.7,34,0,1080,1081,5961
1991,35840,11041,12671,166084,163806,1788,14.3,1530,12.2,34854,13348,21506,8.1,21.3,30298,12038,18260,7.3,18.5,4556,2.8,37,0,1019,1020,6211
1992,35840,11094,12755,170539,169080,1832,14.4,1652,13,33734,13998,19736,8.3,20,30815,14650,16165,8.7,18.2,2919,1.8,36.4,0,1111,1132,6233
1993,35840,11303,12884,164802,168889,1716,13.4,1565,12.2,31376,11243,20133,6.7,18.6,39551,11720,27831,6.9,23.4,-8175,-4.8,37.2,0,1036,1058,6827
1994,35840,11549,13188,172906,168721,1885,14.5,1547,11.9,38474,19775,18699,11.7,22.8,30104,12916,17188,7.7,17.8,8370,5,35.6,0,1119,1119,9562
1995,35840,11820,13494,180697,176748,1933,14.5,1566,11.7,35121,11674,23447,6.6,19.9,27223,12233,14990,6.9,15.4,7898,4.5,30.8,0,1081,1087,6202
1996,35840,11948,13609,186786,182689,1784,13.2,1619,12,43621,21508,22113,11.8,23.9,35427,15405,20022,8.4,19.4,8194,4.5,38.8,0,1110,1110,10574
1997,35840,12072,13819,212603,199908,2017,14.7,1802,13.1,54971,13783,41188,6.9,27.5,29583,12171,17412,6.1,14.8,25388,12.7,29.6,0,1198,1198,6504
1998,35840,12140,13924,229732,220971,1822,13.1,1666,12,47261,15544,31717,7,21.4,29739,13595,16144,6.2,13.5,17522,7.9,27,0,1102,1102,7467
1999,35840,12372,14206,254106,242731,2048,14.6,1738,12.4,74950,14319,60631,5.9,30.9,52199,25042,27157,10.3,21.5,22751,9.4,43,0,1189,1189,7161
2000,35840,12405,14277,296550,275316,1968,13.8,1877,13.2,93673,41095,52578,14.9,34,51205,15306,35899,5.6,18.6,42468,15.4,37.2,0,1162,1162,6581
2001,35840,12801,14824,287908,292882,2218,15.2,1800,12.4,58949,15848,43101,5.4,20.1,68897,27781,41116,9.5,23.5,-9948,-3.4,40.2,0,1108,1108,7451
2002,35840,13132,15186,253284,261234,2368,15.8,1976,13.2,56905,18228,38677,7,21.8,72804,51449,21355,19.7,27.9,-15899,-6.1,43.6,0,1100,1100,6044
2003,35840,13596,15720,253493,248507,2469,16,1654,10.7,72391,35099,37292,14.1,29.1,62418,21370,41048,8.6,25.1,9973,4,50.2,0,1201,1201,7109
2004,35840,14514,16638,273205,263625,2880,17.8,1838,11.4,55535,22151,33384,8.4,21.1,36375,18634,17741,7.1,13.8,19160,7.3,27.6,0,1242,1244,11364
2005,35840,15324,17612,275391,273978,2946,17.2,1819,10.6,55230,23952,31278,8.7,20.2,52404,20716,31688,7.6,19.1,2826,1.1,38.2,0,1301,1303,16364
2006,35840,15862,18262,313471,293547,2870,16,2024,11.3,67215,26297,40918,9,22.9,27367,11036,16331,3.8,9.3,39848,13.6,18.6,0,1422,1422,7355
2007,35840,15937,18460,314400,313523,2601,14.2,2317,12.6,54774,16963,37811,5.4,17.5,53019,18937,34082,6,16.9,1755,0.6,33.8,0,1579,1583,12697
2008,35840,15523,18030,295885,304241,2206,12.1,2441,13.4,42275,19494,22781,6.4,13.9,58987,21579,37408,7.1,19.4,-16712,-5.5,27.8,0,1748,1753,9656
2009,35840,14667,17104,263038,278360,1888,10.8,2530,14.5,32925,13106,19819,4.7,11.8,63568,12415,51153,4.5,22.8,-30643,-11,23.6,0,1733,1738,7375
2010,35840,14605,16986,242924,241247,2084,12.3,2077,12.2,42624,13493,29131,5.6,17.7,39270,10746,28524,4.5,16.3,3354,1.4,32.6,0,1397,1397,6931
2011,35840,14701,17131,227695,235041,2157,12.7,1913,11.2,36739,14547,22192,6.2,15.6,51430,26800,24630,11.4,21.9,-14691,-6.3,31.2,0,1291,1293,5456
2012,35840,15167,17687,231230,229512,2338,13.4,1826,10.5,48648,15327,33321,6.7,21.2,45211,29265,15946,12.8,19.7,3437,1.5,39.4,0,1122,1133,24501
2013,35840,15482,17990,248461,239345,2079,11.7,1812,10.2,46083,13028,33055,5.4,19.3,27851,10010,17841,4.2,11.6,18232,7.7,23.2,0,1153,1153,5921
2014,35840,15753,18303,251760,249456,2215,12.2,1794,9.9,41925,12068,29857,4.8,16.8,37317,9528,27789,3.8,15,4608,1.8,30,0,1274,1274,6237
1977,35980,3468,3812,74057,70398,559,14.9,421,11.2,13273,3334,9939,4.7,18.9,5954,3018,2936,4.3,8.5,7319,10.4,17,0,273,274,1633
1978,35980,3560,3900,72845,73458,479,12.4,390,10.1,8941,2421,6520,3.3,12.2,10167,2400,7767,3.3,13.8,-1226,-1.6,24.4,0,271,272,1342
1979,35980,3672,4008,74295,73557,509,12.9,391,9.9,9492,3449,6043,4.7,12.9,8015,2990,5025,4.1,10.9,1477,2,21.8,0,266,266,981
1980,35980,3676,4028,75683,74946,465,11.6,422,10.5,8885,3046,5839,4.1,11.9,7411,2613,4798,3.5,9.9,1474,2,19.8,0,308,310,1519
1981,35980,3609,3939,77068,75942,440,11.1,491,12.4,9808,2718,7090,3.6,12.9,7556,2696,4860,3.6,9.9,2252,3,19.8,0,284,284,1133
1982,35980,3701,4090,78657,77876,544,13.5,369,9.2,9844,4132,5712,5.3,12.6,8281,2235,6046,2.9,10.6,1563,2,21.2,0,222,222,1154
1983,35980,3816,4208,79792,79230,455,11,370,8.9,9620,2874,6746,3.6,12.1,8496,2674,5822,3.4,10.7,1124,1.4,21.4,0,249,250,1441
1984,35980,3969,4373,83324,81536,559,13,388,9.1,11323,3780,7543,4.6,13.9,7747,2902,4845,3.6,9.5,3576,4.4,19,0,252,252,1544
1985,35980,4124,4572,86230,85099,622,13.9,439,9.8,11797,4964,6833,5.8,13.9,9534,4548,4986,5.3,11.2,2263,2.7,22.4,0,293,293,1667
1986,35980,4266,4733,89761,87949,666,14.3,484,10.4,13083,6142,6941,7,14.9,9459,2787,6672,3.2,10.8,3624,4.1,21.6,0,330,330,1603
1987,35980,4483,4989,94633,92763,767,15.8,503,10.3,14182,6267,7915,6.8,15.3,10441,3167,7274,3.4,11.3,3741,4,22.6,0,330,330,1856
1988,35980,4624,5148,97237,95401,752,14.9,545,10.8,14171,4835,9336,5.1,14.9,10498,3770,6728,4,11,3673,3.9,22,0,360,360,1626
1989,35980,4720,5261,97118,97250,676,13,573,11,11528,4130,7398,4.2,11.9,11791,3355,8436,3.4,12.1,-263,-0.2,23.8,0,419,421,2071
1990,35980,4624,5157,93484,95034,523,10,568,10.9,10000,3593,6407,3.8,10.5,13099,3672,9427,3.9,13.8,-3099,-3.3,21,0,404,405,1942
1991,35980,4586,5144,90818,92375,570,11.1,585,11.4,9817,4116,5701,4.5,10.6,12931,4066,8865,4.4,14,-3114,-3.4,21.2,0,370,373,2084
1992,35980,4529,5107,89695,90233,553,10.8,562,10.9,10977,4011,6966,4.4,12.2,12052,3486,8566,3.9,13.4,-1075,-1.2,24.4,0,363,368,1881
1993,35980,4506,5071,89248,89462,454,8.9,486,9.6,10775,3053,7722,3.4,12,11203,2860,8343,3.2,12.5,-428,-0.5,24,0,320,321,1635
1994,35980,4512,5082,89275,88973,506,10,474,9.3,10898,3406,7492,3.8,12.2,10294,3462,6832,3.9,11.6,604,0.6,23.2,0,334,335,1961
1995,35980,4585,5168,89941,89618,539,10.5,452,8.8,11339,4971,6368,5.5,12.7,10693,4396,6297,4.9,11.9,646,0.8,23.8,0,290,291,1302
1996,35980,4625,5216,89431,89650,540,10.4,480,9.2,11924,5086,6838,5.7,13.3,12361,3362,8999,3.8,13.8,-437,-0.5,26.6,0,296,296,1604
1997,35980,4625,5207,102709,101453,543,10.4,541,10.4,17485,4015,13470,4,17.2,14973,5816,9157,5.7,14.8,2512,2.4,29.6,0,317,317,2641
1998,35980,4574,5137,104221,103253,504,9.7,554,10.7,12015,3775,8240,3.7,11.6,10079,3470,6609,3.4,9.8,1936,1.8,19.6,0,376,376,1830
1999,35980,4519,5104,105066,104634,469,9.2,494,9.6,13416,5612,7804,5.4,12.8,12551,5095,7456,4.9,12,865,0.8,24,0,332,332,2299
2000,35980,4574,5188,106076,105573,520,10.1,447,8.7,14168,4709,9459,4.5,13.4,13162,4164,8998,3.9,12.5,1006,0.9,25,0,271,271,1479
2001,35980,4572,5202,106641,106806,487,9.4,514,9.9,12031,4257,7774,4,11.3,12360,4021,8339,3.8,11.6,-329,-0.3,22.6,0,318,318,2030
2002,35980,4625,5277,110424,108427,595,11.4,509,9.7,21307,6434,14873,5.9,19.7,17313,5142,12171,4.7,16,3994,3.7,32,0,252,252,1859
2003,35980,4628,5298,109702,109911,524,9.9,446,8.5,16358,5043,11315,4.6,14.9,16775,4459,12316,4.1,15.3,-417,-0.4,29.8,0,302,302,1663
2004,35980,4695,5363,100366,104300,527,9.9,406,7.6,12803,4734,8069,4.5,12.3,20670,14270,6400,13.7,19.8,-7867,-7.5,24.6,0,278,278,13336
2005,35980,4741,5457,113316,106692,558,10.3,423,7.8,22712,16388,6324,15.4,21.3,9463,2449,7014,2.3,8.9,13249,12.4,17.8,0,286,286,1511
2006,35980,4673,5433,113073,112946,554,10.2,524,9.6,11550,4993,6557,4.4,10.2,11295,4190,7105,3.7,10,255,0.2,20,0,373,373,3257
2007,35980,4654,5435,109319,111033,517,9.5,497,9.2,10820,4082,6738,3.7,9.7,14247,4039,10208,3.6,12.8,-3427,-3.1,19.4,0,325,325,1974
2008,35980,4657,5440,110243,109585,504,9.3,443,8.2,10793,3427,7366,3.1,9.8,9476,2811,6665,2.6,8.6,1317,1.2,17.2,0,298,298,1434
2009,35980,4539,5295,107297,108393,424,7.9,514,9.6,8894,3462,5432,3.2,8.2,11085,2753,8332,2.5,10.2,-2191,-2,16.4,0,320,320,1545
2010,35980,4430,5205,108714,107739,427,8.2,462,8.8,12002,2855,9147,2.6,11.1,10052,2257,7795,2.1,9.3,1950,1.8,18.6,0,305,305,1600
2011,35980,4351,5123,106897,107583,406,7.9,453,8.8,8025,2594,5431,2.4,7.5,9396,2458,6938,2.3,8.7,-1371,-1.2,15,0,301,301,1579
2012,35980,4391,5141,106053,106457,439,8.6,421,8.2,8988,2693,6295,2.5,8.4,9796,2179,7617,2,9.2,-808,-0.8,16.8,0,256,257,1142
2013,35980,4392,5143,105343,105589,420,8.2,415,8.1,8831,2214,6617,2.1,8.4,9322,2372,6950,2.2,8.8,-491,-0.4,16.8,0,273,273,1359
2014,35980,4385,5151,102794,103821,443,8.6,406,7.9,7576,2817,4759,2.7,7.3,9629,2421,7208,2.3,9.3,-2053,-2,14.6,0,274,274,1068
1977,36100,1926,2101,21735,20860,430,21.1,284,14,5267,2604,2663,12.5,25.2,3516,1522,1994,7.3,16.9,1751,8.3,33.8,0,203,203,934
1978,36100,1993,2174,23079,22393,406,19,330,15.4,5310,2215,3095,9.9,23.7,3938,1992,1946,8.9,17.6,1372,6.1,35.2,0,231,231,990
1979,36100,2075,2269,25743,24378,401,18.1,288,13,6469,3103,3366,12.7,26.5,3739,1810,1929,7.4,15.3,2730,11.2,30.6,0,223,223,1311
1980,36100,2218,2412,27740,26717,446,19.1,293,12.5,6506,2807,3699,10.5,24.4,4460,1956,2504,7.3,16.7,2046,7.7,33.4,0,204,204,1133
1981,36100,2357,2569,29501,28613,514,20.6,347,13.9,6810,3548,3262,12.4,23.8,5033,2117,2916,7.4,17.6,1777,6.2,35.2,0,231,233,1219
1982,36100,2504,2771,31833,30864,526,19.7,313,11.7,6930,3418,3512,11.1,22.5,4991,1690,3301,5.5,16.2,1939,6.3,32.4,0,199,199,969
1983,36100,2594,2865,31726,31618,493,17.5,421,14.9,6544,2879,3665,9.1,20.7,6328,3009,3319,9.5,20,216,0.7,40,0,264,264,1441
1984,36100,2818,3110,35498,33603,610,20.4,360,12.1,8187,3290,4897,9.8,24.4,4396,1756,2640,5.2,13.1,3791,11.3,26.2,0,238,239,977
1985,36100,3033,3362,40231,38370,664,20.5,407,12.6,9702,4686,5016,12.2,25.3,5980,2679,3301,7,15.6,3722,9.7,31.2,0,302,302,2019
1986,36100,3190,3533,42408,41294,671,19.5,482,14,9256,4269,4987,10.3,22.4,7028,3005,4023,7.3,17,2228,5.4,34,0,331,331,1858
1987,36100,3347,3728,44918,43740,731,20.1,535,14.7,9658,4377,5281,10,22.1,7302,3344,3958,7.6,16.7,2356,5.4,33.4,0,371,371,1963
1988,36100,3462,3898,48459,46425,699,18.3,505,13.3,11510,5039,6471,10.9,24.8,7442,3435,4007,7.4,16,4068,8.8,32,0,389,389,2035
1989,36100,3508,3964,49910,49251,578,14.7,516,13.1,9882,3974,5908,8.1,20.1,8563,3473,5090,7.1,17.4,1319,2.7,34.8,0,374,375,2055
1990,36100,3611,4081,51411,50567,622,15.5,461,11.5,9465,4253,5212,8.4,18.7,7777,2737,5040,5.4,15.4,1688,3.3,30.8,0,342,342,1842
1991,36100,3662,4144,49705,50547,557,13.6,487,11.8,8120,3041,5079,6,16.1,9803,3696,6107,7.3,19.4,-1683,-3.3,32.2,0,334,340,2543
1992,36100,3706,4199,52568,51199,579,13.9,502,12,11159,5509,5650,10.8,21.8,8421,2628,5793,5.1,16.4,2738,5.4,32.8,0,351,355,1552
1993,36100,3767,4254,55274,53937,578,13.7,514,12.2,10865,4502,6363,8.3,20.1,8190,4165,4025,7.7,15.2,2675,4.9,30.4,0,379,379,2590
1994,36100,3846,4340,57370,56204,587,13.7,492,11.4,9995,3870,6125,6.9,17.8,7663,3124,4539,5.6,13.6,2332,4.2,27.2,0,360,361,2262
1995,36100,3948,4444,58806,58086,579,13.2,461,10.5,9883,3209,6674,5.5,17,8442,3095,5347,5.3,14.5,1441,2.5,29,0,337,338,1618
1996,36100,4093,4580,59573,59072,627,13.9,466,10.3,10109,4662,5447,7.9,17.1,9107,3324,5783,5.6,15.4,1002,1.7,30.8,0,301,301,1478
1997,36100,4142,4670,63520,61573,673,14.5,592,12.8,13088,5782,7306,9.4,21.3,9193,4163,5030,6.8,14.9,3895,6.4,29.8,0,381,381,1867
1998,36100,4187,4715,66769,65096,597,12.7,524,11.2,12435,5517,6918,8.5,19.1,9089,3081,6008,4.7,14,3346,5.1,28,0,364,364,1757
1999,36100,4241,4769,69065,67845,599,12.6,538,11.3,12114,4344,7770,6.4,17.9,9673,4001,5672,5.9,14.3,2441,3.6,28.6,0,348,348,1769
2000,36100,4283,4835,73366,72248,598,12.5,531,11.1,11333,3911,7422,5.4,15.7,9097,3499,5598,4.8,12.6,2236,3.1,25.2,0,350,350,2043
2001,36100,4415,4977,74059,73902,664,13.5,571,11.6,11195,4296,6899,5.8,15.1,10880,4274,6606,5.8,14.7,315,0.4,29.4,0,327,327,1815
2002,36100,4531,5118,72586,72172,723,14.3,576,11.4,12551,4825,7726,6.7,17.4,11723,4531,7192,6.3,16.2,828,1.2,32.4,0,346,346,2008
2003,36100,4679,5270,75974,73906,736,14.2,488,9.4,14036,5252,8784,7.1,19,9900,2940,6960,4,13.4,4136,5.6,26.8,0,351,351,2000
2004,36100,5064,5666,75835,75570,964,17.7,520,9.5,13875,5207,8668,6.9,18.4,13344,4654,8690,6.2,17.7,531,0.7,35.4,0,372,373,1965
2005,36100,5355,6003,80480,77928,974,16.7,580,10,14913,7189,7724,9.2,19.1,9809,2988,6821,3.8,12.6,5104,6.5,25.2,0,423,423,1856
2006,36100,5668,6349,88311,84225,973,15.8,579,9.4,17266,8135,9131,9.7,20.5,9094,3357,5737,4,10.8,8172,9.7,21.6,0,415,415,2162
2007,36100,5776,6507,89259,88484,965,15,776,12.1,16323,8523,7800,9.6,18.4,14773,5026,9747,5.7,16.7,1550,1.7,33.4,0,529,533,2764
2008,36100,5674,6430,84319,86610,807,12.5,822,12.7,10338,4157,6181,4.8,11.9,14920,3945,10975,4.6,17.2,-4582,-5.3,23.8,0,639,639,2818
2009,36100,5346,6054,78540,81128,610,9.8,893,14.4,9678,4346,5332,5.4,11.9,14853,3922,10931,4.8,18.3,-5175,-6.4,23.8,0,638,640,2624
2010,36100,5250,5966,74035,76113,677,11.3,719,12,9701,4209,5492,5.5,12.7,13857,2939,10918,3.9,18.2,-4156,-5.5,25.4,0,518,518,2103
2011,36100,5208,5914,70773,72104,663,11.2,666,11.2,9446,4239,5207,5.9,13.1,12107,4904,7203,6.8,16.8,-2661,-3.7,26.2,0,464,464,2280
2012,36100,5263,5971,72208,71514,650,11,611,10.3,9388,3880,5508,5.4,13.1,7999,2752,5247,3.8,11.2,1389,1.9,22.4,0,407,408,1780
2013,36100,5344,6057,74125,73151,622,10.4,565,9.4,10503,4050,6453,5.5,14.4,8554,3531,5023,4.8,11.7,1949,2.7,23.4,0,400,401,2143
2014,36100,5353,6082,75017,74397,701,11.6,642,10.6,11005,4672,6333,6.3,14.8,9765,4143,5622,5.6,13.1,1240,1.7,26.2,0,443,446,2820
1977,36140,1605,1706,12951,12755,315,18.7,268,15.9,3316,1472,1844,11.5,26,2923,1561,1362,12.2,22.9,393,3.1,45.8,0,139,140,779
1978,36140,1656,1764,13990,13474,317,18.3,259,14.9,3396,1146,2250,8.5,25.2,2363,969,1394,7.2,17.5,1033,7.7,35,0,159,160,561
1979,36140,1705,1816,14923,14432,301,16.8,229,12.8,3496,1292,2204,9,24.2,2514,1046,1468,7.2,17.4,982,6.8,34.8,0,138,138,639
1980,36140,1772,1894,15148,15039,299,16.1,224,12.1,3166,1146,2020,7.6,21.1,2947,957,1990,6.4,19.6,219,1.5,39.2,0,135,135,563
1981,36140,1715,1833,15476,14738,267,14.4,294,15.9,4061,2042,2019,13.9,27.6,2584,1136,1448,7.7,17.5,1477,10.1,35,0,172,173,528
1982,36140,1770,1925,14876,15244,335,17.8,239,12.7,3443,1548,1895,10.2,22.6,4178,1485,2693,9.7,27.4,-735,-4.8,45.2,0,127,127,743
1983,36140,1817,1982,15905,15467,302,15.5,245,12.5,3811,1409,2402,9.1,24.6,2934,1195,1739,7.7,19,877,5.6,38,0,154,155,638
1984,36140,1898,2065,17100,16376,320,15.8,233,11.5,4671,1642,3029,10,28.5,3223,1070,2153,6.5,19.7,1448,8.8,39.4,0,125,125,445
1985,36140,2024,2197,19238,18716,343,16,228,10.7,4282,1314,2968,7,22.9,3238,1112,2126,5.9,17.3,1044,5.6,34.6,0,128,128,483
1986,36140,2126,2313,20793,20016,397,17.6,271,12,4642,1682,2960,8.4,23.2,3088,1115,1973,5.6,15.4,1554,7.8,30.8,0,157,157,648
1987,36140,2249,2487,23437,22153,458,19,278,11.6,6387,2940,3447,13.3,28.8,3818,1462,2356,6.6,17.2,2569,11.6,34.4,0,175,176,801
1988,36140,2327,2555,22730,22355,400,15.9,315,12.5,5363,1881,3482,8.4,24,4613,1989,2624,8.9,20.6,750,3.4,41.2,0,177,177,613
1989,36140,2360,2592,22839,22845,331,12.9,304,11.8,4576,1437,3139,6.3,20,4588,1637,2951,7.2,20.1,-12,-0.1,40,0,186,186,1111
1990,36140,2374,2614,23300,23020,323,12.4,266,10.2,4583,1423,3160,6.2,19.9,4022,1260,2762,5.5,17.5,561,2.4,35,0,165,166,762
1991,36140,2311,2556,21971,22627,278,10.8,333,12.9,4102,1537,2565,6.8,18.1,5414,1748,3666,7.7,23.9,-1312,-5.8,36.2,0,187,192,1061
1992,36140,2300,2547,22109,22022,276,10.8,267,10.4,4225,1080,3145,4.9,19.2,4050,1372,2678,6.2,18.4,175,0.8,36.8,0,159,159,712
1993,36140,2336,2577,23007,22538,272,10.6,239,9.3,4699,1224,3475,5.4,20.8,3761,998,2763,4.4,16.7,938,4.1,33.4,0,136,136,445
1994,36140,2392,2653,21178,21987,324,12.4,235,9,3372,1266,2106,5.8,15.3,4990,1087,3903,4.9,22.7,-1618,-7.4,30.6,0,150,157,609
1995,36140,2416,2693,21851,21533,280,10.5,234,8.8,3805,1374,2431,6.4,17.7,3169,876,2293,4.1,14.7,636,3,29.4,0,142,142,551
1996,36140,2439,2718,21725,21789,273,10.1,244,9,3716,1279,2437,5.9,17.1,3843,1248,2595,5.7,17.6,-127,-0.5,34.2,0,144,144,461
1997,36140,2490,2753,22735,22280,356,13,302,11,4833,1917,2916,8.6,21.7,3923,1847,2076,8.3,17.6,910,4.1,35.2,0,147,147,871
1998,36140,2560,2838,24571,23629,309,11.1,226,8.1,4962,1562,3400,6.6,21,3078,961,2117,4.1,13,1884,8,26,0,143,143,484
1999,36140,2587,2851,25124,24854,310,10.9,297,10.4,4809,1520,3289,6.1,19.3,4268,2181,2087,8.8,17.2,541,2.1,34.4,0,185,185,818
2000,36140,2598,2863,25898,25496,274,9.6,264,9.2,4537,1410,3127,5.5,17.8,3732,1378,2354,5.4,14.6,805,3.2,29.2,0,160,160,694
2001,36140,2691,2954,26124,26096,317,10.9,255,8.8,3894,1362,2532,5.2,14.9,3837,975,2862,3.7,14.7,57,0.2,29.4,0,140,140,402
2002,36140,2638,2924,25650,25815,386,13.2,404,13.8,4966,2016,2950,7.8,19.2,5296,2587,2709,10,20.5,-330,-1.3,38.4,0,176,176,738
2003,36140,2631,2903,25343,25484,345,11.9,344,11.8,3842,1300,2542,5.1,15.1,4124,1570,2554,6.2,16.2,-282,-1.1,30.2,0,177,177,809
2004,36140,2672,2945,26142,25699,344,11.8,291,10,4156,1583,2573,6.2,16.2,3269,1182,2087,4.6,12.7,887,3.5,25.4,0,173,173,608
2005,36140,2716,2993,25990,26025,337,11.4,276,9.3,4145,1778,2367,6.8,15.9,4214,1568,2646,6,16.2,-69,-0.3,31.8,0,179,179,840
2006,36140,2768,3052,26730,26281,394,13.1,311,10.3,4492,1873,2619,7.1,17.1,3594,1121,2473,4.3,13.7,898,3.4,27.4,0,199,199,729
2007,36140,2761,3057,25781,26155,342,11.2,340,11.1,3913,1468,2445,5.6,15,4660,1223,3437,4.7,17.8,-747,-2.8,30,0,199,200,837
2008,36140,2670,2962,25432,25537,276,9.2,354,11.8,3697,1396,2301,5.5,14.5,3906,1157,2749,4.5,15.3,-209,-0.8,29,0,216,218,717
2009,36140,2490,2783,23720,24548,224,7.8,380,13.2,2754,1037,1717,4.2,11.2,4409,1226,3183,5,18,-1655,-6.8,22.4,0,218,218,712
2010,36140,2435,2724,23866,23765,249,9.1,292,10.6,3371,1289,2082,5.4,14.2,3168,879,2289,3.7,13.3,203,0.9,26.6,0,153,153,494
2011,36140,2387,2679,23941,23882,244,9,280,10.4,3106,1113,1993,4.7,13,2988,995,1993,4.2,12.5,118,0.5,25,0,158,158,586
2012,36140,2454,2751,24119,23995,318,11.7,253,9.3,3881,1384,2497,5.8,16.2,3632,1145,2487,4.8,15.1,249,1.1,30.2,0,134,135,575
2013,36140,2437,2734,24598,24511,259,9.5,291,10.6,3291,911,2380,3.7,13.4,3116,1146,1970,4.7,12.7,175,0.7,25.4,0,144,144,625
2014,36140,2411,2698,24929,24737,257,9.5,280,10.3,3598,882,2716,3.6,14.5,3214,1356,1858,5.5,13,384,1.5,26,0,150,156,486
1977,36220,2559,2831,37821,36963,572,20.9,377,13.8,8993,4383,4610,11.9,24.3,7276,3290,3986,8.9,19.7,1717,4.6,39.4,0,274,274,2419
1978,36220,2474,2742,42327,39929,444,15.9,501,18,11293,4009,7284,10,28.3,6497,3214,3283,8,16.3,4796,12,32.6,0,285,285,1247
1979,36220,2747,3036,45301,43964,531,18.4,257,8.9,10357,3565,6792,8.1,23.6,7682,2753,4929,6.3,17.5,2675,6.1,35,0,9,12,117
1980,36220,2832,3146,48421,46801,525,17,395,12.8,11413,4794,6619,10.2,24.4,8172,3489,4683,7.5,17.5,3241,6.9,35,0,287,287,1935
1981,36220,2886,3225,57780,53120,580,18.2,478,15,17173,4727,12446,8.9,32.3,7852,4437,3415,8.4,14.8,9321,17.5,29.6,0,299,300,2725
1982,36220,3206,3613,61390,59551,786,23,383,11.2,16085,6638,9447,11.1,27,12406,5630,6776,9.5,20.8,3679,6.2,41.6,0,210,210,1353
1983,36220,3135,3529,46067,53469,503,14.1,601,16.8,7962,3970,3992,7.4,14.9,22766,6360,16406,11.9,42.6,-14804,-27.7,29.8,0,418,418,3143
1984,36220,2975,3405,44816,45455,477,13.8,588,17,9634,4108,5526,9,21.2,10911,3852,7059,8.5,24,-1277,-2.8,42.4,0,410,410,2185
1985,36220,2951,3371,44270,44557,405,12,442,13,9148,3089,6059,6.9,20.5,9721,4157,5564,9.3,21.8,-573,-1.3,41,0,283,284,2096
1986,36220,2912,3292,40722,42483,399,12,461,13.8,7232,3502,3730,8.2,17,10753,3466,7287,8.2,25.3,-3521,-8.3,34,0,299,300,2028
1987,36220,2650,3011,33889,37180,346,11,601,19.1,5932,3277,2655,8.8,16,12514,5363,7151,14.4,33.7,-6582,-17.7,32,0,375,382,2619
1988,36220,2672,3060,35460,34697,387,12.7,343,11.3,7762,2767,4995,8,22.4,6235,2223,4012,6.4,18,1527,4.4,36,0,218,218,952
1989,36220,2571,2911,32985,34227,239,8,389,13,5272,1739,3533,5.1,15.4,7756,3419,4337,10,22.7,-2484,-7.3,30.8,0,231,232,1803
1990,36220,2530,2866,33720,33306,297,10.3,322,11.1,6218,1767,4451,5.3,18.7,5389,2036,3353,6.1,16.2,829,2.5,32.4,0,218,221,1242
1991,36220,2561,2896,35936,34871,315,10.9,289,10,7722,2295,5427,6.6,22.1,5592,1910,3682,5.5,16,2130,6.1,32,0,169,170,1094
1992,36220,2529,2874,37625,36625,317,11,332,11.5,8593,3981,4612,10.9,23.5,6593,2251,4342,6.1,18,2000,5.5,36,0,212,215,1134
1993,36220,2503,2836,36466,36982,242,8.5,265,9.3,6186,2059,4127,5.6,16.7,7218,2263,4955,6.1,19.5,-1032,-2.8,33.4,0,170,171,923
1994,36220,2569,2895,36289,36408,312,10.9,251,8.8,6245,1999,4246,5.5,17.2,6483,2719,3764,7.5,17.8,-238,-0.6,34.4,0,153,153,1900
1995,36220,2570,2892,35575,35819,285,9.9,268,9.3,5301,2039,3262,5.7,14.8,5788,1972,3816,5.5,16.2,-487,-1.4,29.6,0,191,191,1292
1996,36220,2575,2876,36323,35928,249,8.6,255,8.8,5551,1725,3826,4.8,15.5,4760,1636,3124,4.6,13.2,791,2.3,26.4,0,154,154,747
1997,36220,2593,2918,38454,37445,342,11.8,303,10.4,8711,3042,5669,8.1,23.3,6693,2831,3862,7.6,17.9,2018,5.4,35.8,0,172,172,1606
1998,36220,2621,2938,40601,39477,294,10,266,9.1,7114,2007,5107,5.1,18,4866,1856,3010,4.7,12.3,2248,5.7,24.6,0,162,162,883
1999,36220,2564,2880,41553,41875,256,8.8,302,10.4,7771,2716,5055,6.5,18.6,8415,2392,6023,5.7,20.1,-644,-1.5,37.2,0,189,189,938
2000,36220,2529,2838,39768,40621,249,8.7,284,9.9,5878,1698,4180,4.2,14.5,7583,2243,5340,5.5,18.7,-1705,-4.2,29,0,152,152,679
2001,36220,2528,2845,41927,40970,244,8.6,270,9.5,7574,2727,4847,6.7,18.5,5660,1838,3822,4.5,13.8,1914,4.7,27.6,0,164,164,979
2002,36220,2545,2872,41966,41848,348,12.2,311,10.9,7209,3284,3925,7.8,17.2,6973,2810,4163,6.7,16.7,236,0.5,33.4,0,161,161,1243
2003,36220,2546,2876,42290,41835,281,9.8,223,7.8,6114,2037,4077,4.9,14.6,5204,1382,3822,3.3,12.4,910,2.2,24.8,0,163,163,970
2004,36220,2531,2871,43035,42535,258,9,237,8.3,6614,2175,4439,5.1,15.5,5613,1723,3890,4.1,13.2,1001,2.3,26.4,0,158,158,904
2005,36220,2560,2909,45592,44283,257,8.9,210,7.3,7617,2826,4791,6.4,17.2,4999,1055,3944,2.4,11.3,2618,5.9,22.6,0,144,144,600
2006,36220,2591,2956,50480,47970,273,9.3,205,7,9580,2880,6700,6,20,4560,1721,2839,3.6,9.5,5020,10.5,19,0,140,140,1181
2007,36220,2696,3068,51983,51253,304,10.1,198,6.6,9368,2948,6420,5.8,18.3,7907,2752,5155,5.4,15.4,1461,2.9,30.8,0,124,124,1010
2008,36220,2698,3084,56593,54161,261,8.5,209,6.8,12020,4615,7405,8.5,22.2,7156,1491,5665,2.8,13.2,4864,9,26.4,0,157,157,882
2009,36220,2706,3104,53696,54942,255,8.3,215,7,6421,2321,4100,4.2,11.7,8913,1495,7418,2.7,16.2,-2492,-4.5,23.4,0,150,150,956
2010,36220,2655,3057,51271,52330,210,6.8,235,7.6,6536,2590,3946,4.9,12.5,8654,1700,6954,3.2,16.5,-2118,-4,25,0,168,168,1020
2011,36220,2665,3065,55150,52936,261,8.6,228,7.5,10071,2734,7337,5.2,19,5643,2523,3120,4.8,10.7,4428,8.3,21.4,0,158,158,1796
2012,36220,2789,3199,60409,57740,338,10.8,219,7,12972,3277,9695,5.7,22.5,7633,3562,4071,6.2,13.2,5339,9.3,26.4,0,134,134,1405
2013,36220,2887,3305,65845,63093,332,10.2,228,7,11852,3109,8743,4.9,18.8,6348,1645,4703,2.6,10.1,5504,8.7,20.2,0,161,161,1067
2014,36220,2941,3382,66814,66136,337,10.1,237,7.1,10424,3369,7055,5.1,15.8,9067,2621,6446,4,13.7,1357,2.1,27.4,0,176,176,1864
1977,36260,3569,3923,47549,44940,814,21.5,538,14.2,13345,5672,7673,12.6,29.7,8126,4094,4032,9.1,18.1,5219,11.6,36.2,0,373,373,2627
1978,36260,3465,3812,49680,48359,682,17.6,743,19.2,12348,5022,7326,10.4,25.5,9705,4614,5091,9.5,20.1,2643,5.4,40.2,0,428,429,2113
1979,36260,3922,4289,54456,52174,763,18.8,314,7.8,12590,5695,6895,10.9,24.1,8025,2182,5843,4.2,15.4,4565,8.7,30.8,1,3,3,
1980,36260,3895,4286,55180,54737,680,15.9,653,15.2,11550,5143,6407,9.4,21.1,10663,3740,6923,6.8,19.5,887,1.6,39,0,462,466,2322
1981,36260,3821,4268,56721,55763,714,16.7,669,15.7,13156,7243,5913,13,23.6,11240,4458,6782,8,20.2,1916,3.4,40.4,0,398,399,1609
1982,36260,3877,4404,56168,56466,737,17,544,12.5,11306,5969,5337,10.6,20,11901,5106,6795,9,21.1,-595,-1.1,40,0,308,308,2543
1983,36260,3944,4492,56370,56240,532,12,511,11.5,10057,3595,6462,6.4,17.9,9797,3051,6746,5.4,17.4,260,0.5,34.8,0,324,324,2070
1984,36260,4119,4675,60973,58668,656,14.3,476,10.4,12674,4322,8352,7.4,21.6,8064,3239,4825,5.5,13.7,4610,7.9,27.4,0,294,294,1409
1985,36260,4165,4724,64058,62609,685,14.6,639,13.6,12813,4162,8651,6.6,20.5,9914,4596,5318,7.3,15.8,2899,4.7,31.6,0,410,410,2622
1986,36260,4259,4838,68118,65831,721,15.1,588,12.3,14907,6083,8824,9.2,22.6,10332,4719,5613,7.2,15.7,4575,6.9,31.4,0,374,374,3312
1987,36260,4353,4979,68999,68613,753,15.3,595,12.1,12387,4725,7662,6.9,18.1,11615,4232,7383,6.2,16.9,772,1.2,33.8,0,338,340,2185
1988,36260,4297,4962,69544,68520,681,13.7,648,13.1,13517,5846,7671,8.5,19.7,11469,4115,7354,6,16.7,2048,3,33.4,0,431,431,2679
1989,36260,4267,4967,75046,72539,626,12.6,616,12.4,15027,5743,9284,7.9,20.7,10013,4462,5551,6.2,13.8,5014,6.9,27.6,0,412,421,2366
1990,36260,4401,5113,80014,77676,634,12.6,452,9,14869,5157,9712,6.6,19.1,10192,4075,6117,5.2,13.1,4677,6,26.2,0,290,290,1804
1991,36260,4515,5261,83875,81851,688,13.3,531,10.2,16112,6543,9569,8,19.7,12063,4450,7613,5.4,14.7,4049,5,29.4,0,315,319,2812
1992,36260,4687,5474,89277,86592,750,14,524,9.7,18281,8296,9985,9.6,21.1,12910,4692,8218,5.4,14.9,5371,6.2,29.8,0,339,344,2409
1993,36260,4832,5605,95219,92237,714,12.9,566,10.2,18323,6378,11945,6.9,19.9,12359,4410,7949,4.8,13.4,5964,6.5,26.8,0,369,374,2148
1994,36260,5154,5954,101486,98341,901,15.6,538,9.3,19364,6718,12646,6.8,19.7,13074,4990,8084,5.1,13.3,6290,6.4,26.6,0,357,358,2546
1995,36260,5378,6215,107714,104483,879,14.5,600,9.9,19837,6851,12986,6.6,19,13374,4296,9078,4.1,12.8,6463,6.2,25.6,0,397,398,2502
1996,36260,5671,6552,116228,111962,1002,15.7,645,10.1,23533,9785,13748,8.7,21,15001,4422,10579,3.9,13.4,8532,7.6,26.8,0,453,453,2673
1997,36260,5986,6933,121201,118613,1156,17.1,773,11.4,25373,11642,13731,9.8,21.4,20196,8154,12042,6.9,17,5177,4.4,34,0,472,472,3259
1998,36260,6275,7245,124983,123036,1133,16,802,11.3,25823,12210,13613,9.9,21,21928,7039,14889,5.7,17.8,3895,3.2,35.6,0,527,527,3762
1999,36260,6526,7541,131076,127952,1166,15.8,864,11.7,24385,10093,14292,7.9,19.1,18136,7418,10718,5.8,14.2,6249,4.9,28.4,0,576,576,4131
2000,36260,6703,7763,133848,132460,1074,14,847,11.1,23213,8720,14493,6.6,17.5,20437,7527,12910,5.7,15.4,2776,2.1,30.8,0,542,542,3253
2001,36260,6886,7988,131134,132881,1134,14.4,970,12.3,23491,10796,12695,8.1,17.7,26985,7066,19919,5.3,20.3,-3494,-2.6,35.4,0,570,570,3562
2002,36260,7061,8141,127724,128994,1226,15.2,1047,13,22459,10286,12173,8,17.4,24998,8798,16200,6.8,19.4,-2539,-2,34.8,0,566,569,3772
2003,36260,7376,8477,130760,128715,1372,16.6,909,11,23195,10076,13119,7.8,18,19104,7123,11981,5.5,14.8,4091,3.2,29.6,0,596,597,4277
2004,36260,7701,8831,135177,132526,1363,15.8,913,10.6,23155,9948,13207,7.5,17.5,17852,6934,10918,5.2,13.5,5303,4,27,0,603,603,3863
2005,36260,8006,9215,139602,136843,1395,15.5,931,10.3,22444,9523,12921,7,16.4,16925,6299,10626,4.6,12.4,5519,4,24.8,0,630,630,4153
2006,36260,8342,9622,147920,143578,1527,16.2,1033,11,26078,11604,14474,8.1,18.2,17393,7001,10392,4.9,12.1,8685,6.1,24.2,0,690,704,4760
2007,36260,8809,10156,153782,150587,1542,15.6,1020,10.3,27556,10491,17065,7,18.3,21166,8020,13146,5.3,14.1,6390,4.2,28.2,0,687,691,4093
2008,36260,8856,10219,151470,152181,1234,12.1,1095,10.8,24875,9400,15475,6.2,16.3,26297,7881,18416,5.2,17.3,-1422,-1,32.6,0,763,763,4701
2009,36260,8470,9882,144473,147549,1077,10.7,1320,13.2,19628,9740,9888,6.6,13.3,25779,7046,18733,4.8,17.5,-6151,-4.2,26.6,0,862,862,4195
2010,36260,8363,9774,140491,141938,1085,11.1,1126,11.5,19193,7552,11641,5.3,13.5,22087,6855,15232,4.8,15.6,-2894,-2.1,27,0,711,713,4840
2011,36260,8329,9717,139029,139576,1052,10.8,1071,11,18099,7309,10790,5.2,13,19192,5530,13662,4,13.8,-1093,-0.8,26,0,673,676,3577
2012,36260,8497,9933,149416,144192,1198,12.2,963,9.8,26478,9204,17274,6.4,18.4,16030,5397,10633,3.7,11.1,10448,7.3,22.2,0,600,602,3431
2013,36260,8654,10148,152408,149569,1115,11.1,916,9.2,24425,7631,16794,5.1,16.3,18746,5579,13167,3.7,12.5,5679,3.8,25,0,578,578,3921
2014,36260,8827,10317,151686,151644,1178,11.6,934,9.2,21136,6893,14243,4.5,13.9,21051,7019,14032,4.6,13.9,85,0,27.8,0,610,613,3711
1977,36420,15594,17804,246829,239142,3284,18.9,2361,13.6,54999,26888,28111,11.2,23,39624,16895,22729,7.1,16.6,15375,6.4,33.2,0,1705,1710,10534
1978,36420,14891,17193,260140,252979,2737,15.6,3148,18,55627,20479,35148,8.1,22,41305,22089,19216,8.7,16.3,14322,5.7,32.6,0,1901,1906,9608
1979,36420,16525,19027,296692,278795,3177,17.5,1481,8.2,69927,22004,47923,7.9,25.1,34132,10005,24127,3.6,12.2,35795,12.9,24.4,0,27,31,335
1980,36420,17054,19647,308468,302331,3126,16.2,2416,12.5,68539,30476,38063,10.1,22.7,56264,17236,39028,5.7,18.6,12275,4.1,37.2,0,1753,1759,9623
1981,36420,17238,19830,319704,311061,3169,16.1,2807,14.2,70609,30406,40203,9.8,22.7,53322,21803,31519,7,17.1,17287,5.6,34.2,0,1807,1812,10763
1982,36420,18461,21443,348546,334957,4087,19.8,2359,11.4,85039,35187,49852,10.5,25.4,57860,18450,39410,5.5,17.3,27179,8.1,34.6,0,1362,1362,8833
1983,36420,18813,21842,325064,334066,3201,14.8,2856,13.2,66658,28636,38022,8.6,20,84661,25033,59628,7.5,25.3,-18003,-5.3,40,0,2098,2103,15748
1984,36420,19223,22363,329034,328295,3438,15.6,2901,13.1,62545,25706,36839,7.8,19.1,61067,24406,36661,7.4,18.6,1478,0.5,37.2,0,2047,2050,12942
1985,36420,19332,22564,333484,335360,3303,14.7,3111,13.8,56589,22458,34131,6.7,16.9,60341,22501,37840,6.7,18,-3752,-1.1,33.8,0,2156,2157,12307
1986,36420,18859,22275,326708,329882,3214,14.3,3354,15,59877,28503,31374,8.6,18.2,66224,25088,41136,7.6,20.1,-6347,-1.9,36.4,0,2353,2358,14425
1987,36420,18258,21703,321419,327878,3104,14.1,3548,16.1,59047,26936,32111,8.2,18,71964,31835,40129,9.7,21.9,-12917,-3.9,36,0,2257,2295,15070
1988,36420,17680,21222,314775,312526,2824,13.2,3117,14.5,60831,23179,37652,7.4,19.5,56332,22989,33343,7.4,18,4499,1.5,36,0,2021,2021,11600
1989,36420,17778,21333,326218,320916,2720,12.8,2653,12.5,60974,22538,38436,7,19,50369,22430,27939,7,15.7,10605,3.3,31.4,0,1780,1791,13097
1990,36420,18007,21562,340700,333522,2777,13,2428,11.3,57337,21084,36253,6.3,17.2,42980,17405,25575,5.2,12.9,14357,4.3,25.8,0,1611,1615,9498
1991,36420,18843,22517,336034,338192,3073,13.9,2155,9.8,58895,27014,31881,8,17.4,63211,18962,44249,5.6,18.7,-4316,-1.3,34.8,0,1342,1358,11111
1992,36420,19162,23000,339883,337562,3090,13.6,2534,11.1,60772,22526,38246,6.7,18,56130,22422,33708,6.6,16.6,4642,1.4,33.2,0,1668,1702,12608
1993,36420,19776,23478,350858,345113,2944,12.7,2447,10.5,59210,21820,37390,6.3,17.2,47720,17486,30234,5.1,13.8,11490,3.4,27.6,0,1608,1611,9436
1994,36420,20355,24146,361289,356139,3087,13,2353,9.9,58391,22167,36224,6.2,16.4,48090,17913,30177,5,13.5,10301,2.9,27,0,1603,1605,9583
1995,36420,20736,24615,376229,368637,2948,12.1,2414,9.9,62988,22078,40910,6,17.1,47803,18182,29621,4.9,13,15185,4.1,26,0,1661,1663,8653
1996,36420,21174,25101,392815,384688,3116,12.5,2571,10.3,68550,30226,38324,7.9,17.8,52295,19932,32363,5.2,13.6,16255,4.2,27.2,0,1736,1738,10580
1997,36420,21557,25676,403274,398055,3482,13.7,2872,11.3,75531,31328,44203,7.9,19,65092,23408,41684,5.9,16.4,10439,2.6,32.8,0,1791,1791,12153
1998,36420,21686,25926,415639,409186,3186,12.3,2866,11.1,71680,28817,42863,7,17.5,58774,23422,35352,5.7,14.4,12906,3.1,28.8,0,1888,1889,10463
1999,36420,21750,26083,419849,417886,3200,12.3,2934,11.3,71773,27063,44710,6.5,17.2,67846,27549,40297,6.6,16.2,3927,1,32.4,0,1882,1882,12515
2000,36420,21826,26279,442812,432107,3097,11.8,2964,11.3,81968,33317,48651,7.7,19,60557,24408,36149,5.6,14,21411,5,28,0,1727,1727,9961
2001,36420,21879,26545,445794,445374,3027,11.4,3014,11.4,76402,31204,45198,7,17.2,75563,30135,45428,6.8,17,839,0.2,34,0,1755,1755,10892
2002,36420,22313,26857,439149,439874,3519,13.2,3186,11.9,82747,34241,48506,7.8,18.8,84196,31486,52710,7.2,19.1,-1449,-0.3,37.6,0,1600,1607,13548
2003,36420,22635,27179,437188,434430,3196,11.9,2402,8.9,72195,22217,49978,5.1,16.6,66678,20298,46380,4.7,15.3,5517,1.3,30.6,0,1717,1717,11429
2004,36420,23119,27696,448736,441445,3124,11.4,2383,8.7,75753,25849,49904,5.9,17.2,61171,19239,41932,4.4,13.9,14582,3.3,27.8,0,1584,1598,9386
2005,36420,23527,28326,457668,452151,3325,11.9,2443,8.7,71869,31270,40599,6.9,15.9,60834,21638,39196,4.8,13.5,11035,2.4,27,0,1670,1670,13667
2006,36420,23747,28677,482738,468716,3389,11.9,2756,9.7,87060,35300,51760,7.5,18.6,59018,22627,36391,4.8,12.6,28042,6,25.2,0,1852,1865,11464
2007,36420,24233,29486,488957,483639,3515,12.1,2644,9.1,82922,30396,52526,6.3,17.1,72286,20587,51699,4.3,14.9,10636,2.2,29.8,0,1701,1707,11329
2008,36420,24484,29867,488960,487204,3228,10.9,2612,8.8,71563,24829,46734,5.1,14.7,68050,19934,48116,4.1,14,3513,0.7,28,0,1847,1851,11883
2009,36420,24386,29761,471980,478633,2826,9.5,2718,9.1,60515,21886,38629,4.6,12.6,73821,23675,50146,4.9,15.4,-13306,-2.8,25.2,0,1873,1876,13952
2010,36420,24365,29778,459850,464868,2819,9.5,2650,8.9,56340,23748,32592,5.1,12.1,66378,18069,48309,3.9,14.3,-10038,-2.2,24.2,0,1750,1759,10917
2011,36420,24364,29895,470708,464397,2845,9.6,2542,8.5,66194,20231,45963,4.4,14.3,53573,17021,36552,3.7,11.5,12621,2.8,23,0,1712,1713,10649
2012,36420,24822,30501,485272,476807,3101,10.3,2514,8.3,73700,24758,48942,5.2,15.5,56770,17534,39236,3.7,11.9,16930,3.6,23.8,0,1559,1568,9000
2013,36420,25213,30934,505131,495278,2875,9.4,2512,8.2,71571,23222,48349,4.7,14.5,51865,15134,36731,3.1,10.5,19706,4,21,0,1606,1625,10059
2014,36420,25494,31275,519762,511357,3118,10.1,2603,8.4,76197,21119,55078,4.1,14.9,59386,17771,41615,3.5,11.6,16811,3.3,23.2,0,1782,1784,9573
1977,36500,1848,1944,19445,18638,400,21.5,222,12,4521,2276,2245,12.2,24.3,2907,1422,1485,7.6,15.6,1614,8.7,31.2,0,153,153,916
1978,36500,1952,2059,23017,21220,427,21.3,305,15.2,6609,2706,3903,12.8,31.1,3015,1701,1314,8,14.2,3594,16.9,28.4,0,209,209,1078
1979,36500,2140,2279,26359,24647,497,22.9,252,11.6,7348,3408,3940,13.8,29.8,3924,1488,2436,6,15.9,3424,13.9,31.8,0,168,168,1009
1980,36500,2192,2339,26032,26171,417,18.1,336,14.6,4997,2199,2798,8.4,19.1,5274,1862,3412,7.1,20.2,-277,-1.1,38.2,0,223,223,1197
1981,36500,2111,2256,25106,24835,364,15.9,383,16.8,4962,2356,2606,9.5,20,4420,1696,2724,6.8,17.8,542,2.2,35.6,0,234,234,818
1982,36500,2164,2331,23966,24432,425,18.5,313,13.6,4563,2423,2140,9.9,18.7,5494,2100,3394,8.6,22.5,-931,-3.8,37.4,0,172,172,1176
1983,36500,2259,2424,26050,25057,350,14.7,292,12.3,5965,3020,2945,12.1,23.8,3978,1450,2528,5.8,15.9,1987,7.9,31.8,0,173,175,593
1984,36500,2456,2629,27072,26513,483,19.1,278,11,6025,2365,3660,8.9,22.7,4907,1694,3213,6.4,18.5,1118,4.2,37,0,179,179,762
1985,36500,2534,2707,29060,28698,428,16,363,13.6,5864,2453,3411,8.5,20.4,5140,2079,3061,7.2,17.9,724,2.5,35.8,0,238,238,1354
1986,36500,2653,2824,31578,30226,458,16.6,334,12.1,6968,2967,4001,9.8,23.1,4264,1953,2311,6.5,14.1,2704,9,28.2,0,229,229,1407
1987,36500,2740,2956,33311,32470,545,18.8,407,14.1,8028,3335,4693,10.3,24.7,6346,2719,3627,8.4,19.5,1682,5.2,39,0,270,273,1504
1988,36500,2812,3041,33130,32519,512,17.1,370,12.4,7529,3252,4277,10,23.2,6307,2681,3626,8.2,19.4,1222,3.8,38.8,0,245,245,1441
1989,36500,2430,2663,31017,32039,369,12.9,738,25.9,6298,2707,3591,8.4,19.7,8342,5093,3249,15.9,26,-2044,-6.3,39.4,0,227,227,1321
1990,36500,3060,3322,38696,34827,917,30.7,242,8.1,11677,7147,4530,20.5,33.5,3939,1268,2671,3.6,11.3,7738,22.2,22.6,0,150,150,733
1991,36500,3248,3545,40013,39353,566,16.5,342,10,7877,3288,4589,8.4,20,6557,1944,4613,4.9,16.7,1320,3.3,33.4,0,204,205,1024
1992,36500,3395,3704,42788,41419,550,15.1,377,10.4,9157,2778,6379,6.7,22.1,6418,2276,4142,5.5,15.5,2739,6.6,31,0,241,242,1129
1993,36500,3525,3844,43865,43170,546,14.5,376,10,7606,2844,4762,6.6,17.6,6215,2101,4114,4.9,14.4,1391,3.2,28.8,0,249,249,1227
1994,36500,3670,3999,43677,43681,599,15.3,416,10.6,8439,3934,4505,9,19.3,8446,4685,3761,10.7,19.3,-7,0,38.6,0,287,288,3868
1995,36500,3733,4060,43715,43575,592,14.7,493,12.2,6950,2775,4175,6.4,15.9,6669,2623,4046,6,15.3,281,0.6,30.6,0,339,344,1687
1996,36500,3837,4178,47555,46192,617,15,494,12,9066,4298,4768,9.3,19.6,6340,2519,3821,5.5,13.7,2726,5.9,27.4,0,326,326,1296
1997,36500,3919,4264,48736,48371,640,15.1,543,12.8,9005,3645,5360,7.5,18.6,8275,3199,5076,6.6,17.1,730,1.5,34.2,0,331,331,1661
1998,36500,3928,4284,50113,49378,568,13.3,537,12.6,8703,3265,5438,6.6,17.6,7232,2891,4341,5.9,14.6,1471,3,29.2,0,358,358,2014
1999,36500,4005,4376,51562,51038,629,14.5,530,12.2,8589,3657,4932,7.2,16.8,7541,2988,4553,5.9,14.8,1048,2,29.6,0,355,355,1648
2000,36500,4013,4387,52618,51811,511,11.7,512,11.7,8238,3010,5228,5.8,15.9,6624,2053,4571,4,12.8,1614,3.1,25.6,0,313,313,1168
2001,36500,4071,4474,53667,53223,616,13.9,563,12.7,8471,3560,4911,6.7,15.9,7582,2800,4782,5.3,14.2,889,1.7,28.4,0,338,338,1378
2002,36500,4168,4578,54937,54274,662,14.6,551,12.2,9890,4356,5534,8,18.2,8563,2516,6047,4.6,15.8,1327,2.4,31.6,0,306,306,1186
2003,36500,4292,4714,56575,55337,661,14.3,446,9.6,9622,3868,5754,7,17.4,7145,2781,4364,5,12.9,2477,4.5,25.8,0,299,299,1089
2004,36500,4378,4799,59841,58080,623,13.1,478,10.1,10148,3114,7034,5.4,17.5,6626,2507,4119,4.3,11.4,3522,6.1,22.8,0,320,320,1725
2005,36500,4501,4962,60623,60080,701,14.4,481,9.9,9187,3815,5372,6.3,15.3,8101,2824,5277,4.7,13.5,1086,1.8,27,0,343,343,1489
2006,36500,4640,5137,63815,62129,706,14,495,9.8,10574,4302,6272,6.9,17,7201,2197,5004,3.5,11.6,3373,5.4,23.2,0,350,350,1422
2007,36500,4742,5260,66236,64878,724,13.9,596,11.5,11877,5253,6624,8.1,18.3,9161,3449,5712,5.3,14.1,2716,4.2,28.2,0,384,386,1690
2008,36500,4844,5346,67422,66638,669,12.7,518,9.8,10196,4453,5743,6.7,15.3,8627,2558,6069,3.8,12.9,1569,2.4,25.8,0,372,372,1685
2009,36500,4687,5216,64823,65985,496,9.4,592,11.2,7719,2612,5107,4,11.7,10043,2936,7107,4.4,15.2,-2324,-3.5,23.4,0,416,416,1946
2010,36500,4661,5192,63436,63983,507,9.8,509,9.8,7429,2721,4708,4.3,11.6,8523,2495,6028,3.9,13.3,-1094,-1.7,23.2,0,347,347,1746
2011,36500,4554,5105,63794,63450,499,9.7,521,10.2,7843,3645,4198,5.7,12.4,7154,1974,5180,3.1,11.3,689,1.1,22.6,0,338,338,1276
2012,36500,4538,5107,66458,64727,518,10.2,530,10.4,11325,2928,8397,4.5,17.5,7863,2198,5665,3.4,12.1,3462,5.4,24.2,0,327,330,1281
2013,36500,4607,5192,64219,65305,525,10.2,461,9,7825,2242,5583,3.4,12,9997,4613,5384,7.1,15.3,-2172,-3.3,24,0,300,301,3739
2014,36500,4678,5255,65797,64873,537,10.3,441,8.5,8059,2572,5487,4,12.4,6210,1773,4437,2.7,9.6,1849,2.8,19.2,0,310,310,1078
1977,36540,11145,12819,211099,204752,2054,16.3,1558,12.4,46607,18833,27774,9.2,22.8,33912,12950,20962,6.3,16.6,12695,6.2,33.2,0,1051,1052,7510
1978,36540,11361,13137,216923,213945,1803,13.9,1480,11.4,39402,14474,24928,6.8,18.4,33446,12336,21110,5.8,15.6,5956,2.8,31.2,0,1032,1038,6020
1979,36540,11563,13380,230126,223412,1768,13.3,1453,11,39535,12820,26715,5.7,17.7,26106,10098,16008,4.5,11.7,13429,6,23.4,0,994,995,4878
1980,36540,11537,13379,233188,231536,1585,11.8,1536,11.5,38369,12148,26221,5.2,16.6,35064,10342,24722,4.5,15.1,3305,1.5,30.2,0,1074,1074,5580
1981,36540,11234,13009,232609,231264,1559,11.9,1768,13.4,39896,17939,21957,7.8,17.3,37205,14503,22702,6.3,16.1,2691,1.2,32.2,0,1034,1034,5490
1982,36540,11264,13233,227593,229554,1828,13.9,1455,11.1,35323,16094,19229,7,15.4,39244,11176,28068,4.9,17.1,-3921,-1.7,30.8,0,854,854,5664
1983,36540,11636,13601,228798,225583,1584,11.8,1336,10,40280,19494,20786,8.6,17.9,33850,13160,20690,5.8,15,6430,2.9,30,0,843,845,6473
1984,36540,11719,13748,238802,237037,1728,12.6,1590,11.6,38836,14614,24222,6.2,16.4,35306,12149,23157,5.1,14.9,3530,1.5,29.8,0,919,921,5500
1985,36540,12152,14193,244756,240777,1873,13.4,1481,10.6,42521,17376,25145,7.2,17.7,34563,17106,17457,7.1,14.4,7958,3.3,28.8,0,971,976,8905
1986,36540,12396,14455,250650,247299,1762,12.3,1467,10.2,42772,17583,25189,7.1,17.3,36069,11071,24998,4.5,14.6,6703,2.7,29.2,0,920,920,5505
1987,36540,12599,14848,261769,257865,2080,14.2,1634,11.1,49148,19190,29958,7.4,19.1,41339,18782,22557,7.3,16,7809,3.1,32,0,1017,1027,7216
1988,36540,12609,15005,270027,264727,1859,12.5,1586,10.7,47430,18051,29379,6.8,17.9,36830,14137,22693,5.3,13.9,10600,4,27.8,0,1011,1011,5877
1989,36540,12685,15195,281582,276030,1794,11.9,1615,10.7,47084,16345,30739,5.9,17.1,35979,13784,22195,5,13,11105,4.1,26,0,1043,1048,7888
1990,36540,12938,15485,293272,287228,1817,11.8,1451,9.5,45005,15987,29018,5.6,15.7,32916,10726,22190,3.7,11.5,12089,4.2,23,0,926,927,5973
1991,36540,13189,15901,299063,296248,1892,12.1,1494,9.5,43773,17182,26591,5.8,14.8,38143,10688,27455,3.6,12.9,5630,1.9,25.8,0,929,943,5900
1992,36540,13457,16216,299227,297246,1926,12,1562,9.7,44427,16312,28115,5.5,14.9,40465,12914,27551,4.3,13.6,3962,1.3,27.2,0,926,939,6091
1993,36540,13642,16346,309373,304311,1638,10.1,1473,9,45534,13030,32504,4.3,15,35412,11537,23875,3.8,11.6,10122,3.4,23.2,0,923,928,5503
1994,36540,13833,16596,314839,311645,1875,11.4,1563,9.5,47832,17936,29896,5.8,15.3,41444,15412,26032,4.9,13.3,6388,2,26.6,0,984,985,6759
1995,36540,14027,16844,330021,322239,1812,10.8,1501,9,53302,15986,37316,5,16.5,37738,14238,23500,4.4,11.7,15564,4.8,23.4,0,962,965,5223
1996,36540,14195,17011,347456,340621,1808,10.7,1626,9.6,52723,21206,31517,6.2,15.5,39053,12844,26209,3.8,11.5,13670,4,23,0,1018,1018,6471
1997,36540,14461,17315,347828,348044,2106,12.3,1808,10.5,58682,24362,34320,7,16.9,59113,18110,41003,5.2,17,-431,-0.1,33.8,0,1011,1011,8161
1998,36540,14532,17494,358596,353051,1996,11.5,1768,10.2,58076,21100,36976,6,16.4,46985,18462,28523,5.2,13.3,11091,3.1,26.6,0,1119,1119,6500
1999,36540,14588,17637,372857,365692,1906,10.8,1773,10.1,67288,27639,39649,7.6,18.4,52958,23255,29703,6.4,14.5,14330,3.9,29,0,1088,1088,12454
2000,36540,14745,18036,379635,376209,2106,11.8,1710,9.6,60485,24349,36136,6.5,16.1,53633,19484,34149,5.2,14.3,6852,1.8,28.6,0,1018,1018,10778
2001,36540,14901,18298,374365,377306,2027,11.1,1898,10.4,55844,23092,32752,6.1,14.8,61726,22940,38786,6.1,16.4,-5882,-1.6,29.6,0,994,994,6618
2002,36540,15056,18515,383099,378799,2213,12,1990,10.8,62187,22523,39664,5.9,16.4,53587,16602,36985,4.4,14.1,8600,2.3,28.2,0,936,938,4906
2003,36540,15195,18654,389672,382232,2052,11.1,1594,8.6,67620,22999,44621,6,17.7,52740,13919,38821,3.6,13.8,14880,3.9,27.6,0,1021,1022,6418
2004,36540,15375,18845,396618,391718,2011,10.8,1618,8.7,51562,19214,32348,4.9,13.2,41762,12588,29174,3.2,10.7,9800,2.5,21.4,0,972,988,6610
2005,36540,15669,19203,397513,395348,2128,11.2,1577,8.3,63246,22048,41198,5.6,16,58916,13608,45308,3.4,14.9,4330,1.1,29.8,0,1058,1060,7990
2006,36540,15935,19634,410412,402290,2311,11.9,1698,8.8,58626,23992,34634,6,14.6,42381,12405,29976,3.1,10.5,16245,4.1,21,0,1085,1090,8077
2007,36540,16083,19942,414197,411522,2258,11.4,1925,9.7,59376,21991,37385,5.3,14.4,54025,17139,36886,4.2,13.1,5351,1.3,26.2,0,1137,1143,8514
2008,36540,15996,19949,419416,415820,1986,10,1792,9,61730,20293,41437,4.9,14.8,54537,13840,40697,3.3,13.1,7193,1.7,26.2,0,1174,1174,6728
2009,36540,15853,19813,406463,413072,1759,8.9,1771,8.9,46676,17045,29631,4.1,11.3,59893,17217,42676,4.2,14.5,-13217,-3.2,22.6,0,1111,1120,7799
2010,36540,15821,19874,401093,402918,1846,9.3,1657,8.4,43704,16577,27127,4.1,10.8,47354,9743,37611,2.4,11.8,-3650,-1,21.6,0,993,1007,5978
2011,36540,15670,19816,394065,396777,1838,9.3,1704,8.6,47872,14225,33647,3.6,12.1,53296,23198,30098,5.8,13.4,-5424,-1.3,24.2,0,999,1005,7650
2012,36540,15918,19993,402754,397802,1920,9.7,1765,8.9,51963,15945,36018,4,13.1,42059,12242,29817,3.1,10.6,9904,2.5,21.2,0,948,959,5470
2013,36540,16003,20169,408481,404965,1826,9.1,1613,8.1,49427,13962,35465,3.4,12.2,42394,13713,28681,3.4,10.5,7033,1.7,21,0,1009,1012,6912
2014,36540,16217,20391,413980,409862,1948,9.7,1528,7.6,47883,13918,33965,3.4,11.7,39646,14782,24864,3.6,9.7,8237,2,19.4,0,953,959,5644
1977,36740,12291,14418,216099,204905,2918,20.7,2182,15.5,58980,31765,27215,15.5,28.8,36591,16319,20272,8,17.9,22389,10.9,35.8,0,1496,1501,10292
1978,36740,13096,15320,230980,223511,2935,19.7,2037,13.7,53596,19697,33899,8.8,24,38658,15268,23390,6.8,17.3,14938,6.7,34.6,0,1415,1417,9726
1979,36740,13793,16158,252834,241692,2924,18.6,1990,12.6,61185,22860,38325,9.5,25.3,38901,17620,21281,7.3,16.1,22284,9.2,32.2,0,1421,1425,10680
1980,36740,14401,16877,273186,264121,2927,17.7,2120,12.8,56827,21225,35602,8,21.5,38696,15332,23364,5.8,14.7,18131,6.8,29.4,0,1538,1540,9512
1981,36740,14813,17438,285867,279202,3156,18.4,2481,14.5,60989,25775,35214,9.2,21.8,47659,19639,28020,7,17.1,13330,4.7,34.2,0,1557,1562,9307
1982,36740,15688,18682,299313,292781,3658,20.2,2294,12.7,61753,28450,33303,9.7,21.1,48688,18070,30618,6.2,16.6,13065,4.5,33.2,0,1288,1291,8767
1983,36740,16410,19498,321813,310840,3297,17.3,2571,13.5,71145,28644,42501,9.2,22.9,49201,19702,29499,6.3,15.8,21944,7.1,31.6,0,1535,1541,9150
1984,36740,17996,21239,361619,342262,4078,20,2342,11.5,85894,34256,51638,10,25.1,47181,18930,28251,5.5,13.8,38713,11.3,27.6,0,1576,1580,8865
1985,36740,19295,22764,386303,374136,4217,19.2,2646,12,90298,42677,47621,11.4,24.1,65963,23530,42433,6.3,17.6,24335,6.5,35.2,0,1738,1744,11428
1986,36740,20535,24271,418020,401964,4570,19.4,2970,12.6,97054,44217,52837,11,24.1,64942,26068,38874,6.5,16.2,32112,7.9,32.4,0,1964,1968,13358
1987,36740,21535,25840,439399,428883,5090,20.3,3409,13.6,101102,45015,56087,10.5,23.6,80070,35881,44189,8.4,18.7,21032,4.9,37.4,0,2240,2242,16194
1988,36740,22107,26759,467266,453018,4713,17.9,3672,14,102862,40625,62237,9,22.7,74365,31134,43231,6.9,16.4,28497,6.3,32.8,0,2579,2579,16310
1989,36740,23063,28047,507383,488449,4677,17.1,3461,12.6,114059,46174,67885,9.5,23.4,76191,29607,46584,6.1,15.6,37868,7.8,31.2,0,2322,2325,16153
1990,36740,23987,29202,540825,523585,4765,16.7,3398,11.9,114128,47988,66140,9.2,21.8,79647,32071,47576,6.1,15.2,34481,6.6,30.4,0,2329,2336,16972
1991,36740,24967,30615,531276,535856,5187,17.3,3772,12.6,97906,44296,53610,8.3,18.3,107065,35125,71940,6.6,20,-9159,-1.7,36.6,0,2467,2479,19128
1992,36740,25791,31482,540315,536067,5325,17.1,4348,14,106636,47751,58885,8.9,19.9,98139,44167,53972,8.2,18.3,8497,1.6,36.6,0,2727,2773,22019
1993,36740,26738,32365,562235,551351,5069,15.9,4057,12.7,104419,41126,63293,7.5,18.9,82650,31782,50868,5.8,15,21769,3.9,30,0,2828,2855,16269
1994,36740,27604,33472,586666,574213,5244,15.9,4060,12.3,106609,42423,64186,7.4,18.6,81703,30622,51081,5.3,14.2,24906,4.4,28.4,0,2850,2862,17057
1995,36740,28409,34403,615801,600374,5157,15.2,4082,12,112646,43456,69190,7.2,18.8,81791,33561,48230,5.6,13.6,30855,5.2,27.2,0,2796,2808,16006
1996,36740,29195,35437,654207,635236,5245,15,4136,11.8,145650,70094,75556,11,22.9,107708,43181,64527,6.8,17,37942,5.9,34,0,2752,2753,17027
1997,36740,29849,36579,685820,670211,5848,16.2,4692,13,148997,62593,86404,9.3,22.2,117779,47355,70424,7.1,17.6,31218,4.6,35.2,0,2991,2991,21618
1998,36740,30176,37151,722858,703152,5317,14.4,4643,12.6,153357,61953,91404,8.8,21.8,113944,43287,70657,6.2,16.2,39413,5.6,32.4,0,3070,3070,21073
1999,36740,30744,38150,754182,738610,5604,14.9,4517,12,142950,52801,90149,7.1,19.4,111806,44236,67570,6,15.1,31144,4.3,30.2,0,2892,2892,21417
2000,36740,31049,38757,793506,774484,5519,14.4,4893,12.7,154852,58341,96511,7.5,20,116808,49674,67134,6.4,15.1,38044,4.9,30.2,0,2951,2951,19350
2001,36740,31327,39447,857782,827311,5659,14.5,5260,13.4,192628,84621,108007,10.2,23.3,131685,56621,75064,6.8,15.9,60943,7.4,31.8,0,3043,3044,20430
2002,36740,32269,40358,839984,847358,6407,16.1,5455,13.7,171510,71235,100275,8.4,20.2,186257,76261,109996,9,22,-14747,-1.8,40.4,0,2919,2923,20808
2003,36740,33680,41898,827381,823622,6799,16.6,4383,10.7,153318,62573,90745,7.6,18.6,145801,39722,106079,4.8,17.7,7517,0.9,35.4,0,3015,3021,18816
2004,36740,35999,44465,856516,837828,7895,18.3,4753,11,151747,56531,95216,6.7,18.1,114370,47546,66824,5.7,13.7,37377,4.4,27.4,0,3178,3205,23446
2005,36740,38527,47602,916756,883378,8462,18.4,4781,10.4,196138,83572,112566,9.5,22.2,129381,46825,82556,5.3,14.6,66757,7.6,29.2,0,3279,3280,19996
2006,36740,40413,49955,988952,950092,8458,17.4,5590,11.5,193646,66016,127630,6.9,20.4,115926,43791,72135,4.6,12.2,77720,8.2,24.4,0,3855,3855,23517
2007,36740,41171,51088,974997,979596,7850,15.6,6448,12.8,197859,74399,123460,7.6,20.2,207056,70855,136201,7.2,21.1,-9197,-0.9,40.4,0,4239,4265,24648
2008,36740,40221,50422,952278,960141,6818,13.5,6929,13.7,148681,59808,88873,6.2,15.5,164407,59604,104803,6.2,17.1,-15726,-1.6,31,0,5107,5111,40574
2009,36740,38122,48350,881545,914024,5815,11.8,7202,14.6,111041,53518,57523,5.9,12.1,175999,49645,126354,5.4,19.3,-64958,-7.2,24.2,0,5077,5097,30192
2010,36740,37557,47646,867005,871212,5842,12.2,6130,12.8,122338,55846,66492,6.4,14,130752,45842,84910,5.3,15,-8414,-1,28,0,4085,4089,23897
2011,36740,37652,47793,883402,872537,6249,13.1,5689,12,144247,49799,94448,5.7,16.5,122517,39107,83410,4.5,14,21730,2.5,28,0,3840,3847,18696
2012,36740,38978,49261,905730,894569,6643,13.7,5201,10.7,140080,57234,82846,6.4,15.7,117758,42412,75346,4.7,13.2,22322,2.5,26.4,0,3199,3218,19130
2013,36740,40099,50387,931357,918065,6331,12.8,5272,10.6,133564,49570,83994,5.4,14.5,106980,40158,66822,4.4,11.7,26584,2.8,23.4,0,3381,3388,24077
2014,36740,41061,51614,972706,948152,6933,13.6,5340,10.5,152262,55603,96659,5.9,16.1,103153,36882,66271,3.9,10.9,49109,5.2,21.8,0,3660,3668,21506
1977,36780,2316,2504,45844,45210,351,14.2,280,11.3,6829,2664,4165,5.9,15.1,5560,2485,3075,5.5,12.3,1269,2.8,24.6,0,174,175,1097
1978,36780,2396,2590,49252,47545,335,13.2,244,9.6,8072,2829,5243,6,17,4658,1877,2781,3.9,9.8,3414,7.2,19.6,0,161,161,1072
1979,36780,2435,2638,51404,50310,313,12,255,9.8,7654,2594,5060,5.2,15.2,5466,1868,3598,3.7,10.9,2188,4.3,21.8,0,181,181,795
1980,36780,2418,2620,51864,51626,258,9.8,270,10.3,6564,1773,4791,3.4,12.7,6088,2230,3858,4.3,11.8,476,0.9,23.6,0,194,194,1137
1981,36780,2403,2596,49752,50577,301,11.6,301,11.6,5802,3096,2706,6.1,11.5,7452,2226,5226,4.4,14.7,-1650,-3.2,23,0,170,170,951
1982,36780,2407,2625,51525,50327,310,11.9,249,9.5,7380,2284,5096,4.5,14.7,4984,1620,3364,3.2,9.9,2396,4.8,19.8,0,152,153,914
1983,36780,2462,2672,50234,50970,262,9.9,243,9.2,5666,1904,3762,3.7,11.1,7137,1677,5460,3.3,14,-1471,-2.9,22.2,0,155,155,1020
1984,36780,2546,2752,52775,51466,338,12.5,253,9.3,7655,2274,5381,4.4,14.9,5036,1621,3415,3.1,9.8,2619,5.1,19.6,0,154,154,651
1985,36780,2615,2840,56931,54795,384,13.7,290,10.4,9379,3373,6006,6.2,17.1,5107,2045,3062,3.7,9.3,4272,7.8,18.6,0,203,204,1115
1986,36780,2495,2734,57124,56811,295,10.6,362,13,8184,3535,4649,6.2,14.4,7558,3139,4419,5.5,13.3,626,1.1,26.6,0,201,201,1500
1987,36780,2704,2982,61300,59608,430,15,197,6.9,8247,3132,5115,5.3,13.8,4863,1637,3226,2.7,8.2,3384,5.6,16.4,0,53,53,208
1988,36780,2735,3033,64780,63615,340,11.3,282,9.4,9276,3590,5686,5.6,14.6,6946,2928,4018,4.6,10.9,2330,3.7,21.8,0,203,203,2175
1989,36780,2800,3098,67401,66110,367,12,303,9.9,9065,2633,6432,4,13.7,6483,1906,4577,2.9,9.8,2582,3.9,19.6,0,185,185,1061
1990,36780,2863,3203,70573,68927,373,11.8,248,7.9,11777,6277,5500,9.1,17.1,8485,2757,5728,4,12.3,3292,4.8,24.6,0,177,177,885
1991,36780,2886,3247,71044,70812,326,10.1,283,8.8,7518,2239,5279,3.2,10.6,7053,1886,5167,2.7,10,465,0.6,20,0,192,193,1281
1992,36780,2904,3257,73072,71995,338,10.4,319,9.8,9160,2446,6714,3.4,12.7,7007,2272,4735,3.2,9.7,2153,3,19.4,0,189,190,1026
1993,36780,2942,3314,73799,73518,352,10.7,290,8.8,7842,2619,5223,3.6,10.7,7279,1930,5349,2.6,9.9,563,0.8,19.8,0,199,199,1106
1994,36780,2975,3353,75147,74457,342,10.3,291,8.7,8250,3318,4932,4.5,11.1,6869,1871,4998,2.5,9.2,1381,1.9,18.4,0,204,204,1091
1995,36780,2979,3367,76848,75839,299,8.9,267,8,9411,2840,6571,3.7,12.4,7393,1941,5452,2.6,9.7,2018,2.7,19.4,0,181,181,1082
1996,36780,3010,3395,78033,77639,312,9.2,288,8.5,7722,2454,5268,3.2,9.9,6934,2086,4848,2.7,8.9,788,1,17.8,0,189,189,891
1997,36780,3008,3394,76780,77504,358,10.5,371,10.9,11955,3601,8354,4.6,15.4,13402,7972,5430,10.3,17.3,-1447,-1.9,30.8,0,207,207,1229
1998,36780,2996,3381,79274,78033,294,8.7,303,8.9,10115,3164,6951,4.1,13,7632,2355,5277,3,9.8,2483,3.2,19.6,0,177,177,939
1999,36780,2987,3383,79483,79365,322,9.5,318,9.4,9354,2978,6376,3.8,11.8,9117,2961,6156,3.7,11.5,237,0.3,23,0,219,219,1252
2000,36780,2954,3368,80494,79976,278,8.2,289,8.6,9137,3223,5914,4,11.4,8101,2390,5711,3,10.1,1036,1.3,20.2,0,199,199,1158
2001,36780,2954,3372,80835,80719,307,9.1,322,9.5,8413,3602,4811,4.5,10.4,8180,2760,5420,3.4,10.1,233,0.3,20.2,0,197,199,997
2002,36780,2956,3378,81352,81044,351,10.4,340,10.1,11229,3644,7585,4.5,13.9,10612,3330,7282,4.1,13.1,617,0.8,26.2,0,178,178,1201
2003,36780,2958,3392,81067,80718,313,9.3,248,7.4,11272,5894,5378,7.3,14,10573,2848,7725,3.5,13.1,699,0.9,26.2,0,173,173,1681
2004,36780,2958,3418,88810,84770,301,8.9,258,7.6,16532,10949,5583,12.9,19.5,8452,2572,5880,3,10,8080,9.5,20,0,181,181,2015
2005,36780,2965,3430,88598,88507,311,9.1,255,7.5,7974,2744,5230,3.1,9,7792,2032,5760,2.3,8.8,182,0.2,17.6,0,165,165,1182
2006,36780,2970,3491,84561,86580,369,10.7,291,8.4,13904,6714,7190,7.8,16.1,17942,2698,15244,3.1,20.7,-4038,-4.6,32.2,0,205,205,1718
2007,36780,2966,3492,84488,84411,309,8.9,294,8.4,8830,2762,6068,3.3,10.5,8675,2155,6520,2.6,10.3,155,0.2,20.6,0,161,162,744
2008,36780,2929,3454,87246,85760,273,7.9,284,8.2,10587,3046,7541,3.6,12.3,7615,1763,5852,2.1,8.9,2972,3.4,17.8,0,188,194,1301
2009,36780,2854,3371,85677,86098,220,6.5,267,7.8,8833,1983,6850,2.3,10.3,9674,2753,6921,3.2,11.2,-841,-0.9,20.6,0,179,179,2080
2010,36780,2785,3298,83076,84265,191,5.7,249,7.5,9304,2741,6563,3.3,11,11682,5712,5970,6.8,13.9,-2378,-2.9,22,0,168,168,5190
2011,36780,2782,3299,85391,84212,237,7.2,210,6.4,7885,1954,5931,2.3,9.4,5526,935,4591,1.1,6.6,2359,2.8,13.2,0,147,148,598
2012,36780,2762,3260,84435,84717,223,6.8,263,8,7624,1641,5983,1.9,9,8187,2571,5616,3,9.7,-563,-0.7,18,0,150,154,1608
2013,36780,2742,3226,83355,83705,198,6.1,220,6.8,6807,1507,5300,1.8,8.1,7506,1152,6354,1.4,9,-699,-0.9,16.2,0,135,141,875
2014,36780,2729,3233,82475,82549,238,7.4,205,6.4,8832,3276,5556,4,10.7,8980,3446,5534,4.2,10.9,-148,-0.2,21.4,0,142,142,2983
1977,36980,1894,2063,29464,28454,323,16,230,11.4,5302,2585,2717,9.1,18.6,3281,1179,2102,4.1,11.5,2021,7.1,23,0,167,167,778
1978,36980,1942,2112,31369,30448,303,14.5,254,12.2,6506,2535,3971,8.3,21.4,4664,2146,2518,7,15.3,1842,6.1,30.6,0,175,177,993
1979,36980,1987,2164,32790,32051,322,15.1,256,12,6531,2585,3946,8.1,20.4,5053,2033,3020,6.3,15.8,1478,4.6,31.6,0,175,175,970
1980,36980,1951,2132,32459,32592,238,11.1,254,11.8,4488,1663,2825,5.1,13.8,4754,1427,3327,4.4,14.6,-266,-0.8,27.6,0,195,195,754
1981,36980,1878,2058,30110,30465,227,10.9,276,13.2,4071,1502,2569,4.9,13.4,4781,1767,3014,5.8,15.7,-710,-2.3,26.8,0,162,162,742
1982,36980,1894,2102,30333,30199,280,13.4,224,10.8,4729,2109,2620,7,15.7,4460,1398,3062,4.6,14.8,269,0.9,29.6,0,138,138,535
1983,36980,1939,2150,30146,30253,242,11.4,202,9.5,4142,1470,2672,4.9,13.7,4355,1165,3190,3.9,14.4,-213,-0.7,27.4,0,137,137,618
1984,36980,1979,2189,30684,30429,254,11.7,222,10.2,4048,1444,2604,4.7,13.3,3538,1303,2235,4.3,11.6,510,1.7,23.2,0,149,151,752
1985,36980,2014,2233,33293,32861,255,11.5,212,9.6,4145,1378,2767,4.2,12.6,3281,962,2319,2.9,10,864,2.6,20,0,146,146,515
1986,36980,2015,2227,35189,34168,252,11.3,244,11,6420,2291,4129,6.7,18.8,4377,1725,2652,5,12.8,2043,6,25.6,0,164,165,791
1987,36980,2053,2277,32221,32925,319,14.1,259,11.5,4751,1728,3023,5.2,14.4,6158,2013,4145,6.1,18.7,-1407,-4.3,28.8,0,175,175,1175
1988,36980,2026,2254,33282,32486,270,11.9,273,12.1,5561,1828,3733,5.6,17.1,3968,1515,2453,4.7,12.2,1593,4.9,24.4,0,201,201,954
1989,36980,2026,2268,35693,34736,228,10.1,215,9.5,5850,1956,3894,5.6,16.8,3936,1499,2437,4.3,11.3,1914,5.5,22.6,0,154,154,1070
1990,36980,2036,2285,36594,36100,235,10.3,203,8.9,5210,1459,3751,4,14.4,4221,1253,2968,3.5,11.7,989,2.7,23.4,0,147,147,722
1991,36980,2068,2332,36852,36738,233,10.1,194,8.4,4435,1359,3076,3.7,12.1,4206,1013,3193,2.8,11.4,229,0.7,22.8,0,139,139,676
1992,36980,2075,2344,38173,37505,233,10,209,8.9,6274,3333,2941,8.9,16.7,4938,1461,3477,3.9,13.2,1336,3.5,26.4,0,149,149,661
1993,36980,2084,2346,38275,38210,192,8.2,189,8.1,5189,1286,3903,3.4,13.6,5058,1949,3109,5.1,13.2,131,0.4,26.4,0,129,129,626
1994,36980,2111,2377,39641,38929,239,10.1,206,8.7,6323,2638,3685,6.8,16.2,4898,1712,3186,4.4,12.6,1425,3.6,25.2,0,150,150,856
1995,36980,2142,2407,40110,39855,236,9.9,197,8.2,5159,1468,3691,3.7,12.9,4649,1369,3280,3.4,11.7,510,1.2,23.4,0,137,138,648
1996,36980,2151,2423,40120,40195,248,10.3,233,9.7,6135,2241,3894,5.6,15.3,6284,3346,2938,8.3,15.6,-149,-0.3,30.6,0,156,156,1085
1997,36980,2164,2450,41322,40728,265,10.9,235,9.6,6771,2527,4244,6.2,16.6,5582,2589,2993,6.4,13.7,1189,2.9,27.4,0,157,157,815
1998,36980,2189,2470,42934,42123,235,9.6,212,8.6,7896,3341,4555,7.9,18.7,6274,2559,3715,6.1,14.9,1622,3.8,29.8,0,125,125,942
1999,36980,2171,2472,43853,43375,213,8.6,206,8.3,6526,2402,4124,5.5,15,5570,1429,4141,3.3,12.8,956,2.2,25.6,0,138,138,620
2000,36980,2143,2463,45001,44417,206,8.4,218,8.8,6700,2392,4308,5.4,15.1,5531,1804,3727,4.1,12.5,1169,2.6,25,0,134,134,906
2001,36980,2158,2469,42908,43982,206,8.3,209,8.5,4788,1206,3582,2.7,10.9,6936,2301,4635,5.2,15.8,-2148,-4.9,21.8,0,120,120,1048
2002,36980,2174,2500,43640,43276,251,10.1,223,9,6108,1857,4251,4.3,14.1,5379,1319,4060,3,12.4,729,1.7,24.8,0,123,123,553
2003,36980,2160,2491,41514,42257,198,8,176,7.1,4412,1289,3123,3.1,10.4,5898,1246,4652,2.9,14,-1486,-3.6,20.8,0,118,118,636
2004,36980,2174,2500,41588,41429,216,8.7,184,7.4,4839,1331,3508,3.2,11.7,4521,1751,2770,4.2,10.9,318,0.8,21.8,0,125,125,543
2005,36980,2170,2493,42864,42112,217,8.7,202,8.1,5779,1665,4114,4,13.7,4274,1342,2932,3.2,10.1,1505,3.6,20.2,0,148,152,797
2006,36980,2152,2494,44273,43546,224,9,209,8.4,6296,2790,3506,6.4,14.5,4841,1888,2953,4.3,11.1,1455,3.4,22.2,0,150,150,1357
2007,36980,2135,2497,44017,44120,231,9.3,224,9,6003,1679,4324,3.8,13.6,6208,1987,4221,4.5,14.1,-205,-0.5,27.2,0,136,136,1191
2008,36980,2096,2455,44941,44405,163,6.6,174,7.1,5254,1631,3623,3.7,11.8,4182,976,3206,2.2,9.4,1072,2.4,18.8,0,115,115,663
2009,36980,2053,2426,43405,44066,176,7.2,181,7.4,4761,1580,3181,3.6,10.8,6082,1318,4764,3,13.8,-1321,-3,21.6,0,132,132,1090
2010,36980,2033,2406,43472,43457,163,6.8,171,7.1,5183,1386,3797,3.2,11.9,5153,1275,3878,2.9,11.9,30,0,23.8,0,113,113,688
2011,36980,2004,2382,43863,43530,157,6.6,159,6.7,4701,1115,3586,2.6,10.8,4035,733,3302,1.7,9.3,666,1.5,18.6,0,113,113,503
2012,36980,2011,2397,45159,44423,167,7,159,6.7,5613,1918,3695,4.3,12.6,4142,1010,3132,2.3,9.3,1471,3.3,18.6,0,101,101,498
2013,36980,2015,2395,45204,45114,154,6.5,144,6,4384,1055,3329,2.3,9.7,4204,808,3396,1.8,9.3,180,0.4,18.6,0,90,90,578
2014,36980,1981,2361,45340,45185,145,6.1,153,6.5,4786,1373,3413,3,10.6,4475,1297,3178,2.9,9.9,311,0.7,19.8,0,106,108,978
1977,37100,6810,7637,92595,88546,1648,22.6,969,13.3,23171,10893,12278,12.3,26.2,15072,7075,7997,8,17,8099,9.2,34,0,627,629,4077
1978,37100,7137,8007,102919,97738,1534,19.6,1146,14.7,25706,10284,15422,10.5,26.3,15343,7811,7532,8,15.7,10363,10.6,31.4,0,725,725,4105
1979,37100,7748,8730,116821,109762,1868,22.3,1073,12.8,31222,13845,17377,12.6,28.4,17103,7211,9892,6.6,15.6,14119,12.8,31.2,0,773,773,4179
1980,37100,8150,9146,135970,126294,1666,18.6,1191,13.3,41702,26700,15002,21.1,33,22350,9326,13024,7.4,17.7,19352,15.3,35.4,0,801,804,5012
1981,37100,8174,9150,124230,129434,1588,17.4,1480,16.2,28831,13993,14838,10.8,22.3,39239,11336,27903,8.8,30.3,-10408,-8,44.6,0,894,896,4921
1982,37100,8454,9574,146977,135380,1725,18.4,1206,12.9,47999,31494,16505,23.3,35.5,24805,9329,15476,6.9,18.3,23194,17.2,36.6,0,675,675,4599
1983,37100,8800,9948,132037,139507,1514,15.5,1208,12.4,27848,12951,14897,9.3,20,42787,7770,35017,5.6,30.7,-14939,-10.7,40,0,768,772,4394
1984,37100,9190,10399,147486,139699,1617,15.9,1163,11.4,37016,15198,21818,10.9,26.5,21442,8223,13219,5.9,15.3,15574,11.2,30.6,0,761,761,3751
1985,37100,9753,10947,162360,155243,1715,16.1,1188,11.1,39294,17882,21412,11.5,25.3,25059,10092,14967,6.5,16.1,14235,9.2,32.2,0,694,696,4601
1986,37100,10255,11492,170007,166231,1847,16.5,1262,11.3,37235,15448,21787,9.3,22.4,29683,10485,19198,6.3,17.9,7552,4.5,35.8,0,806,806,5320
1987,37100,10864,12163,180868,177883,2175,18.4,1427,12.1,41150,17158,23992,9.6,23.1,35180,15338,19842,8.6,19.8,5970,3.3,39.6,0,893,895,5674
1988,37100,11236,12603,188455,183447,1970,15.9,1455,11.8,41590,17373,24217,9.5,22.7,31573,14203,17370,7.7,17.2,10017,5.5,34.4,0,934,934,5775
1989,37100,11652,13050,198283,193626,1911,14.9,1458,11.4,40199,15603,24596,8.1,20.8,30884,11336,19548,5.9,16,9315,4.8,32,0,985,985,6750
1990,37100,12062,13490,202196,200447,1992,15,1459,11,38114,13779,24335,6.9,19,34616,11627,22989,5.8,17.3,3498,1.7,34.6,0,998,1004,7290
1991,37100,12180,13738,190792,196456,1918,14.1,1675,12.3,32171,13618,18553,6.9,16.4,43498,13893,29605,7.1,22.1,-11327,-5.7,32.8,0,1059,1061,7152
1992,37100,12133,13740,187118,188768,1818,13.2,1700,12.4,32431,11928,20503,6.3,17.2,35731,12010,23721,6.4,18.9,-3300,-1.7,34.4,0,1100,1118,6462
1993,37100,12010,13531,191645,190243,1585,11.6,1708,12.5,37115,11268,25847,5.9,19.5,34310,14072,20238,7.4,18,2805,1.5,36,0,1100,1115,7283
1994,37100,12025,13536,194065,192697,1703,12.6,1657,12.2,37370,15221,22149,7.9,19.4,34633,12600,22033,6.5,18,2737,1.4,36,0,1084,1086,6532
1995,37100,12286,13798,202343,197917,1798,13.2,1456,10.7,37305,12801,24504,6.5,18.8,28453,9607,18846,4.9,14.4,8852,4.4,28.8,0,947,953,4849
1996,37100,12446,13961,205704,203725,1730,12.5,1511,10.9,37713,13688,24025,6.7,18.5,33754,11371,22383,5.6,16.6,3959,1.9,33.2,0,986,986,6098
1997,37100,12477,14073,206529,206322,1817,12.9,1702,12.1,39464,16039,23425,7.8,19.1,39050,14709,24341,7.1,18.9,414,0.2,37.8,0,1065,1065,7165
1998,37100,12647,14314,212431,209363,1816,12.8,1556,11,38428,14877,23551,7.1,18.4,32292,13281,19011,6.3,15.4,6136,3,30.8,0,998,998,5972
1999,37100,12846,14583,221187,216678,1869,12.9,1587,11,42792,15913,26879,7.3,19.7,33773,12697,21076,5.9,15.6,9019,4.1,31.2,0,961,961,5962
2000,37100,12995,14738,235058,228121,1835,12.5,1690,11.5,48355,19403,28952,8.5,21.2,34481,14403,20078,6.3,15.1,13874,6.1,30.2,0,980,980,6116
2001,37100,13367,15234,242785,239360,2062,13.7,1727,11.5,44461,18753,25708,7.8,18.6,37610,13423,24187,5.6,15.7,6851,2.9,31.4,0,1014,1014,7132
2002,37100,13558,15497,246867,244293,2248,14.6,1951,12.7,52646,23072,29574,9.4,21.6,47498,18079,29419,7.4,19.4,5148,2.2,38.8,0,1069,1069,7936
2003,37100,13893,15930,249107,246136,2196,14,1467,9.4,45229,20928,24301,8.5,18.4,39288,12434,26854,5.1,16,5941,2.4,32,0,996,1006,6422
2004,37100,14156,16190,259358,253369,2091,13,1624,10.1,48127,17388,30739,6.9,19,36150,12118,24032,4.8,14.3,11977,4.7,28.6,0,1043,1044,5789
2005,37100,14504,16668,266829,262247,2274,13.9,1635,10,47214,17233,29981,6.6,18,38050,14168,23882,5.4,14.5,9164,3.5,29,0,1170,1170,8310
2006,37100,14894,17213,275517,270545,2386,14.1,1708,10.1,49157,20464,28693,7.6,18.2,39212,12465,26747,4.6,14.5,9945,3.7,29,0,1170,1170,7376
2007,37100,15241,17609,268611,271739,2317,13.3,1841,10.6,44210,16936,27274,6.2,16.3,50466,16428,34038,6,18.6,-6256,-2.3,32.6,0,1149,1160,7846
2008,37100,15183,17555,261333,263751,2061,11.8,1891,10.8,37444,16570,20874,6.3,14.2,42279,15617,26662,5.9,16,-4835,-1.8,28.4,0,1291,1291,8256
2009,37100,14751,17103,242703,250937,1765,10.2,2018,11.7,28011,10708,17303,4.3,11.2,44478,11755,32723,4.7,17.7,-16467,-6.5,22.4,0,1332,1332,7298
2010,37100,14498,16891,227962,234589,1661,9.8,1754,10.3,26877,10966,15911,4.7,11.5,40131,10736,29395,4.6,17.1,-13254,-5.6,23,0,1152,1152,6796
2011,37100,14484,16956,231678,229337,1830,10.8,1640,9.7,33875,13112,20763,5.7,14.8,29194,9839,19355,4.3,12.7,4681,2.1,25.4,0,1046,1046,6136
2012,37100,14576,17058,237114,234087,1765,10.4,1634,9.6,36876,10920,25956,4.7,15.8,30821,11274,19547,4.8,13.2,6055,2.6,26.4,0,940,942,4774
2013,37100,14882,17349,243366,239529,1811,10.6,1539,9,32963,11812,21151,4.9,13.8,25288,9118,16170,3.8,10.6,7675,3.2,21.2,0,932,934,5137
2014,37100,15009,17456,246319,244069,1858,10.7,1630,9.4,32567,10897,21670,4.5,13.3,28067,11076,16991,4.5,11.5,4500,1.8,23,0,1087,1088,5905
1977,37340,3851,4344,63802,61181,833,19.6,657,15.4,14469,5324,9145,8.7,23.6,9226,4357,4869,7.1,15.1,5243,8.5,30.2,0,451,452,2715
1978,37340,4146,4631,69123,66454,941,21,660,14.7,18775,6480,12295,9.8,28.3,13437,8998,4439,13.5,20.2,5338,8.1,40.4,0,492,492,7403
1979,37340,4348,4871,75513,72288,888,18.7,624,13.1,20654,7815,12839,10.8,28.6,14204,5977,8227,8.3,19.6,6450,9,39.2,0,469,473,3725
1980,37340,4532,5078,81221,78206,859,17.3,639,12.8,17718,4997,12721,6.4,22.7,11688,5065,6623,6.5,14.9,6030,7.8,29.8,0,489,489,2508
1981,37340,4571,5171,85438,83256,861,16.8,720,14.1,19343,8954,10389,10.8,23.2,14978,7133,7845,8.6,18,4365,5.2,36,0,490,490,2385
1982,37340,4795,5525,89766,87539,1033,19.3,634,11.8,20624,8975,11649,10.3,23.6,16172,5300,10872,6.1,18.5,4452,5.1,37,0,359,359,2101
1983,37340,4950,5724,92698,90482,895,15.9,738,13.1,20010,10580,9430,11.7,22.1,15578,5432,10146,6,17.2,4432,4.9,34.4,0,443,444,2610
1984,37340,5425,6240,105371,99037,1186,19.8,680,11.4,29081,14540,14541,14.7,29.4,16413,5668,10745,5.7,16.6,12668,12.8,33.2,0,443,443,2376
1985,37340,5885,6781,116460,111749,1302,20,748,11.5,24811,9422,15389,8.4,22.2,15388,6619,8769,5.9,13.8,9423,8.4,27.6,0,517,517,3009
1986,37340,6253,7192,120608,118674,1330,19,888,12.7,22839,10225,12614,8.6,19.2,18971,6535,12436,5.5,16,3868,3.2,32,0,605,605,3432
1987,37340,6447,7501,121683,121396,1402,19.1,1031,14,22608,10872,11736,9,18.6,22034,8174,13860,6.7,18.2,574,0.4,36.4,0,706,707,5035
1988,37340,6652,7726,123756,121919,1334,17.5,1074,14.1,23279,8396,14883,6.9,19.1,19604,10485,9119,8.6,16.1,3675,3,32.2,0,730,730,3853
1989,37340,6937,8074,132175,129219,1313,16.6,987,12.5,27398,12368,15030,9.6,21.2,21485,8189,13296,6.3,16.6,5913,4.6,33.2,0,684,685,3649
1990,37340,7178,8359,136470,134962,1295,15.8,966,11.8,22274,8637,13637,6.4,16.5,19257,7850,11407,5.8,14.3,3017,2.2,28.6,0,691,697,5481
1991,37340,7449,8698,139331,138045,1383,16.2,1039,12.2,25307,11748,13559,8.5,18.3,22734,7728,15006,5.6,16.5,2573,1.8,33,0,665,680,4275
1992,37340,7625,8859,135295,137311,1311,14.9,1116,12.7,20861,8235,12626,6,15.2,24892,8800,16092,6.4,18.1,-4031,-2.9,30.4,0,716,728,4037
1993,37340,7901,9106,141270,138206,1335,14.9,1057,11.8,23914,8423,15491,6.1,17.3,17787,5780,12007,4.2,12.9,6127,4.4,25.8,0,757,762,3464
1994,37340,8052,9271,141320,141251,1263,13.7,1080,11.8,20141,7771,12370,5.5,14.3,20002,7021,12981,5,14.2,139,0.1,28.4,0,786,787,4293
1995,37340,8218,9439,141535,141377,1333,14.3,1113,11.9,22093,8927,13166,6.3,15.6,21777,7030,14747,5,15.4,316,0.2,30.8,0,772,775,4026
1996,37340,8283,9511,134719,138071,1268,13.4,1174,12.4,21029,8813,12216,6.4,15.2,27732,13751,13981,10,20.1,-6703,-4.9,30.4,0,802,802,3881
1997,37340,8440,9815,146381,140637,1441,14.9,1164,12,31972,15202,16770,10.8,22.7,20483,8645,11838,6.1,14.6,11489,8.1,29.2,0,767,767,4441
1998,37340,8513,9903,150948,148317,1294,13.1,1189,12.1,26050,9850,16200,6.6,17.6,20787,8736,12051,5.9,14,5263,3.6,28,0,817,817,4053
1999,37340,8568,10009,155329,153811,1319,13.2,1214,12.2,26626,12425,14201,8.1,17.3,23590,8837,14753,5.7,15.3,3036,2,30.6,0,801,801,4305
2000,37340,8539,9963,156913,155974,1222,12.2,1259,12.6,25907,8092,17815,5.2,16.6,24029,11622,12407,7.5,15.4,1878,1.2,30.8,0,776,776,3722
2001,37340,8651,10148,162778,160302,1283,12.8,1182,11.7,23994,8657,15337,5.4,15,19042,7180,11862,4.5,11.9,4952,3.1,23.8,0,737,738,3255
2002,37340,8871,10382,162900,162092,1508,14.7,1261,12.3,26908,12563,14345,7.8,16.6,25291,9232,16059,5.7,15.6,1617,1,31.2,0,716,716,3963
2003,37340,9099,10620,171392,166355,1496,14.3,1084,10.4,29759,11754,18005,7.1,17.9,19685,6877,12808,4.1,11.8,10074,6.1,23.6,0,751,751,3816
2004,37340,9634,11152,174206,172084,1782,16.4,1140,10.5,31134,12876,18258,7.5,18.1,26890,9423,17467,5.5,15.6,4244,2.5,31.2,0,770,770,4521
2005,37340,10168,11796,178875,176108,1834,16,1090,9.5,29151,12653,16498,7.2,16.6,23616,7031,16585,4,13.4,5535,3.2,26.8,0,758,758,3890
2006,37340,10504,12220,184315,181125,1841,15.4,1298,10.8,29912,13185,16727,7.3,16.5,23532,9138,14394,5,13,6380,3.5,26,0,912,917,4998
2007,37340,10575,12371,184790,183935,1656,13.5,1471,12,28932,12541,16391,6.8,15.7,27222,8221,19001,4.5,14.8,1710,0.9,29.6,0,1037,1039,4629
2008,37340,10192,11981,181040,182272,1352,11.1,1596,13.2,23738,9536,14202,5.2,13,26202,7823,18379,4.3,14.4,-2464,-1.4,26,0,1191,1192,4738
2009,37340,9695,11454,166740,172114,1246,10.7,1605,13.7,19527,10093,9434,5.9,11.3,30274,8517,21757,4.9,17.6,-10747,-6.3,22.6,0,1089,1090,4665
2010,37340,9526,11303,164093,164288,1253,11.1,1318,11.6,23273,11018,12255,6.7,14.2,23662,7784,15878,4.7,14.4,-389,-0.2,28.4,0,904,904,4238
2011,37340,9424,11197,166835,165127,1272,11.3,1307,11.6,24491,9139,15352,5.5,14.8,21077,8659,12418,5.2,12.8,3414,2,25.6,0,894,894,3989
2012,37340,9617,11362,161670,163702,1315,11.7,1164,10.3,22161,9635,12526,5.9,13.5,26225,10431,15794,6.4,16,-4064,-2.5,27,0,735,737,3447
2013,37340,9776,11540,161107,161231,1305,11.4,1162,10.2,20157,8704,11453,5.4,12.5,20405,5815,14590,3.6,12.7,-248,-0.2,25,0,732,732,3430
2014,37340,9951,11720,160083,160135,1371,11.8,1123,9.7,20185,8507,11678,5.3,12.6,20288,6943,13345,4.3,12.7,-103,-0.1,25.2,0,795,797,3842
1977,37380,149,162,2478,1752,52,35.6,19,13,1700,1583,117,90.4,97,248,82,166,4.7,14.2,1452,82.8,28.4,0,14,14,59
1978,37380,178,191,2847,2663,57,32.3,28,15.9,684,257,427,9.7,25.7,315,158,157,5.9,11.8,369,13.9,23.6,0,22,22,142
1979,37380,202,216,3461,3153,53,26,26,12.8,860,243,617,7.7,27.3,244,103,141,3.3,7.7,616,19.6,15.4,0,19,19,89
1980,37380,207,222,3556,3507,47,21.5,38,17.4,650,320,330,9.1,18.5,552,114,438,3.3,15.7,98,2.8,31.4,0,32,32,90
1981,37380,203,217,3256,3258,44,20.1,47,21.5,604,205,399,6.3,18.5,607,261,346,8,18.6,-3,-0.1,37,0,31,31,185
1982,37380,220,240,2723,2981,54,23.6,24,10.5,639,449,190,15.1,21.4,1154,157,997,5.3,38.7,-515,-17.3,42.8,0,15,15,102
1983,37380,222,241,2542,2639,39,16.3,43,17.9,444,141,303,5.3,16.8,637,260,377,9.9,24.1,-193,-7.3,33.6,0,25,25,81
1984,37380,268,286,2856,2705,74,28.1,30,11.4,671,294,377,10.9,24.8,369,220,149,8.1,13.6,302,11.2,27.2,0,20,20,79
1985,37380,291,311,3850,3523,67,22.4,43,14.4,1020,626,394,17.8,29,365,174,191,4.9,10.4,655,18.6,20.8,0,34,34,96
1986,37380,326,345,4314,4083,69,21,35,10.7,1051,471,580,11.5,25.7,588,263,325,6.4,14.4,463,11.3,28.8,0,23,23,77
1987,37380,384,401,4860,4553,98,26.2,38,10.2,1260,422,838,9.3,27.7,646,400,246,8.8,14.2,614,13.5,28.4,0,29,29,79
1988,37380,413,435,5807,5134,90,21.6,55,13.2,1863,967,896,18.8,36.3,517,180,337,3.5,10.1,1346,26.2,20.2,0,43,43,145
1989,37380,441,462,5994,5945,85,19,58,12.9,1089,473,616,8,18.3,991,442,549,7.4,16.7,98,1.6,33.4,0,50,50,259
1990,37380,455,478,6209,6098,85,18.1,66,14,1308,645,663,10.6,21.4,1086,606,480,9.9,17.8,222,3.6,35.6,0,56,56,309
1991,37380,481,507,5444,5824,89,18.1,58,11.8,824,497,327,8.5,14.1,1584,397,1187,6.8,27.2,-760,-13.1,28.2,0,40,40,278
1992,37380,478,518,5542,5520,89,17.3,80,15.5,1089,626,463,11.3,19.7,1044,473,571,8.6,18.9,45,0.8,37.8,0,53,53,192
1993,37380,556,592,5970,5757,120,21.6,48,8.6,1074,461,613,8,18.7,648,171,477,3,11.3,426,7.4,22.6,0,35,36,133
1994,37380,589,629,7009,6490,96,15.7,59,9.7,1717,767,950,11.8,26.5,678,226,452,3.5,10.4,1039,16.1,20.8,0,44,44,144
1995,37380,639,677,7319,7151,118,18.1,64,9.8,1350,479,871,6.7,18.9,1013,257,756,3.6,14.2,337,4.7,28.4,0,46,46,175
1996,37380,670,711,8057,7678,113,16.3,69,9.9,1721,692,1029,9,22.4,962,194,768,2.5,12.5,759,9.9,25,0,54,54,154
1997,37380,707,751,8445,8255,126,17.2,82,11.2,1845,909,936,11,22.4,1464,516,948,6.3,17.7,381,4.7,35.4,0,52,52,226
1998,37380,771,818,9106,8777,141,18,74,9.4,1767,848,919,9.7,20.1,1108,373,735,4.2,12.6,659,7.5,25.2,0,53,53,296
1999,37380,798,850,9021,9062,134,16.1,104,12.5,1387,517,870,5.7,15.3,1469,917,552,10.1,16.2,-82,-0.9,30.6,0,66,66,413
2000,37380,824,872,9638,9324,147,17.1,121,14.1,1844,792,1052,8.5,19.8,1215,480,735,5.1,13,629,6.8,26,0,77,77,265
2001,37380,897,944,9965,9843,176,19.4,117,12.9,1898,866,1032,8.8,19.3,1653,676,977,6.9,16.8,245,2.5,33.6,0,65,65,292
2002,37380,941,992,11042,10509,175,18,131,13.5,2721,688,2033,6.5,25.9,1655,503,1152,4.8,15.7,1066,10.2,31.4,0,72,72,325
2003,37380,1001,1054,12094,11485,210,20.6,128,12.5,3211,1836,1375,16,28,1992,932,1060,8.1,17.3,1219,10.7,34.6,0,95,95,648
2004,37380,1203,1255,13688,12830,345,30,135,11.7,3240,1353,1887,10.5,25.3,1523,774,749,6,11.9,1717,13.4,23.8,0,103,103,382
2005,37380,1332,1392,15607,14598,312,23.6,168,12.7,3917,1709,2208,11.7,26.8,1898,762,1136,5.2,13,2019,13.8,26,0,119,119,623
2006,37380,1475,1553,18063,16809,336,22.8,162,11,5083,2614,2469,15.6,30.2,2574,1589,985,9.5,15.3,2509,14.9,30.6,0,122,122,830
2007,37380,1487,1567,17293,17647,271,17.4,249,16,2732,1299,1433,7.4,15.5,3439,1367,2072,7.7,19.5,-707,-4,31,0,176,176,705
2008,37380,1428,1504,16694,16932,252,16.5,288,18.8,2474,1147,1327,6.8,14.6,2950,930,2020,5.5,17.4,-476,-2.8,29.2,0,221,221,742
2009,37380,1389,1468,16246,16418,252,17,264,17.8,2924,1538,1386,9.4,17.8,3267,871,2396,5.3,19.9,-343,-2.1,35.6,0,194,198,543
2010,37380,1353,1442,14280,15197,237,16.3,239,16.5,2156,1159,997,7.6,14.2,3989,2703,1286,17.8,26.2,-1833,-12,28.4,0,173,173,639
2011,37380,1348,1438,16089,15199,223,15.5,217,15.1,3712,2136,1576,14.1,24.4,1932,970,962,6.4,12.7,1780,11.7,25.4,0,161,161,637
2012,37380,1415,1507,16342,16198,220,14.9,166,11.3,2252,1180,1072,7.3,13.9,1964,657,1307,4.1,12.1,288,1.8,24.2,0,109,110,400
2013,37380,1466,1557,15512,15942,234,15.3,199,13,2047,873,1174,5.5,12.8,2907,1944,963,12.2,18.2,-860,-5.4,25.6,0,122,122,1613
2014,37380,1518,1617,16558,16002,229,14.4,165,10.4,2650,1063,1587,6.6,16.6,1538,640,898,4,9.6,1112,7,19.2,0,118,120,462
1977,37460,1840,1994,20058,19955,447,22.9,353,18.1,5247,3289,1958,16.5,26.3,5040,2134,2906,10.7,25.3,207,1,50.6,0,241,241,1146
1978,37460,1896,2068,22061,21067,378,18.6,308,15.2,6171,2917,3254,13.8,29.3,4182,2014,2168,9.6,19.9,1989,9.4,39.8,0,214,215,1500
1979,37460,1917,2089,22686,22347,369,17.8,329,15.8,5336,2014,3322,9,23.9,4657,1983,2674,8.9,20.8,679,3.1,41.6,0,239,239,1246
1980,37460,1965,2143,22751,22642,362,17.1,301,14.2,4783,2077,2706,9.2,21.1,4564,1436,3128,6.3,20.2,219,0.9,40.4,0,209,209,923
1981,37460,1960,2123,25001,23804,332,15.6,326,15.3,6618,3156,3462,13.3,27.8,4224,2112,2112,8.9,17.7,2394,10.1,35.4,0,220,220,1300
1982,37460,2044,2239,25897,25426,391,17.9,253,11.6,5497,2114,3383,8.3,21.6,4554,1901,2653,7.5,17.9,943,3.7,35.8,0,151,151,968
1983,37460,2092,2292,26899,26408,384,16.9,355,15.7,6428,3201,3227,12.1,24.3,5446,2475,2971,9.4,20.6,982,3.7,41.2,0,211,211,1399
1984,37460,2333,2551,29986,28508,532,22,272,11.2,7283,3474,3809,12.2,25.5,4326,1678,2648,5.9,15.2,2957,10.3,30.4,0,186,186,1061
1985,37460,2490,2722,33207,31598,512,19.4,340,12.9,8460,3909,4551,12.4,26.8,5242,2114,3128,6.7,16.6,3218,10.2,33.2,0,227,229,1273
1986,37460,2637,2887,34747,33949,538,19.2,361,12.9,8441,3852,4589,11.3,24.9,6845,3016,3829,8.9,20.2,1596,4.7,40.4,0,228,228,1391
1987,37460,2766,3063,36636,35825,609,20.4,411,13.8,9140,4500,4640,12.6,25.5,7517,3210,4307,9,21,1623,4.5,42,0,287,287,2001
1988,37460,2765,3101,37140,36843,512,16.6,461,15,8102,3856,4246,10.5,22,7508,2827,4681,7.7,20.4,594,1.6,40.8,0,308,308,1519
1989,37460,2756,3125,36999,37079,451,14.5,418,13.4,7963,3730,4233,10.1,21.5,8123,3358,4765,9.1,21.9,-160,-0.4,43,0,293,293,2271
1990,37460,2826,3197,39103,37961,434,13.7,339,10.7,8215,3025,5190,8,21.6,5930,2229,3701,5.9,15.6,2285,6,31.2,0,238,238,1478
1991,37460,2854,3257,39586,39244,411,12.7,358,11.1,8057,3612,4445,9.2,20.5,7372,2389,4983,6.1,18.8,685,1.7,37.6,0,242,242,1586
1992,37460,2968,3404,41375,40625,493,14.8,334,10,8295,2996,5299,7.4,20.4,6794,2001,4793,4.9,16.7,1501,3.7,33.4,0,220,220,1266
1993,37460,3006,3449,43091,42629,451,13.2,401,11.7,8633,3166,5467,7.4,20.3,7709,3601,4108,8.4,18.1,924,2.2,36.2,0,279,279,1769
1994,37460,3103,3535,44793,43771,464,13.3,361,10.3,8499,2728,5771,6.2,19.4,6454,2560,3894,5.8,14.7,2045,4.7,29.4,0,236,238,1706
1995,37460,3137,3593,46292,45516,451,12.7,387,10.9,9432,3726,5706,8.2,20.7,7879,3372,4507,7.4,17.3,1553,3.4,34.6,0,280,280,2228
1996,37460,3216,3680,48493,47308,475,13.1,377,10.4,10187,4467,5720,9.4,21.5,7816,2557,5259,5.4,16.5,2371,5,33,0,267,267,1537
1997,37460,3232,3697,49449,49002,451,12.2,448,12.1,9028,3240,5788,6.6,18.4,8134,3199,4935,6.5,16.6,894,1.8,33.2,0,284,284,1988
1998,37460,3252,3712,52575,50947,437,11.8,410,11.1,11081,5579,5502,11,21.8,7824,3207,4617,6.3,15.4,3257,6.4,30.8,0,253,253,1511
1999,37460,3270,3741,52653,52598,468,12.6,433,11.6,8923,4120,4803,7.8,17,8813,2952,5861,5.6,16.8,110,0.2,33.6,0,281,281,1582
2000,37460,3208,3685,52969,52800,389,10.5,439,11.8,8557,2462,6095,4.7,16.2,8219,3024,5195,5.7,15.6,338,0.6,31.2,0,244,244,1154
2001,37460,3264,3781,54043,53687,484,13,412,11,8187,3284,4903,6.1,15.2,7474,2318,5156,4.3,13.9,713,1.3,27.8,0,247,247,1159
2002,37460,3280,3768,54770,54399,465,12.3,475,12.6,10773,3571,7202,6.6,19.8,10031,3757,6274,6.9,18.4,742,1.4,36.8,0,234,235,1461
2003,37460,3328,3811,53723,53938,510,13.6,385,10.2,8906,2699,6207,5,16.5,9335,2701,6634,5,17.3,-429,-0.8,33,0,286,286,1732
2004,37460,3477,3970,55696,54522,633,16.3,435,11.2,10545,4241,6304,7.8,19.3,8196,3319,4877,6.1,15,2349,4.3,30,0,282,287,1484
2005,37460,3546,4080,56741,56108,568,14.1,417,10.4,9973,4706,5267,8.4,17.8,8706,3188,5518,5.7,15.5,1267,2.3,31,0,302,302,1811
2006,37460,3616,4173,60184,58259,536,13,410,9.9,13104,4350,8754,7.5,22.5,9254,2639,6615,4.5,15.9,3850,6.6,31.8,0,295,295,1447
2007,37460,3640,4209,62017,60886,523,12.5,458,10.9,11993,3821,8172,6.3,19.7,9730,2951,6779,4.8,16,2263,3.7,32,0,323,324,1423
2008,37460,3643,4213,61927,61893,452,10.8,432,10.3,9407,4340,5067,7,15.2,9339,2399,6940,3.9,15.1,68,0.1,30.2,0,296,296,1498
2009,37460,3505,4074,54309,57910,419,10.2,509,12.3,6647,3240,3407,5.6,11.5,13849,6137,7712,10.6,23.9,-7202,-12.4,23,0,371,373,3256
2010,37460,3433,4027,54241,54128,420,10.4,454,11.2,8354,4106,4248,7.6,15.4,8127,2555,5572,4.7,15,227,0.4,30,0,309,309,1425
2011,37460,3361,3958,55487,54811,425,10.7,459,11.5,9381,4107,5274,7.5,17.1,8029,2892,5137,5.3,14.6,1352,2.5,29.2,0,313,315,2221
2012,37460,3344,3959,57703,56608,406,10.2,423,10.7,10390,5089,5301,9,18.4,8199,3290,4909,5.8,14.5,2191,3.9,29,0,261,262,1836
2013,37460,3335,3966,58144,57866,344,8.7,345,8.7,7779,3113,4666,5.4,13.4,7223,2480,4743,4.3,12.5,556,0.9,25,0,232,232,1885
2014,37460,3387,4030,60741,59282,446,11.2,351,8.8,12184,7040,5144,11.9,20.6,9266,4669,4597,7.9,15.6,2918,5,31.2,0,241,241,3854
1977,37620,2757,3031,45129,44542,432,14.4,381,12.7,6588,2632,3956,5.9,14.8,5416,2204,3212,4.9,12.2,1172,2.6,24.4,0,226,227,1205
1978,37620,2848,3138,47988,46579,436,14.1,342,11.1,7370,2537,4833,5.4,15.8,4553,1547,3006,3.3,9.8,2817,6,19.6,0,232,232,968
1979,37620,2908,3196,51497,49711,406,12.8,332,10.5,8390,2325,6065,4.7,16.9,4817,1631,3186,3.3,9.7,3573,7.2,19.4,0,242,243,1082
1980,37620,2864,3158,51127,51292,338,10.6,371,11.7,8335,2268,6067,4.4,16.3,8665,3657,5008,7.1,16.9,-330,-0.6,32.6,0,262,263,1463
1981,37620,2763,3050,47694,48794,336,10.9,422,13.6,6804,3682,3122,7.5,13.9,9004,3545,5459,7.3,18.5,-2200,-4.6,27.8,0,259,261,1365
1982,37620,2777,3102,48552,48118,477,15.5,367,11.9,7875,3948,3927,8.2,16.4,7006,2634,4372,5.5,14.6,869,1.8,29.2,0,219,219,1007
1983,37620,2820,3144,46426,47554,362,11.6,349,11.2,6205,3126,3079,6.6,13,8461,2239,6222,4.7,17.8,-2256,-4.8,26,0,234,234,1308
1984,37620,2805,3127,46317,46255,382,12.2,389,12.4,6337,2120,4217,4.6,13.7,6213,2386,3827,5.2,13.4,124,0.3,26.8,0,206,206,1101
1985,37620,2944,3255,48910,47697,368,11.5,265,8.3,6865,2573,4292,5.4,14.4,4439,1621,2818,3.4,9.3,2426,5.1,18.6,0,97,98,406
1986,37620,2980,3284,48708,48807,397,12.1,357,10.9,7014,2359,4655,4.8,14.4,7212,2041,5171,4.2,14.8,-198,-0.4,28.8,0,247,247,1010
1987,37620,3039,3403,50474,49533,472,14.1,336,10,8003,2790,5213,5.6,16.2,6120,2676,3444,5.4,12.4,1883,3.8,24.8,0,233,233,1291
1988,37620,2995,3354,51777,50968,319,9.4,355,10.5,7500,2706,4794,5.3,14.7,5881,1994,3887,3.9,11.5,1619,3.2,23,0,220,220,873
1989,37620,3018,3383,52108,51734,345,10.2,313,9.3,6906,2813,4093,5.4,13.3,6157,1900,4257,3.7,11.9,749,1.4,23.8,0,198,199,1103
1990,37620,3066,3440,53398,52688,373,10.9,288,8.4,7142,2327,4815,4.4,13.6,5721,1797,3924,3.4,10.9,1421,2.7,21.8,0,206,206,1170
1991,37620,3067,3438,52582,53076,325,9.5,333,9.7,5471,1934,3537,3.6,10.3,6459,2067,4392,3.9,12.2,-988,-1.9,20.6,0,232,232,1438
1992,37620,3097,3490,54342,53412,352,10.2,289,8.3,7773,2817,4956,5.3,14.6,5912,1832,4080,3.4,11.1,1861,3.5,22.2,0,190,194,970
1993,37620,3151,3534,55320,54800,347,9.9,302,8.6,7547,2526,5021,4.6,13.8,6506,1650,4856,3,11.9,1041,1.9,23.8,0,197,197,840
1994,37620,3201,3595,56323,55811,373,10.5,296,8.3,7543,2618,4925,4.7,13.5,6518,1927,4591,3.5,11.7,1025,1.8,23.4,0,216,219,1176
1995,37620,3272,3670,58011,57144,379,10.4,290,8,7435,2884,4551,5,13,5700,2067,3633,3.6,10,1735,3,20,0,183,183,717
1996,37620,3321,3723,58427,58232,375,10.2,327,8.9,7510,2532,4978,4.3,12.9,7119,1888,5231,3.2,12.2,391,0.7,24.4,0,219,219,1033
1997,37620,3316,3735,58759,58555,375,10,357,9.6,7500,3011,4489,5.1,12.8,7092,2563,4529,4.4,12.1,408,0.7,24.2,0,222,222,1081
1998,37620,3292,3712,60084,59950,349,9.4,367,9.9,8327,3326,5001,5.5,13.9,8059,3684,4375,6.1,13.4,268,0.5,26.8,0,251,251,1481
1999,37620,3309,3747,59085,59641,362,9.7,325,8.7,7296,2452,4844,4.1,12.2,8408,3418,4990,5.7,14.1,-1112,-1.9,24.4,0,210,210,1024
2000,37620,3299,3753,61047,60054,361,9.6,359,9.6,8759,3415,5344,5.7,14.6,6773,2803,3970,4.7,11.3,1986,3.3,22.6,0,216,216,1059
2001,37620,3284,3748,62542,62348,330,8.8,359,9.6,7952,2516,5436,4,12.8,7565,2621,4944,4.2,12.1,387,0.7,24.2,0,212,212,1464
2002,37620,3250,3723,62117,62278,371,9.9,384,10.3,9378,3017,6361,4.8,15.1,9700,2699,7001,4.3,15.6,-322,-0.5,30.2,0,203,203,1018
2003,37620,3204,3694,60190,60934,312,8.5,280,7.6,6694,2537,4157,4.2,11,8182,1657,6525,2.7,13.4,-1488,-2.4,22,0,185,185,956
2004,37620,3226,3732,60384,59922,367,9.9,297,8,7452,2357,5095,3.9,12.4,6527,2115,4412,3.5,10.9,925,1.5,21.8,0,205,205,1038
2005,37620,3220,3747,59984,60077,333,8.9,291,7.8,7209,2344,4865,3.9,12,7394,1872,5522,3.1,12.3,-185,-0.3,24,0,204,204,1270
2006,37620,3154,3702,60522,60101,329,8.9,335,9,7914,3106,4808,5.2,13.2,7072,2347,4725,3.9,11.8,842,1.4,23.6,0,223,223,1513
2007,37620,3119,3692,60260,60340,307,8.3,315,8.5,8618,2833,5785,4.7,14.3,8777,2589,6188,4.3,14.5,-159,-0.2,28.6,0,200,207,1081
2008,37620,3086,3657,60973,60418,289,7.9,291,8,8280,2643,5637,4.4,13.7,7170,2113,5057,3.5,11.9,1110,1.8,23.8,0,196,196,1025
2009,37620,2994,3570,58606,59685,233,6.5,287,8,6074,1696,4378,2.8,10.2,8232,1990,6242,3.3,13.8,-2158,-3.6,20.4,0,203,204,1476
2010,37620,2965,3546,56873,57240,235,6.6,239,6.7,6431,2620,3811,4.6,11.2,7165,1711,5454,3,12.5,-734,-1.3,22.4,0,163,165,775
2011,37620,2923,3503,58350,57444,230,6.5,243,6.9,7512,1619,5893,2.8,13.1,5699,1255,4444,2.2,9.9,1813,3.2,19.8,0,157,157,844
2012,37620,2882,3474,57818,58008,255,7.3,281,8.1,6926,1934,4992,3.3,11.9,7305,2906,4399,5,12.6,-379,-0.7,23.8,0,178,179,962
2013,37620,2865,3450,57760,57704,205,5.9,225,6.5,6425,1476,4949,2.6,11.1,6312,2157,4155,3.7,10.9,113,0.2,21.8,0,150,150,1091
2014,37620,2819,3402,62862,60182,205,6,230,6.7,11307,1427,9880,2.4,18.8,5947,1201,4746,2,9.9,5360,8.9,19.8,0,162,164,765
1977,37700,1561,1703,46189,44839,321,19.2,242,14.5,6156,2027,4129,4.5,13.7,3456,1420,2036,3.2,7.7,2700,6,15.4,0,176,176,1081
1978,37700,1583,1734,45211,45712,254,14.8,229,13.3,4209,1496,2713,3.3,9.2,5210,1044,4166,2.3,11.4,-1001,-2.2,18.4,0,167,168,742
1979,37700,1638,1797,39962,42589,299,16.9,225,12.7,5051,2674,2377,6.3,11.9,10304,3099,7205,7.3,24.2,-5253,-12.3,23.8,0,170,170,986
1980,37700,1672,1844,36378,38101,319,17.5,261,14.3,4955,2711,2244,7.1,13,8400,1260,7140,3.3,22,-3445,-9,26,0,191,191,811
1981,37700,1630,1804,34626,34693,260,14.3,279,15.3,4812,1486,3326,4.3,13.9,4945,1747,3198,5,14.3,-133,-0.4,27.8,0,171,171,687
1982,37700,1596,1808,35914,35286,293,16.2,272,15,5880,2282,3598,6.5,16.7,4623,1626,2997,4.6,13.1,1257,3.6,26.2,0,157,157,617
1983,37700,1649,1854,30785,33316,245,13.4,217,11.9,3848,2006,1842,6,11.6,8909,1694,7215,5.1,26.7,-5061,-15.1,23.2,0,137,137,814
1984,37700,1688,1897,31837,31302,269,14.4,229,12.2,4679,1739,2940,5.6,14.9,3609,1361,2248,4.3,11.5,1070,3.4,23,0,142,142,575
1985,37700,1716,1923,36085,34731,264,13.8,236,12.3,6432,2286,4146,6.6,18.5,3723,1700,2023,4.9,10.7,2709,7.8,21.4,0,151,151,837
1986,37700,1781,1992,39285,37669,276,14.1,199,10.2,7170,1977,5193,5.2,19,3937,1448,2489,3.8,10.5,3233,8.5,21,0,125,125,594
1987,37700,1827,2065,38926,39215,325,16,251,12.4,3907,1484,2423,3.8,10,4484,1541,2943,3.9,11.4,-577,-1.4,20,0,164,164,822
1988,37700,1765,2016,39693,39206,257,12.6,279,13.7,5880,1848,4032,4.7,15,4905,1586,3319,4,12.5,975,2.5,25,0,204,204,868
1989,37700,1774,2024,37660,38870,270,13.4,269,13.3,4190,2014,2176,5.2,10.8,6609,2968,3641,7.6,17,-2419,-6.2,21.6,0,173,173,939
1990,37700,1724,1969,38459,37836,232,11.6,256,12.8,6051,1913,4138,5.1,16,4806,2468,2338,6.5,12.7,1245,3.3,25.4,0,173,173,1115
1991,37700,1777,2027,40378,39388,272,13.6,230,11.5,6358,2133,4225,5.4,16.1,4377,1670,2707,4.2,11.1,1981,5,22.2,0,129,131,765
1992,37700,1813,2066,44156,42367,269,13.1,217,10.6,7325,1503,5822,3.5,17.3,3746,946,2800,2.2,8.8,3579,8.5,17.6,0,135,135,535
1993,37700,1863,2112,43466,43791,260,12.4,209,10,5583,2497,3086,5.7,12.7,6233,2706,3527,6.2,14.2,-650,-1.5,25.4,0,148,148,1279
1994,37700,1904,2154,43808,43580,258,12.1,218,10.2,4587,1733,2854,4,10.5,4130,1194,2936,2.7,9.5,457,1,19,0,164,164,698
1995,37700,1931,2194,43879,43838,275,12.7,229,10.5,5513,2415,3098,5.5,12.6,5431,1947,3484,4.4,12.4,82,0.2,24.8,0,163,163,1432
1996,37700,1970,2243,41679,42738,308,13.9,247,11.1,5106,2544,2562,6,11.9,7223,2177,5046,5.1,16.9,-2117,-5,23.8,0,164,164,1429
1997,37700,1999,2296,41629,41695,312,13.7,264,11.6,7039,2890,4149,6.9,16.9,7170,2070,5100,5,17.2,-131,-0.3,33.8,0,166,166,824
1998,37700,2011,2315,45501,43576,304,13.2,288,12.5,8634,2793,5841,6.4,19.8,4784,2256,2528,5.2,11,3850,8.8,22,0,198,198,1564
1999,37700,2063,2366,49178,47482,292,12.5,241,10.3,8127,1720,6407,3.6,17.1,4734,1408,3326,3,10,3393,7.1,20,0,156,156,689
2000,37700,2056,2376,45946,47602,290,12.2,272,11.5,4838,1990,2848,4.2,10.2,8150,1671,6479,3.5,17.1,-3312,-6.9,20.4,0,178,178,1046
2001,37700,2070,2392,44586,45601,309,13,311,13,6215,3166,3049,6.9,13.6,8244,2169,6075,4.8,18.1,-2029,-4.5,27.2,0,192,192,861
2002,37700,2077,2388,44890,44634,310,13,313,13.1,7676,3418,4258,7.7,17.2,7164,2608,4556,5.8,16.1,512,1.1,32.2,0,167,167,943
2003,37700,2065,2348,44843,44565,259,11.1,221,9.5,6753,2514,4239,5.6,15.2,6197,2080,4117,4.7,13.9,556,1.3,27.8,0,166,167,1669
2004,37700,2084,2374,45275,44860,255,10.8,208,8.8,6597,2980,3617,6.6,14.7,5767,2229,3538,5,12.9,830,1.8,25.8,0,140,141,1023
2005,37700,2084,2382,45265,45181,287,12.1,245,10.3,6087,3147,2940,7,13.5,5918,1584,4334,3.5,13.1,169,0.4,26.2,0,175,177,1027
2006,37700,2005,2314,47396,45945,296,12.6,340,14.5,7626,2014,5612,4.4,16.6,4724,1723,3001,3.8,10.3,2902,6.3,20.6,0,214,214,1132
2007,37700,2141,2480,49418,48374,370,15.4,214,8.9,7358,3042,4316,6.3,15.2,5269,1287,3982,2.7,10.9,2089,4.3,21.8,0,145,145,722
2008,37700,2162,2509,49257,49337,275,11.1,227,9.1,8217,1467,6750,3,16.7,8377,3768,4609,7.6,17,-160,-0.3,33.4,0,177,177,1065
2009,37700,2096,2464,50523,49753,243,9.8,271,10.9,8330,2019,6311,4.1,16.7,6790,2525,4265,5.1,13.6,1540,3.1,27.2,0,196,196,1877
2010,37700,2037,2392,50053,50210,196,8.1,244,10.1,4023,1285,2738,2.6,8,4337,1060,3277,2.1,8.6,-314,-0.6,16,0,175,175,739
2011,37700,1998,2352,48281,49090,197,8.3,223,9.4,3709,1281,2428,2.6,7.6,5327,1520,3807,3.1,10.9,-1618,-3.3,15.2,0,149,149,950
2012,37700,1979,2366,44997,46615,221,9.4,213,9,4381,1547,2834,3.3,9.4,7617,1243,6374,2.7,16.3,-3236,-6.9,18.8,0,138,139,575
2013,37700,1980,2376,46175,45594,186,7.9,184,7.8,4775,1258,3517,2.8,10.5,3613,899,2714,2,7.9,1162,2.6,15.8,0,130,130,663
2014,37700,1962,2360,47177,46472,184,7.8,176,7.5,5459,1387,4072,3,11.7,4048,847,3201,1.8,8.7,1411,3,17.4,0,129,129,535
1977,37860,4144,4706,62431,61165,878,19,671,14.5,12116,5889,6227,9.6,19.8,9583,3716,5867,6.1,15.7,2533,4.1,31.4,0,496,498,2418
1978,37860,4267,4834,67451,64953,786,16.5,652,13.7,14823,4615,10208,7.1,22.8,9826,4239,5587,6.5,15.1,4997,7.7,30.2,0,465,467,2915
1979,37860,4295,4909,69295,68290,761,15.6,659,13.5,13650,5634,8016,8.3,20,11639,3912,7727,5.7,17,2011,3,34,0,486,487,2458
1980,37860,4450,5085,68909,69053,771,15.4,580,11.6,10908,4411,6497,6.4,15.8,11196,4087,7109,5.9,16.2,-288,-0.4,31.6,0,393,395,2466
1981,37860,4307,4926,68655,68620,633,12.7,734,14.7,10675,3479,7196,5.1,15.6,10604,3763,6841,5.5,15.5,71,0.1,31,0,472,480,1956
1982,37860,4414,5101,73836,71221,823,16.4,608,12.1,15687,6685,9002,9.4,22,10456,3672,6784,5.2,14.7,5231,7.3,29.4,0,352,352,2063
1983,37860,4593,5296,73195,73252,771,14.8,609,11.7,12881,4425,8456,6,17.6,12995,4411,8584,6,17.7,-114,-0.1,35.2,0,380,381,2249
1984,37860,4943,5668,78982,76075,931,17,567,10.3,15638,6190,9448,8.1,20.6,9824,3426,6398,4.5,12.9,5814,7.7,25.8,0,380,382,2096
1985,37860,5242,5993,84073,81648,995,17.1,667,11.4,16725,7617,9108,9.3,20.5,11875,5292,6583,6.5,14.5,4850,6,29,0,446,448,2336
1986,37860,5450,6254,86864,85455,1029,16.8,750,12.2,17869,8398,9471,9.8,20.9,15051,5235,9816,6.1,17.6,2818,3.3,35.2,0,514,514,3183
1987,37860,5667,6532,92951,90897,1148,18,822,12.9,20297,9504,10793,10.5,22.3,16188,6337,9851,7,17.8,4109,4.5,35.6,0,540,541,3127
1988,37860,5653,6586,94777,93527,961,14.7,882,13.5,18747,8392,10355,9,20,16246,6212,10034,6.6,17.4,2501,2.6,34.8,0,595,597,3264
1989,37860,5629,6620,95979,95491,857,13,820,12.4,16393,6181,10212,6.5,17.2,15416,5283,10133,5.5,16.1,977,1.1,32.2,0,566,566,3144
1990,37860,5694,6720,98435,97074,918,13.8,782,11.7,17664,6411,11253,6.6,18.2,14942,5707,9235,5.9,15.4,2722,2.8,30.8,0,537,540,3946
1991,37860,5832,6877,99423,98895,950,14,789,11.6,17635,8453,9182,8.5,17.8,16579,5798,10781,5.9,16.8,1056,1,33.6,0,497,512,2878
1992,37860,6004,7052,103400,101538,1025,14.7,826,11.8,20083,7257,12826,7.1,19.8,16358,5920,10438,5.8,16.1,3725,3.7,32.2,0,532,537,3209
1993,37860,6170,7228,105157,104172,894,12.5,705,9.9,17716,6161,11555,5.9,17,15746,4477,11269,4.3,15.1,1970,1.9,30.2,0,491,491,2420
1994,37860,6249,7295,109716,107159,894,12.3,799,11,19390,6743,12647,6.3,18.1,14275,5063,9212,4.7,13.3,5115,4.8,26.6,0,541,541,3023
1995,37860,6302,7394,117681,113658,926,12.6,790,10.8,22759,9121,13638,8,20,14713,5999,8714,5.3,12.9,8046,7.1,25.8,0,570,570,3186
1996,37860,6375,7455,118559,118112,902,12.2,816,11,20468,7311,13157,6.2,17.3,19573,8414,11159,7.1,16.6,895,0.7,33.2,0,534,534,5689
1997,37860,6435,7580,119348,118960,1038,13.8,902,12,21014,8387,12627,7.1,17.7,20238,7850,12388,6.6,17,776,0.7,34,0,589,589,3479
1998,37860,6471,7666,122049,120631,1009,13.2,902,11.8,22726,8074,14652,6.7,18.8,19889,7656,12233,6.3,16.5,2837,2.3,33,0,593,593,3188
1999,37860,6405,7657,123545,122722,950,12.4,946,12.4,22946,8575,14371,7,18.7,21300,9021,12279,7.4,17.4,1646,1.3,34.8,0,610,610,3504
2000,37860,6315,7607,132256,128921,922,12.1,967,12.7,25998,8026,17972,6.2,20.2,19328,9099,10229,7.1,15,6670,5.2,30,0,576,576,4657
2001,37860,6362,7705,128343,130530,925,12.1,881,11.5,19309,7037,12272,5.4,14.8,23683,6833,16850,5.2,18.1,-4374,-3.3,29.6,0,515,516,2759
2002,37860,6416,7703,125303,126751,1074,14,1064,13.8,22628,9830,12798,7.8,17.9,25523,13018,12505,10.3,20.1,-2895,-2.2,35.8,0,565,565,6575
2003,37860,6610,7888,132013,128224,1052,13.6,724,9.3,23101,8305,14796,6.5,18,15523,5081,10442,4,12.1,7578,5.9,24.2,0,520,521,2835
2004,37860,6899,8201,133046,132102,1246,15.5,851,10.6,27056,8729,18327,6.6,20.5,25167,12157,13010,9.2,19.1,1889,1.4,38.2,0,600,605,3871
2005,37860,7011,8379,142789,137483,1135,13.7,851,10.3,26749,12526,14223,9.1,19.5,16136,4695,11441,3.4,11.7,10613,7.8,23.4,0,607,607,3043
2006,37860,7164,8572,148779,145455,1150,13.6,902,10.7,25447,8166,17281,5.6,17.5,18799,6564,12235,4.5,12.9,6648,4.6,25.8,0,609,609,3377
2007,37860,7262,8737,142442,145430,1174,13.6,996,11.5,19259,9061,10198,6.2,13.2,25235,7610,17625,5.2,17.4,-5976,-4.2,26.4,0,666,680,3121
2008,37860,6994,8496,140646,141020,935,10.9,1063,12.4,18585,6231,12354,4.4,13.2,19332,6281,13051,4.5,13.7,-747,-0.5,26.4,0,758,758,3839
2009,37860,6661,8145,133792,136735,819,9.9,1045,12.6,16247,5401,10846,3.9,11.9,22133,5066,17067,3.7,16.2,-5886,-4.3,23.8,0,710,714,3085
2010,37860,6588,8055,127409,130356,752,9.3,804,10,13537,5088,8449,3.9,10.4,19431,3615,15816,2.8,14.9,-5894,-4.5,20.8,0,514,514,2187
2011,37860,6526,7982,128446,127814,829,10.4,870,10.9,19508,6649,12859,5.2,15.3,18244,4881,13363,3.8,14.3,1264,1,28.6,0,571,572,2560
2012,37860,6549,8039,134679,130994,861,10.8,813,10.2,21682,6785,14897,5.2,16.6,14312,5046,9266,3.9,10.9,7370,5.7,21.8,0,502,504,3254
2013,37860,6585,8088,134343,134225,796,9.9,751,9.3,19882,5547,14335,4.1,14.8,19646,9063,10583,6.8,14.6,236,0.2,29.2,0,487,488,2435
2014,37860,6566,8084,135323,133990,851,10.6,759,9.4,17445,5450,11995,4.1,13,14778,4974,9804,3.7,11,2667,2,22,0,495,495,2660
1977,37900,6345,7077,141762,138910,1063,15.2,847,12.1,23660,9267,14393,6.7,17,17955,6107,11848,4.4,12.9,5705,4.1,25.8,0,561,570,3963
1978,37900,6441,7217,150431,146100,931,13,796,11.1,25605,5757,19848,3.9,17.5,16942,4868,12074,3.3,11.6,8663,5.9,23.2,0,540,543,2546
1979,37900,6389,7169,152517,151419,795,11.1,803,11.2,25851,5664,20187,3.7,17.1,23654,9314,14340,6.2,15.6,2197,1.5,31.2,0,570,571,3094
1980,37900,6346,7132,148837,150557,762,10.7,773,10.8,17283,5141,12142,3.4,11.5,20722,5247,15475,3.5,13.8,-3439,-2.3,23,0,528,530,3245
1981,37900,5982,6694,134502,139358,675,9.8,991,14.4,13742,5791,7951,4.2,9.9,23454,8056,15398,5.8,16.8,-9712,-6.9,19.8,0,557,557,3108
1982,37900,5895,6715,130071,132091,831,12.4,743,11.1,14983,8234,6749,6.2,11.3,19023,5276,13747,4,14.4,-4040,-3.1,22.6,0,446,446,2594
1983,37900,5835,6682,116796,123438,680,10.2,756,11.3,13491,4277,9214,3.5,10.9,26774,5555,21219,4.5,21.7,-13283,-10.8,21.8,0,396,397,2023
1984,37900,5981,6844,116151,116505,863,12.8,715,10.6,16502,5337,11165,4.6,14.2,17209,5566,11643,4.8,14.8,-707,-0.6,28.4,0,441,443,2217
1985,37900,6078,6921,120331,120266,732,10.6,718,10.4,15794,5097,10697,4.2,13.1,15664,5543,10121,4.6,13,130,0.1,26,0,474,480,3008
1986,37900,6110,6945,121331,120800,739,10.7,696,10,14646,5776,8870,4.8,12.1,13583,4346,9237,3.6,11.2,1063,0.9,22.4,0,439,439,2084
1987,37900,6139,7048,122400,122244,878,12.5,753,10.7,17879,6990,10889,5.7,14.6,17566,6597,10969,5.4,14.4,313,0.2,28.8,0,476,476,2778
1988,37900,6126,7089,130780,124412,810,11.5,688,9.8,25447,6193,19254,5,20.5,12710,5149,7561,4.1,10.2,12737,10.3,20.4,0,466,466,3152
1989,37900,6131,7149,134554,132773,748,10.5,685,9.6,20045,5769,14276,4.3,15.1,16483,5004,11479,3.8,12.4,3562,2.7,24.8,0,461,468,3353
1990,37900,6242,7276,136907,135742,706,9.8,550,7.6,17727,6180,11547,4.6,13.1,15397,4585,10812,3.4,11.3,2330,1.8,22.6,0,352,352,2037
1991,37900,6312,7415,136929,136426,759,10.3,607,8.3,16244,6574,9670,4.8,11.9,15238,4479,10759,3.3,11.2,1006,0.7,22.4,0,394,396,2834
1992,37900,6380,7532,137344,137141,839,11.2,687,9.2,17612,6705,10907,4.9,12.8,17205,4916,12289,3.6,12.5,407,0.3,25,0,435,435,2744
1993,37900,6463,7608,137562,137488,722,9.5,637,8.4,17245,6196,11049,4.5,12.5,17096,4083,13013,3,12.4,149,0.1,24.8,0,439,442,2584
1994,37900,6576,7721,146229,141829,754,9.8,621,8.1,21906,5771,16135,4.1,15.4,13105,3540,9565,2.5,9.2,8801,6.2,18.4,0,409,409,2106
1995,37900,6630,7783,152348,149261,761,9.8,686,8.9,21449,7750,13699,5.2,14.4,15275,4525,10750,3,10.2,6174,4.2,20.4,0,423,423,1957
1996,37900,6717,7856,150509,151402,762,9.7,674,8.6,20318,7190,13128,4.7,13.4,22103,6791,15312,4.5,14.6,-1785,-1.2,26.8,0,409,409,2373
1997,37900,6789,7966,152660,151710,842,10.6,730,9.2,20677,6612,14065,4.4,13.6,18776,6080,12696,4,12.4,1901,1.2,24.8,0,471,471,3491
1998,37900,6768,7988,160548,156496,736,9.2,710,8.9,25040,8028,17012,5.1,16,16936,6744,10192,4.3,10.8,8104,5.2,21.6,0,495,495,4338
1999,37900,6795,8019,162536,161533,688,8.6,650,8.1,19126,5770,13356,3.6,11.8,17119,4901,12218,3,10.6,2007,1.2,21.2,0,402,402,2266
2000,37900,6779,8007,163725,163128,711,8.9,721,9,22653,7328,15325,4.5,13.9,21458,5741,15717,3.5,13.2,1195,0.7,26.4,0,439,439,2144
2001,37900,6707,7958,158761,161335,675,8.4,775,9.7,17416,5283,12133,3.3,10.8,22564,6013,16551,3.7,14,-5148,-3.2,21.6,0,447,449,2430
2002,37900,6706,7990,157671,158124,855,10.7,802,10.1,21632,9118,12514,5.8,13.7,22537,6887,15650,4.4,14.3,-905,-0.6,27.4,0,395,395,2481
2003,37900,6717,8020,153719,154696,754,9.5,612,7.7,16405,5448,10957,3.5,10.6,18358,4426,13932,2.9,11.9,-1953,-1.3,21.2,0,422,422,2300
2004,37900,6783,8069,156481,154658,781,9.7,648,8.1,20080,5734,14346,3.7,13,16433,5646,10787,3.7,10.6,3647,2.4,21.2,0,424,431,3301
2005,37900,6737,8055,159286,157414,724,9,677,8.4,20216,8016,12200,5.1,12.8,16471,5513,10958,3.5,10.5,3745,2.3,21,0,456,457,3147
2006,37900,6761,8120,170025,164776,767,9.5,632,7.8,23676,6228,17448,3.8,14.4,13177,3924,9253,2.4,8,10499,6.4,16,0,411,411,2578
2007,37900,6820,8215,170339,169912,770,9.4,674,8.3,19861,5532,14329,3.3,11.7,19007,5150,13857,3,11.2,854,0.5,22.4,0,379,387,2681
2008,37900,6751,8197,175603,172735,684,8.4,616,7.5,21344,6319,15025,3.7,12.4,15607,3545,12062,2.1,9,5737,3.4,18,0,412,412,2288
2009,37900,6574,8000,166216,170597,555,6.9,694,8.6,14718,4833,9885,2.8,8.6,23482,6752,16730,4,13.8,-8764,-5.2,17.2,0,475,478,3371
2010,37900,6508,7953,162344,164053,578,7.3,583,7.3,17764,6717,11047,4.1,10.8,21183,5511,15672,3.4,12.9,-3419,-2.1,21.6,0,382,383,3573
2011,37900,6419,7853,164894,163197,586,7.4,627,8,18943,5641,13302,3.5,11.6,15548,3565,11983,2.2,9.5,3395,2.1,19,0,425,429,2163
2012,37900,6456,7866,170145,167445,602,7.7,589,7.5,22818,6865,15953,4.1,13.6,17418,5235,12183,3.1,10.4,5400,3.2,20.8,0,315,316,2271
2013,37900,6354,7784,167307,168386,496,6.4,563,7.2,15645,5075,10570,3,9.3,17802,4433,13369,2.6,10.6,-2157,-1.3,18.6,0,362,363,2914
2014,37900,6296,7737,167362,166916,568,7.3,563,7.3,20179,8610,11569,5.2,12.1,19287,7095,12192,4.3,11.6,892,0.5,23.2,0,376,378,3901
1977,37980,79142,92676,1781721,1738936,13754,15.1,10919,12,347544,139272,208272,8,20,261976,95557,166419,5.5,15.1,85568,4.9,30.2,0,7039,7082,46631
1978,37980,79831,93498,1782781,1776698,11824,12.7,11003,11.8,348643,90086,258557,5.1,19.6,336478,160519,175959,9,18.9,12165,0.7,37.8,0,7442,7474,97218
1979,37980,80938,95162,1788918,1785132,11936,12.7,9780,10.4,300586,96073,204513,5.4,16.8,293015,91555,201460,5.1,16.4,7571,0.4,32.8,0,6719,6759,38989
1980,37980,81649,95816,1806611,1796159,11290,11.8,10310,10.8,284646,101811,182835,5.7,15.8,263741,95773,167968,5.3,14.7,20905,1.1,29.4,0,7055,7114,42988
1981,37980,79215,93063,1794393,1800205,10747,11.4,12658,13.4,286036,113512,172524,6.3,15.9,297659,117578,180081,6.5,16.5,-11623,-0.6,31.8,0,7269,7305,43831
1982,37980,80046,95296,1806093,1799706,13013,13.8,10031,10.6,299182,125191,173991,7,16.6,286408,94796,191612,5.3,15.9,12774,0.7,31.8,0,5579,5595,37144
1983,37980,82377,97607,1814335,1811322,11281,11.7,9741,10.1,302217,109960,192257,6.1,16.7,296191,95069,201122,5.2,16.4,6026,0.3,32.8,0,6133,6170,38792
1984,37980,84058,99594,1902336,1856041,12223,12.4,10303,10.5,337322,112235,225087,6,18.2,244731,86758,157973,4.7,13.2,92591,5,26.4,0,6391,6405,36668
1985,37980,86197,102037,1967477,1940243,13033,12.9,10661,10.6,330329,111154,219175,5.7,17,275861,117729,158132,6.1,14.2,54468,2.8,28.4,0,6648,6693,60854
1986,37980,89614,105868,2072864,2018810,14775,14.2,10607,10.2,396722,168275,228447,8.3,19.7,288614,109698,178916,5.4,14.3,108108,5.4,28.6,0,6740,6767,49431
1987,37980,92440,109737,2122543,2104850,15884,14.7,11677,10.8,378463,137554,240909,6.5,18,343077,123418,219659,5.9,16.3,35386,1.7,32.6,0,7361,7407,54436
1988,37980,94009,112082,2168588,2139076,14697,13.3,11971,10.8,403227,149452,253775,7,18.9,344204,137596,206608,6.4,16.1,59023,2.8,32.2,0,7743,7743,64123
1989,37980,96074,114898,2208817,2185624,14407,12.7,11730,10.3,375022,142418,232604,6.5,17.2,328635,113453,215182,5.2,15,46387,2.2,30,0,7552,7607,58426
1990,37980,97684,117100,2237335,2222612,13900,12,11094,9.6,338061,113235,224826,5.1,15.2,308614,92892,215722,4.2,13.9,29447,1.3,27.8,0,7490,7508,52853
1991,37980,97748,118207,2217581,2233046,13696,11.6,12541,10.7,340121,133491,206630,6,15.2,371051,114180,256871,5.1,16.6,-30930,-1.4,30.4,0,7882,7982,55641
1992,37980,97065,117955,2154279,2182183,13230,11.2,12960,11,321993,119729,202264,5.5,14.8,377801,124933,252868,5.7,17.3,-55808,-2.5,29.6,0,8032,8142,55034
1993,37980,97598,117903,2173265,2163207,12137,10.3,11801,10,327139,104762,222377,4.8,15.1,307023,98538,208485,4.6,14.2,20116,0.9,28.4,0,7561,7611,47220
1994,37980,97997,118616,2200043,2183984,12571,10.6,11542,9.8,353740,117962,235778,5.4,16.2,321623,111668,209955,5.1,14.7,32117,1.5,29.4,0,7497,7567,58728
1995,37980,99663,120567,2242474,2207949,13746,11.5,11414,9.5,352678,120243,232435,5.4,16,283629,103426,180203,4.7,12.8,69049,3.2,25.6,0,7463,7495,51509
1996,37980,100450,121599,2268871,2257650,13258,11,12070,10,336082,127421,208661,5.6,14.9,313640,112364,201276,5,13.9,22442,1,27.8,0,7890,7890,53812
1997,37980,101555,123642,2313477,2293211,15024,12.2,13093,10.7,397940,137287,260653,6,17.4,357408,141958,215450,6.2,15.6,40532,1.8,31.2,0,7754,7754,59158
1998,37980,102111,124393,2367504,2340094,13834,11.2,12794,10.3,390235,140899,249336,6,16.7,335417,126749,208668,5.4,14.3,54818,2.4,28.6,0,8045,8045,51872
1999,37980,102739,125560,2403316,2386057,13608,10.9,12325,9.9,371602,136172,235430,5.7,15.6,337085,115951,221134,4.9,14.1,34517,1.5,28.2,0,7776,7776,50843
2000,37980,103173,126571,2486934,2444985,13762,10.9,12805,10.2,427108,168413,258695,6.9,17.5,343211,130622,212589,5.3,14,83897,3.5,28,0,7668,7668,49016
2001,37980,104269,129075,2528218,2511886,14323,11.2,12837,10,401827,156343,245484,6.2,16,369162,134357,234805,5.3,14.7,32665,1.3,29.4,0,7494,7498,54219
2002,37980,104161,129525,2525526,2524864,15264,11.8,14647,11.3,450185,187225,262960,7.4,17.8,448862,177526,271336,7,17.8,1323,0,35.6,0,7500,7536,47659
2003,37980,104733,130374,2526270,2510503,14425,11.1,11661,9,405398,139694,265704,5.6,16.1,373864,107428,266436,4.3,14.9,31534,1.2,29.8,0,7615,7637,55867
2004,37980,106096,131640,2541936,2526193,14161,10.8,11826,9,378302,122013,256289,4.8,15,346817,136789,210028,5.4,13.7,31485,1.3,27.4,0,7414,7430,71280
2005,37980,107299,133252,2517741,2524169,14944,11.3,12229,9.3,356797,143579,213218,5.7,14.1,369653,137422,232231,5.4,14.6,-12856,-0.5,28.2,0,7763,7788,61558
2006,37980,107377,134320,2542187,2522257,14953,11.2,12620,9.5,363934,134458,229476,5.3,14.4,324073,115347,208726,4.6,12.8,39861,1.6,25.6,0,8416,8455,63138
2007,37980,107097,134687,2571125,2551358,14489,10.8,13591,10.1,405595,146239,259356,5.7,15.9,366061,123300,242761,4.8,14.3,39534,1.6,28.6,0,8138,8173,50987
2008,37980,106777,135174,2604607,2577822,13718,10.2,12134,9,376022,133880,242142,5.2,14.6,322451,97234,225217,3.8,12.5,53571,2.1,25,0,8437,8454,56469
2009,37980,103931,132135,2490936,2539091,11365,8.5,13155,9.9,288428,97035,191393,3.8,11.4,384737,114902,269835,4.5,15.2,-96309,-3.8,22.8,0,8465,8523,54878
2010,37980,102498,130514,2426058,2452461,11658,8.9,12358,9.4,289469,112356,177113,4.6,11.8,342275,114673,227602,4.7,14,-52806,-2.2,23.6,0,7524,7531,60617
2011,37980,101766,129915,2457047,2435940,11696,9,11416,8.8,307748,90041,217707,3.7,12.6,265533,84428,181105,3.5,10.9,42215,1.7,21.8,0,7236,7257,43235
2012,37980,102641,130624,2497714,2474054,12413,9.5,11660,9,334683,103519,231164,4.2,13.5,287362,101265,186097,4.1,11.6,47321,1.9,23.2,0,6671,6707,44504
2013,37980,103037,131584,2547318,2520328,12262,9.4,11142,8.5,339796,116597,223199,4.6,13.5,285816,87500,198316,3.5,11.3,53980,2.2,22.6,0,6829,6863,51222
2014,37980,103158,131525,2586563,2559384,12155,9.3,11234,8.6,334335,109668,224667,4.3,13.1,279976,83116,196860,3.2,10.9,54359,2.2,21.8,0,7300,7336,43912
1977,38060,22447,26772,404681,394748,5808,22.5,3785,14.7,100554,47554,53000,12,25.5,80689,28889,51800,7.3,20.4,19865,5.1,40.8,0,2602,2619,18801
1978,38060,21663,26095,444645,424121,4754,18,5146,19.5,109281,38661,70620,9.1,25.8,68234,36055,32179,8.5,16.1,41047,9.7,32.2,0,3045,3071,17536
1979,38060,25011,29788,519443,482616,5794,20.7,2336,8.4,134723,47210,87513,9.8,27.9,61069,20042,41027,4.2,12.7,73654,15.2,25.4,0,71,81,837
1980,38060,26295,31319,539985,529165,5817,19,4107,13.4,114224,48007,66217,9.1,21.6,92584,31822,60762,6,17.5,21640,4.1,35,0,2925,2935,18337
1981,38060,26542,31693,543604,538289,5695,18.1,4981,15.8,106360,45823,60537,8.5,19.8,95730,35398,60332,6.6,17.8,10630,2,35.6,0,3139,3145,19065
1982,38060,28006,33988,553537,548487,6912,21,4378,13.3,122744,61841,60903,11.3,22.4,112643,35883,76760,6.5,20.5,10101,1.9,41,0,2418,2419,15525
1983,38060,29588,35695,574356,561837,6023,17.3,4460,12.8,130933,53009,77924,9.4,23.3,105895,35128,70767,6.3,18.8,25038,4.5,37.6,0,2955,2966,19383
1984,38060,31917,38274,650259,613247,7066,19.1,4481,12.1,163784,61361,102423,10,26.7,89759,33876,55883,5.5,14.6,74025,12.1,29.2,0,2862,2873,18304
1985,38060,34281,40905,734906,694496,7553,19.1,4889,12.3,186246,66213,120033,9.5,26.8,105425,43254,62171,6.2,15.2,80821,11.6,30.4,0,3202,3215,23942
1986,38060,36205,43289,772928,753439,8044,19.1,5495,13.1,186067,79981,106086,10.6,24.7,147089,53269,93820,7.1,19.5,38978,5.2,39,0,3710,3714,27921
1987,38060,37656,45580,783031,779834,8818,19.8,6291,14.1,166578,78101,88477,10,21.4,160185,67147,93038,8.6,20.5,6393,0.9,41,0,4029,4058,30544
1988,38060,37930,46382,809583,791920,7791,17,6741,14.7,183336,78171,105165,9.9,23.2,148010,60959,87051,7.7,18.7,35326,4.5,37.4,0,4504,4504,30639
1989,38060,37986,46730,841836,826375,7353,15.8,6916,14.9,181020,72937,108083,8.8,21.9,150100,61758,88342,7.5,18.2,30920,3.7,36.4,0,4615,4633,34140
1990,38060,38379,47315,850651,845156,7192,15.3,6184,13.2,164808,65593,99215,7.8,19.5,153819,55557,98262,6.6,18.2,10989,1.3,36.4,0,4177,4206,30703
1991,38060,39364,48714,855820,853228,7550,15.7,6137,12.8,167162,80475,86687,9.4,19.6,161979,59545,102434,7,19,5183,0.6,38,0,3846,3874,33383
1992,38060,40153,49582,869414,861947,7602,15.4,6504,13.2,171609,69797,101812,8.1,19.9,156675,54124,102551,6.3,18.2,14934,1.7,36.4,0,4025,4143,28728
1993,38060,41352,50562,902958,886636,7163,14.3,6020,12,173541,65250,108291,7.4,19.6,140897,56127,84770,6.3,15.9,32644,3.7,31.8,0,3851,3885,26038
1994,38060,42963,52574,965688,933718,8121,15.8,5931,11.5,207870,81031,126839,8.7,22.3,143929,56313,87616,6,15.4,63941,6.9,30.8,0,3968,3980,25900
1995,38060,44746,54629,1044107,1005039,8490,15.8,6118,11.4,215089,81461,133628,8.1,21.4,136952,51256,85696,5.1,13.6,78137,7.8,27.2,0,4058,4123,28850
1996,38060,46393,56746,1109127,1076356,8648,15.5,6396,11.5,216538,84185,132353,7.8,20.1,150997,58034,92963,5.4,14,65541,6.1,28,0,4222,4222,30449
1997,38060,48144,59443,1185321,1147366,9848,16.9,7296,12.5,276600,111060,165540,9.7,24.1,200690,87427,113263,7.6,17.5,75910,6.6,35,0,4453,4453,32123
1998,38060,49012,60742,1243918,1215474,8845,14.7,7382,12.3,254335,95440,158895,7.9,20.9,197447,84882,112565,7,16.2,56888,4.7,32.4,0,4831,4831,50358
1999,38060,50060,62439,1299679,1272124,9311,15.1,7522,12.2,264745,110153,154592,8.7,20.8,209636,81573,128063,6.4,16.5,55109,4.3,33,0,4656,4656,40637
2000,38060,50491,63611,1370385,1336061,9089,14.4,7884,12.5,285005,117593,167412,8.8,21.3,216358,77787,138571,5.8,16.2,68647,5.1,32.4,0,4805,4805,34682
2001,38060,51583,65421,1409425,1392271,9467,14.7,8147,12.6,283216,124168,159048,8.9,20.3,248909,94518,154391,6.8,17.9,34307,2.4,35.8,0,4610,4611,33880
2002,38060,52335,66532,1381300,1392224,10277,15.6,9139,13.9,277164,116271,160893,8.4,19.9,299013,103530,195483,7.4,21.5,-21849,-1.6,39.8,0,4815,4825,35585
2003,38060,53406,68021,1418581,1387804,9997,14.9,7090,10.6,290728,112574,178154,8.1,20.9,229175,74565,154610,5.4,16.5,61553,4.4,33,0,4791,4798,41597
2004,38060,54924,69732,1446015,1425304,9940,14.5,7317,10.7,270941,96892,174049,6.8,19,229518,82305,147213,5.8,16.1,41423,2.9,32.2,0,4718,4732,44368
2005,38060,57410,73204,1551042,1494418,11270,15.8,6986,9.8,320488,132466,188022,8.9,21.4,207239,72766,134473,4.9,13.9,113249,7.5,27.8,0,4694,4698,38790
2006,38060,60602,77990,1683233,1613775,13006,17.2,7557,10,338781,133364,205417,8.3,21,199864,67017,132847,4.2,12.4,138917,8.6,24.8,0,5054,5067,37660
2007,38060,62902,81272,1740128,1708690,12515,15.7,8978,11.3,359116,123908,235208,7.3,21,296240,101222,195018,5.9,17.3,62876,3.7,34.6,0,5539,5573,45255
2008,38060,62839,81730,1684721,1705241,10914,13.4,9516,11.7,268856,109527,159329,6.4,15.8,309897,85394,224503,5,18.2,-41041,-2.4,31.6,0,6740,6762,53565
2009,38060,59263,77933,1511936,1591815,8844,11.1,11550,14.5,198527,85719,112808,5.4,12.5,358284,120509,237775,7.6,22.5,-159757,-10,25,0,7859,7890,51313
2010,38060,57585,76062,1467004,1483845,8665,11.3,9516,12.4,221224,92794,128430,6.3,14.9,254906,79801,175105,5.4,17.2,-33682,-2.3,29.8,0,6292,6318,41251
2011,38060,56996,75473,1505493,1482301,8895,11.8,8869,11.7,242863,79313,163550,5.4,16.4,196479,68399,128080,4.6,13.3,46384,3.1,26.6,0,5768,5791,40554
2012,38060,57692,76284,1532371,1514585,9144,12.1,8145,10.8,250076,83947,166129,5.5,16.5,214504,71300,143204,4.7,14.2,35572,2.3,28.4,0,4883,4937,30130
2013,38060,58791,77685,1570793,1549528,8788,11.5,7435,9.7,228051,71822,156229,4.6,14.7,185521,62465,123056,4,12,42530,2.7,24,0,4657,4685,34190
2014,38060,59583,78796,1623445,1592097,9242,11.9,7501,9.6,272402,89287,183115,5.6,17.1,209706,65801,143905,4.1,13.2,62696,3.9,26.4,0,4870,4886,32437
1977,38220,1651,1766,21906,21417,312,18,249,14.3,4067,2042,2025,9.5,19,3089,1492,1597,7,14.4,978,4.6,28.8,0,180,180,933
1978,38220,1559,1667,22346,22076,226,13.2,303,17.7,3773,1245,2528,5.6,17.1,3233,1881,1352,8.5,14.6,540,2.5,29.2,0,183,183,1276
1979,38220,1653,1773,24075,23239,247,14.4,152,8.8,4264,1618,2646,7,18.3,2592,979,1613,4.2,11.2,1672,7.1,22.4,1,3,3,
1980,38220,1637,1768,24891,24477,201,11.4,207,11.7,3930,1155,2775,4.7,16.1,3102,1040,2062,4.2,12.7,828,3.4,25.4,0,165,165,737
1981,38220,1556,1688,22595,22896,184,10.7,231,13.5,3168,1108,2060,4.8,13.8,3769,1277,2492,5.6,16.5,-601,-2.7,27.6,0,164,164,862
1982,38220,1537,1681,22346,22453,224,13.3,210,12.5,3517,1382,2135,6.2,15.7,3731,1276,2455,5.7,16.6,-214,-0.9,31.4,0,123,123,508
1983,38220,1552,1691,21590,21754,185,11,187,11.1,2982,1134,1848,5.2,13.7,3310,891,2419,4.1,15.2,-328,-1.5,27.4,0,124,124,561
1984,38220,1603,1744,22688,22223,228,13.3,187,10.9,4075,1166,2909,5.2,18.3,3145,1198,1947,5.4,14.2,930,4.1,28.4,0,118,118,872
1985,38220,1601,1730,23450,23568,209,12,234,13.4,4395,2068,2327,8.8,18.6,4631,2839,1792,12,19.6,-236,-1,37.2,0,150,151,538
1986,38220,1625,1750,23689,23554,208,12,178,10.2,3086,1243,1843,5.3,13.1,2815,722,2093,3.1,12,271,1.1,24,0,119,119,416
1987,38220,1662,1806,25041,24392,262,14.7,203,11.4,4852,2531,2321,10.4,19.9,3553,1143,2410,4.7,14.6,1299,5.3,29.2,0,129,129,658
1988,38220,1580,1720,25150,24513,164,9.4,208,11.9,4648,1373,3275,5.6,19,3373,1350,2023,5.5,13.8,1275,5.2,27.6,0,141,141,616
1989,38220,1601,1756,25596,25480,170,9.8,145,8.3,3554,1374,2180,5.4,13.9,3322,1200,2122,4.7,13,232,0.9,26,0,100,101,940
1990,38220,1600,1756,25816,25691,174,9.9,164,9.3,3370,747,2623,2.9,13.1,3119,942,2177,3.7,12.1,251,1,24.2,0,112,112,639
1991,38220,1620,1788,26372,26138,178,10,156,8.8,4417,2079,2338,8,16.9,3949,1218,2731,4.7,15.1,468,1.8,30.2,0,106,107,541
1992,38220,1612,1782,26514,26411,199,11.1,193,10.8,3945,1090,2855,4.1,14.9,3738,1153,2585,4.4,14.2,207,0.7,28.4,0,134,138,470
1993,38220,1620,1791,27476,26997,166,9.3,164,9.2,3850,1022,2828,3.8,14.3,2892,906,1986,3.4,10.7,958,3.6,21.4,0,117,121,540
1994,38220,1599,1768,27506,27488,161,9,175,9.8,3337,1245,2092,4.5,12.1,3300,1057,2243,3.8,12,37,0.1,24,0,126,127,769
1995,38220,1585,1750,27950,27584,173,9.8,180,10.2,4118,1922,2196,7,14.9,3385,1816,1569,6.6,12.3,733,2.6,24.6,0,115,115,1170
1996,38220,1596,1755,28674,28414,168,9.6,161,9.2,3433,914,2519,3.2,12.1,2912,939,1973,3.3,10.2,521,1.9,20.4,0,107,107,552
1997,38220,1597,1766,28839,28760,183,10.4,176,10,3761,1057,2704,3.7,13.1,3602,1090,2512,3.8,12.5,159,0.6,25,0,119,119,581
1998,38220,1559,1715,28626,28698,159,9.1,202,11.6,3704,1459,2245,5.1,12.9,3847,1416,2431,4.9,13.4,-143,-0.5,25.8,0,144,144,711
1999,38220,1545,1713,29327,28982,169,9.9,170,9.9,4273,1497,2776,5.2,14.7,3583,1119,2464,3.9,12.4,690,2.3,24.8,0,112,112,605
2000,38220,1536,1710,30451,29872,164,9.6,166,9.7,4281,1151,3130,3.9,14.3,3122,1158,1964,3.9,10.5,1159,3.8,21,0,96,96,579
2001,38220,1524,1714,28710,29645,181,10.6,189,11,3379,1577,1802,5.3,11.4,5248,1130,4118,3.8,17.7,-1869,-6.3,22.8,0,109,109,378
2002,38220,1535,1741,28725,28741,186,10.7,169,9.8,3943,1846,2097,6.4,13.7,3974,1313,2661,4.6,13.8,-31,-0.1,27.4,0,89,89,375
2003,38220,1557,1762,28575,28548,180,10.3,136,7.8,4159,1214,2945,4.3,14.6,4105,1608,2497,5.6,14.4,54,0.2,28.8,0,92,92,507
2004,38220,1540,1769,30770,29566,164,9.3,142,8.1,5980,1965,4015,6.6,20.2,3571,983,2588,3.3,12.1,2409,8.1,24.2,0,104,104,821
2005,38220,1533,1763,30179,30480,151,8.6,139,7.9,3125,898,2227,2.9,10.3,3726,1068,2658,3.5,12.2,-601,-1.9,20.6,0,105,105,578
2006,38220,1487,1723,29631,29789,159,9.2,167,9.6,3096,1313,1783,4.4,10.4,3412,1187,2225,4,11.5,-316,-1.1,20.8,0,127,127,986
2007,38220,1472,1704,27223,28251,145,8.5,157,9.2,2634,1034,1600,3.7,9.3,4690,1991,2699,7,16.6,-2056,-7.3,18.6,0,102,102,381
2008,38220,1451,1666,27241,27085,129,7.7,149,8.9,3461,1637,1824,6,12.8,3149,1138,2011,4.2,11.6,312,1.2,23.2,0,111,111,577
2009,38220,1404,1621,26619,26768,98,6,134,8.2,2250,680,1570,2.5,8.4,2547,672,1875,2.5,9.5,-297,-1.1,16.8,0,94,94,484
2010,38220,1388,1613,25679,26045,110,6.8,117,7.3,2185,515,1670,2,8.4,2916,748,2168,2.9,11.2,-731,-2.8,16.8,0,88,88,606
2011,38220,1345,1556,25234,25396,98,6.2,133,8.4,2339,658,1681,2.6,9.2,2663,757,1906,3,10.5,-324,-1.3,18.4,0,85,85,394
2012,38220,1326,1511,24580,24847,96,6.3,143,9.4,2636,609,2027,2.5,10.6,3169,1464,1705,5.9,12.8,-533,-2.2,21.2,0,75,76,339
2013,38220,1326,1520,23783,24031,114,7.5,99,6.6,2517,981,1536,4.1,10.5,3013,1193,1820,5,12.5,-496,-2,21,0,68,69,348
2014,38220,1313,1500,23222,23390,113,7.5,117,7.8,2426,575,1851,2.5,10.4,2761,849,1912,3.6,11.8,-335,-1.4,20.8,0,79,80,456
1977,38300,37861,45369,851127,835306,6086,13.6,4648,10.4,137223,59848,77375,7.2,16.4,105581,35190,70391,4.2,12.6,31642,3.8,25.2,0,2898,2913,17976
1978,38300,38492,46103,880883,866089,5390,11.8,4659,10.2,141779,37247,104532,4.3,16.4,112191,38380,73811,4.4,13,29588,3.4,26,0,2947,2968,17088
1979,38300,38917,46642,908265,893752,5342,11.5,4561,9.8,142050,38484,103566,4.3,15.9,113023,34999,78024,3.9,12.6,29027,3.3,25.2,0,3042,3057,14849
1980,38300,38684,46601,933705,925652,4857,10.4,4714,10.1,139423,46429,92994,5,15.1,123318,36128,87190,3.9,13.3,16105,1.8,26.6,0,3176,3183,17107
1981,38300,37228,44949,910642,918310,4472,9.8,5654,12.4,129729,49485,80244,5.4,14.1,145064,46178,98886,5,15.8,-15335,-1.7,28.2,0,3218,3225,17336
1982,38300,37197,45743,901632,903559,5627,12.4,4325,9.5,158969,60337,98632,6.7,17.6,162823,45604,117219,5,18,-3854,-0.4,35.2,0,2348,2352,16336
1983,38300,37895,46327,816178,859204,4638,10.1,4514,9.8,110693,42238,68455,4.9,12.9,196747,39098,157649,4.6,22.9,-86054,-10,25.8,0,2632,2646,13928
1984,38300,38538,46962,828102,821179,5384,11.5,4756,10.2,132811,46431,86380,5.7,16.2,118965,40164,78801,4.9,14.5,13846,1.7,29,0,2664,2693,13764
1985,38300,39172,47540,827342,827668,5545,11.7,4976,10.5,132900,53544,79356,6.5,16.1,133551,55837,77714,6.7,16.1,-651,0,32.2,0,2903,2925,23735
1986,38300,40332,48710,837336,832833,6024,12.5,4682,9.7,135312,55557,79755,6.7,16.2,126305,39882,86423,4.8,15.2,9007,1,30.4,0,2803,2805,15923
1987,38300,41278,50060,859140,852298,6498,13.1,4991,10.1,152003,57965,94038,6.8,17.8,138319,55523,82796,6.5,16.2,13684,1.6,32.4,0,2989,3002,20851
1988,38300,41567,50478,881443,871482,5701,11.3,5060,10.1,147815,53698,94117,6.2,17,127895,46681,81214,5.4,14.7,19920,2.3,29.4,0,3144,3147,18351
1989,38300,42300,51436,906557,892604,5582,11,4692,9.2,147636,51446,96190,5.8,16.5,119731,44329,75402,5,13.4,27905,3.1,26.8,0,2959,2987,20629
1990,38300,43009,52399,947056,926944,5448,10.5,4240,8.2,149683,45450,104233,4.9,16.1,109458,36431,73027,3.9,11.8,40225,4.3,23.6,0,2802,2806,18168
1991,38300,43643,53323,937465,942870,5454,10.3,4576,8.7,129104,50558,78546,5.4,13.7,139916,54082,85834,5.7,14.8,-10812,-1.1,27.4,0,2762,2841,24374
1992,38300,43542,53420,941844,939141,5324,10,5080,9.5,137943,45780,92163,4.9,14.7,132538,42562,89976,4.5,14.1,5405,0.6,28.2,0,3121,3198,19893
1993,38300,43707,53302,949745,946357,4718,8.8,4707,8.8,137857,44749,93108,4.7,14.6,131081,37482,93599,4,13.9,6776,0.7,27.8,0,2948,2980,17761
1994,38300,43633,53312,948377,948948,4790,9,4598,8.6,131662,46440,85222,4.9,13.9,132805,46411,86394,4.9,14,-1143,-0.1,27.8,0,2991,2999,18567
1995,38300,44070,53822,969806,958578,5074,9.5,4397,8.2,129794,43746,86048,4.6,13.5,107337,36127,71210,3.8,11.2,22457,2.3,22.4,0,2836,2854,18237
1996,38300,44325,54258,979279,976151,5035,9.3,4520,8.4,130564,44338,86226,4.5,13.4,124307,45825,78482,4.7,12.7,6257,0.7,25.4,0,2922,2922,22592
1997,38300,44594,55039,1003933,992752,5798,10.6,5057,9.2,163550,58872,104678,5.9,16.5,141188,49790,91398,5,14.2,22362,2.3,28.4,0,3010,3010,22850
1998,38300,44448,55163,1017888,1012052,5197,9.4,4925,8.9,144182,45175,99007,4.5,14.2,132510,43553,88957,4.3,13.1,11672,1.1,26.2,0,3088,3088,22240
1999,38300,44229,55177,1023274,1020124,5004,9.1,4954,9,141518,50773,90745,5,13.9,135217,43124,92093,4.2,13.3,6301,0.6,26.6,0,3102,3102,19876
2000,38300,44175,55256,1043048,1032965,4922,8.9,4854,8.8,157434,54786,102648,5.3,15.2,137268,43770,93498,4.2,13.3,20166,1.9,26.6,0,2882,2882,16898
2001,38300,44151,55569,1038207,1042742,4945,8.9,5047,9.1,139706,49124,90582,4.7,13.4,148776,46645,102131,4.5,14.3,-9070,-0.9,26.8,0,2894,2895,19219
2002,38300,43871,55266,1049195,1041571,5738,10.4,5948,10.7,173085,68948,104137,6.6,16.6,157836,59996,97840,5.8,15.2,15249,1.4,30.4,0,2784,2789,18730
2003,38300,43624,55119,1049169,1042776,5245,9.6,4499,8.2,163170,64306,98864,6.2,15.6,150383,42962,107421,4.1,14.4,12787,1.2,28.8,0,2873,2904,20748
2004,38300,43850,55428,1043966,1043821,5090,9.2,4284,7.8,138601,46599,92002,4.5,13.3,138312,51766,86546,5,13.3,289,0,26.6,0,2765,2765,18350
2005,38300,44120,55934,1039738,1039243,5430,9.8,4482,8.1,139718,54474,85244,5.2,13.4,138729,44848,93881,4.3,13.3,989,0.1,26.6,0,2951,2955,27374
2006,38300,43674,55935,1049241,1040479,5184,9.3,4636,8.3,148695,57336,91359,5.5,14.3,131170,45418,85752,4.4,12.6,17525,1.7,25.2,0,3078,3094,28276
2007,38300,43479,55807,1057287,1050504,5183,9.3,5057,9.1,150764,51451,99313,4.9,14.4,137198,44121,93077,4.2,13.1,13566,1.3,26.2,0,2905,2950,18043
2008,38300,42896,55276,1059261,1055328,4392,7.9,4318,7.8,141082,47054,94028,4.5,13.4,133215,36241,96974,3.4,12.6,7867,0.8,25.2,0,2811,2811,17823
2009,38300,42123,54492,1030768,1041033,4016,7.3,4432,8.1,111051,39250,71801,3.8,10.7,131581,37956,93625,3.6,12.6,-20530,-1.9,21.4,0,2716,2739,19418
2010,38300,41648,54129,1022139,1024850,3892,7.2,3945,7.3,119835,37351,82484,3.6,11.7,125257,28037,97220,2.7,12.2,-5422,-0.5,23.4,0,2377,2378,14063
2011,38300,41236,54195,1051528,1035172,4319,8,3883,7.2,145408,55656,89752,5.4,14,112695,34778,77917,3.4,10.9,32713,3.1,21.8,0,2388,2392,15957
2012,38300,41585,54508,1075854,1061930,4325,8,3901,7.2,144302,41322,102980,3.9,13.6,116454,31569,84885,3,11,27848,2.6,22,0,2251,2281,14112
2013,38300,41370,54636,1080982,1076492,4018,7.4,3855,7.1,123597,36897,86700,3.4,11.5,114616,31583,83033,2.9,10.6,8981,0.9,21.2,0,2372,2377,19209
2014,38300,41432,54752,1080607,1077881,4418,8.1,3860,7.1,121883,40211,81672,3.7,11.3,116430,36514,79916,3.4,10.8,5453,0.5,21.6,0,2536,2547,17307
1977,38340,2593,2839,45596,43793,414,14.8,333,11.9,9338,5612,3726,12.8,21.3,5731,2244,3487,5.1,13.1,3607,8.2,26.2,0,218,218,1144
1978,38340,2680,2930,48604,47082,391,13.6,298,10.3,7211,1876,5335,4,15.3,4167,1767,2400,3.8,8.9,3044,6.4,17.8,0,207,208,847
1979,38340,2667,2913,47087,47818,319,10.9,319,10.9,6829,2210,4619,4.6,14.3,8291,3359,4932,7,17.3,-1462,-3,28.6,0,232,232,1401
1980,38340,2653,2900,47752,47480,290,10,296,10.2,5656,1368,4288,2.9,11.9,5111,1807,3304,3.8,10.8,545,1.1,21.6,0,209,211,975
1981,38340,2619,2851,47364,47323,289,10.1,307,10.7,6099,1961,4138,4.1,12.9,6016,2562,3454,5.4,12.7,83,0.2,25.4,0,172,172,753
1982,38340,2651,2940,50404,49747,388,13.4,273,9.4,7472,2969,4503,6,15,6158,1480,4678,3,12.4,1314,2.6,24.8,0,163,163,807
1983,38340,2694,2981,51326,50954,297,10,284,9.6,7028,2249,4779,4.4,13.8,6284,2183,4101,4.3,12.3,744,1.5,24.6,0,190,191,954
1984,38340,2814,3101,53488,52391,368,12.1,249,8.2,8717,2954,5763,5.6,16.6,6522,1636,4886,3.1,12.4,2195,4.2,24.8,0,159,159,682
1985,38340,2910,3194,54280,53545,410,13,317,10.1,8729,1929,6800,3.6,16.3,7259,3154,4105,5.9,13.6,1470,2.7,27.2,0,217,218,1658
1986,38340,3015,3301,56943,55571,436,13.4,307,9.5,10317,3655,6662,6.6,18.6,7572,3226,4346,5.8,13.6,2745,5,27.2,0,204,208,1904
1987,38340,3136,3440,58020,57414,487,14.4,334,9.9,9289,3857,5432,6.7,16.2,8076,2875,5201,5,14.1,1213,2.1,28.2,0,224,224,1674
1988,38340,3202,3510,58369,58114,438,12.6,347,10,8758,3773,4985,6.5,15.1,8249,2328,5921,4,14.2,509,0.9,28.4,0,238,238,1145
1989,38340,3291,3652,58758,58684,480,13.4,370,10.3,9104,3291,5813,5.6,15.5,8956,3363,5593,5.7,15.3,148,0.2,30.6,0,263,271,1847
1990,38340,3253,3619,56813,57731,365,10,367,10.1,7018,2285,4733,4,12.2,8853,3478,5375,6,15.3,-1835,-3.1,24.4,0,255,255,1453
1991,38340,3184,3577,54347,55643,380,10.6,409,11.4,7166,3042,4124,5.5,12.9,9758,2443,7315,4.4,17.5,-2592,-4.6,25.8,0,291,293,1309
1992,38340,3102,3520,53170,53711,345,9.7,398,11.2,6942,1972,4970,3.7,12.9,8024,2270,5754,4.2,14.9,-1082,-2,25.8,0,270,271,1359
1993,38340,3086,3475,52350,52757,300,8.6,329,9.4,7380,1967,5413,3.7,14,8194,2455,5739,4.7,15.5,-814,-1.5,28,0,205,205,783
1994,38340,3086,3492,50816,51576,297,8.5,274,7.9,5591,1917,3674,3.7,10.8,7110,1879,5231,3.6,13.8,-1519,-3,21.6,0,182,183,1094
1995,38340,3151,3553,52300,51534,353,10,277,7.9,6436,1973,4463,3.8,12.5,4904,1534,3370,3,9.5,1532,3,19,0,172,176,987
1996,38340,3149,3535,51700,51991,317,8.9,332,9.4,5984,1879,4105,3.6,11.5,6566,2744,3822,5.3,12.6,-582,-1.1,23,0,214,214,1019
1997,38340,3164,3569,53614,52595,373,10.5,328,9.2,8074,3401,4673,6.5,15.4,6036,2162,3874,4.1,11.5,2038,3.9,23,0,207,207,1084
1998,38340,3185,3621,53659,53696,362,10.1,305,8.5,7663,2301,5362,4.3,14.3,7737,1997,5740,3.7,14.4,-74,-0.1,28.6,0,196,196,1118
1999,38340,3213,3654,56050,54841,320,8.8,287,7.9,8428,3244,5184,5.9,15.4,6009,1818,4191,3.3,11,2419,4.4,22,0,190,190,1060
2000,38340,3269,3683,57524,56761,363,9.9,336,9.2,9173,3125,6048,5.5,16.2,7647,3764,3883,6.6,13.5,1526,2.7,27,0,198,198,1498
2001,38340,3396,3811,57188,57649,353,9.3,317,8.4,6360,2290,4070,4,11,7281,2149,5132,3.7,12.6,-921,-1.6,22,0,197,197,1222
2002,38340,3368,3793,55237,56102,414,10.9,424,11.2,7199,2653,4546,4.7,12.8,8929,2913,6016,5.2,15.9,-1730,-3.1,25.6,0,199,199,937
2003,38340,3352,3768,56769,55838,343,9.1,328,8.7,7891,2496,5395,4.5,14.1,6028,2107,3921,3.8,10.8,1863,3.3,21.6,0,208,208,778
2004,38340,3445,3865,55867,56154,403,10.6,282,7.4,5537,1812,3725,3.2,9.9,6110,1693,4417,3,10.9,-573,-1,19.8,0,185,185,1112
2005,38340,3327,3756,60089,57939,390,10.2,489,12.8,10086,5558,4528,9.6,17.4,5786,1907,3879,3.3,10,4300,7.4,20,0,399,399,1463
2006,38340,3329,3764,58720,59343,361,9.6,316,8.4,6701,1992,4709,3.4,11.3,7947,3203,4744,5.4,13.4,-1246,-2.1,22.6,0,214,214,2805
2007,38340,3352,3798,57010,57805,385,10.2,339,9,5862,2088,3774,3.6,10.1,7451,1730,5721,3,12.9,-1589,-2.8,20.2,0,201,203,932
2008,38340,3287,3752,62554,59650,301,8,322,8.6,11488,6814,4674,11.4,19.3,5680,1658,4022,2.8,9.5,5808,9.8,19,0,223,223,1147
2009,38340,3162,3613,58747,60323,240,6.5,351,9.6,6116,2057,4059,3.4,10.1,9267,2473,6794,4.1,15.4,-3151,-5.3,20.2,0,213,213,1560
2010,38340,3127,3574,53692,56133,257,7.2,283,7.9,5190,1528,3662,2.7,9.2,10072,2454,7618,4.4,17.9,-4882,-8.7,18.4,0,172,172,1276
2011,38340,3046,3502,52886,53206,236,6.7,280,7.9,5123,1525,3598,2.9,9.6,5763,1170,4593,2.2,10.8,-640,-1.2,19.2,0,182,182,827
2012,38340,3081,3557,53330,53081,321,9.1,274,7.8,6114,1947,4167,3.7,11.5,5616,1588,4028,3,10.6,498,0.9,21.2,0,160,160,853
2013,38340,3015,3465,52789,52928,214,6.1,294,8.4,5029,1246,3783,2.4,9.5,5306,1846,3460,3.5,10,-277,-0.5,19,0,164,164,888
2014,38340,3003,3447,52580,52587,251,7.3,251,7.3,5044,1796,3248,3.4,9.6,5057,1100,3957,2.1,9.6,-13,0,19.2,0,163,163,782
1977,38540,1385,1483,27821,23103,273,19,186,12.9,12361,1823,10538,7.9,53.5,2924,1430,1494,6.2,12.7,9437,40.8,25.4,0,141,141,1083
1978,38540,1316,1415,20102,23924,202,13.9,252,17.4,4253,1734,2519,7.2,17.8,11897,1942,9955,8.1,49.7,-7644,-31.9,35.6,0,147,148,1106
1979,38540,1423,1523,20667,20390,234,15.9,132,9,3370,1705,1665,8.4,16.5,2816,582,2234,2.9,13.8,554,2.7,27.6,1,1,1,
1980,38540,1407,1501,20342,20486,188,12.4,202,13.4,2985,997,1988,4.9,14.6,3273,1007,2266,4.9,16,-288,-1.4,29.2,0,137,137,585
1981,38540,1344,1434,19541,19851,183,12.5,228,15.6,2776,1104,1672,5.6,14,3396,1238,2158,6.2,17.1,-620,-3.1,28,0,146,146,760
1982,38540,1310,1426,18980,19263,215,15,202,14.1,3111,1651,1460,8.6,16.2,3677,1295,2382,6.7,19.1,-566,-2.9,32.4,0,106,106,506
1983,38540,1332,1445,18887,18759,152,10.6,148,10.3,2869,1317,1552,7,15.3,2612,825,1787,4.4,13.9,257,1.4,27.8,0,92,92,418
1984,38540,1333,1458,19604,19245,179,12.3,166,11.4,3105,1110,1995,5.8,16.1,2387,1151,1236,6,12.4,718,3.7,24.8,0,107,107,634
1985,38540,1334,1465,18855,19287,156,10.6,155,10.6,2732,1074,1658,5.6,14.2,3596,1285,2311,6.7,18.6,-864,-4.4,28.4,0,90,90,533
1986,38540,1365,1489,18878,18851,184,12.5,154,10.4,3111,1382,1729,7.3,16.5,3057,812,2245,4.3,16.2,54,0.3,32.4,0,95,95,399
1987,38540,1377,1505,18282,18657,206,13.7,193,12.9,2885,1491,1394,8,15.5,3634,1373,2261,7.4,19.5,-749,-4,31,0,104,104,476
1988,38540,1348,1475,17868,17996,171,11.5,180,12.1,2686,1077,1609,6,14.9,2944,1457,1487,8.1,16.4,-258,-1.5,29.8,0,112,112,632
1989,38540,1347,1477,19539,18708,164,11.1,159,10.8,3741,1432,2309,7.7,20,2080,931,1149,5,11.1,1661,8.9,22.2,0,99,99,498
1990,38540,1374,1511,19406,19456,176,11.8,135,9,2841,964,1877,5,14.6,2940,994,1946,5.1,15.1,-99,-0.5,29.2,0,88,89,693
1991,38540,1421,1555,19877,19629,165,10.8,120,7.8,3298,1312,1986,6.7,16.8,2802,779,2023,4,14.3,496,2.5,28.6,0,64,64,444
1992,38540,1470,1611,20142,20004,199,12.5,147,9.3,3790,1527,2263,7.6,18.9,3514,869,2645,4.3,17.6,276,1.3,35.2,0,93,93,505
1993,38540,1454,1597,19577,19904,145,9,157,9.8,2684,795,1889,4,13.5,3338,1834,1504,9.2,16.8,-654,-3.3,27,0,105,105,767
1994,38540,1483,1631,21471,20495,182,11.3,139,8.6,4409,2387,2022,11.6,21.5,2457,922,1535,4.5,12,1952,9.5,24,0,83,85,460
1995,38540,1513,1644,21727,21589,189,11.5,176,10.8,3153,1430,1723,6.6,14.6,2877,1253,1624,5.8,13.3,276,1.3,26.6,0,109,110,713
1996,38540,1569,1692,22411,22059,204,12.2,145,8.7,3430,1199,2231,5.4,15.5,2725,986,1739,4.5,12.4,705,3.1,24.8,0,85,85,538
1997,38540,1609,1734,22874,22668,216,12.6,182,10.6,3828,1657,2171,7.3,16.9,3415,1222,2193,5.4,15.1,413,1.8,30.2,0,112,112,652
1998,38540,1607,1743,24268,23554,195,11.2,181,10.4,4641,1847,2794,7.8,19.7,3213,1171,2042,5,13.6,1428,6.1,27.2,0,124,124,800
1999,38540,1639,1788,25524,25325,204,11.5,157,8.9,3573,1246,2327,4.9,14.1,3174,927,2247,3.7,12.5,399,1.6,25,0,110,110,517
2000,38540,1625,1793,26505,25992,191,10.7,186,10.4,3811,1245,2566,4.8,14.7,2784,822,1962,3.2,10.7,1027,4,21.4,0,117,117,455
2001,38540,1626,1795,27704,27171,210,11.7,226,12.6,5411,1914,3497,7,19.9,4345,1855,2490,6.8,16,1066,3.9,32,0,106,106,728
2002,38540,1645,1813,25620,26175,248,13.8,227,12.6,4274,2009,2265,7.7,16.3,5383,1915,3468,7.3,20.6,-1109,-4.3,32.6,0,114,114,567
2003,38540,1664,1827,26824,26115,214,11.8,169,9.3,4340,1554,2786,6,16.6,2922,959,1963,3.7,11.2,1418,5.4,22.4,0,117,120,655
2004,38540,1683,1853,27057,26883,203,11.1,165,9,4667,1722,2945,6.4,17.4,4318,1403,2915,5.2,16.1,349,1.3,32.2,0,106,106,641
2005,38540,1701,1885,29835,28190,227,12.2,172,9.2,6651,2814,3837,10,23.6,3361,1086,2275,3.9,11.9,3290,11.7,23.8,0,119,119,849
2006,38540,1748,1940,28525,29180,253,13.2,193,10.1,4094,1582,2512,5.4,14,5404,2802,2602,9.6,18.5,-1310,-4.5,28,0,129,129,1344
2007,38540,1815,2015,29568,29011,252,12.8,177,9,5073,1447,3626,5,17.5,3958,1648,2310,5.7,13.6,1115,3.9,27.2,0,117,117,646
2008,38540,1810,2026,29787,29624,221,11,188,9.3,4062,1394,2668,4.7,13.7,3735,1371,2364,4.6,12.6,327,1.1,25.2,0,137,138,680
2009,38540,1775,1987,30427,29969,193,9.6,220,11,5613,2337,3276,7.8,18.7,4696,1494,3202,5,15.7,917,3,31.4,0,132,132,587
2010,38540,1762,1975,28403,29334,178,9,173,8.8,2769,908,1861,3.1,9.4,4631,797,3834,2.7,15.8,-1862,-6.4,18.8,0,114,115,590
2011,38540,1688,1899,25740,26993,147,7.6,188,9.7,3191,1240,1951,4.6,11.8,5696,2752,2944,10.2,21.1,-2505,-9.3,23.6,0,126,126,2423
2012,38540,1690,1899,26243,26027,170,9,186,9.8,5369,2896,2473,11.1,20.6,4937,2557,2380,9.8,19,432,1.6,38,0,102,102,712
2013,38540,1688,1898,26330,26174,162,8.6,160,8.5,3726,922,2804,3.5,14.2,3414,980,2434,3.7,13,312,1.2,26,0,100,100,658
2014,38540,1689,1897,28110,27179,162,8.6,150,7.9,4712,1176,3536,4.3,17.3,2850,1010,1840,3.7,10.5,1862,6.8,21,0,104,104,503
1977,38860,6913,7684,103846,100887,1209,16,946,12.5,20479,8497,11982,8.4,20.3,14561,5599,8962,5.5,14.4,5918,5.9,28.8,0,602,602,3175
1978,38860,7136,7949,112752,108318,1187,15.2,902,11.5,22364,7331,15033,6.8,20.6,13496,5298,8198,4.9,12.5,8868,8.1,25,0,639,641,3150
1979,38860,7312,8147,117869,115245,1141,14.2,902,11.2,20961,7016,13945,6.1,18.2,15712,5968,9744,5.2,13.6,5249,4.6,27.2,0,654,656,3421
1980,38860,7346,8186,118297,118014,1045,12.8,955,11.7,19523,6269,13254,5.3,16.5,18956,7005,11951,5.9,16.1,567,0.4,32.2,0,658,662,3360
1981,38860,7166,7983,118060,117352,1016,12.6,1115,13.8,20160,7004,13156,6,17.2,18743,7946,10797,6.8,16,1417,1.2,32,0,666,670,2737
1982,38860,7203,8116,122813,120409,1140,14.2,921,11.4,22059,9617,12442,8,18.3,17250,6991,10259,5.8,14.3,4809,4,28.6,0,499,501,3526
1983,38860,7486,8382,127129,125189,1067,12.9,834,10.1,19948,6964,12984,5.6,15.9,16067,6284,9783,5,12.8,3881,3.1,25.6,0,543,544,2941
1984,38860,7937,8876,135481,131234,1312,15.2,808,9.4,22834,8370,14464,6.4,17.4,14340,4777,9563,3.6,10.9,8494,6.5,21.8,0,526,528,2500
1985,38860,8418,9351,141536,138665,1370,15,923,10.1,23300,7248,16052,5.2,16.8,17557,6903,10654,5,12.7,5743,4.1,25.4,0,577,579,2849
1986,38860,9073,10046,151998,146701,1724,17.8,996,10.3,29077,10951,18126,7.5,19.8,18483,7088,11395,4.8,12.6,10594,7.2,25.2,0,661,667,3720
1987,38860,9859,10968,163506,158105,2137,20.3,1182,11.2,32808,14660,18148,9.3,20.8,22006,9682,12324,6.1,13.9,10802,6.9,27.8,0,782,785,4721
1988,38860,10201,11367,176767,169650,1782,16,1309,11.7,35800,10785,25015,6.4,21.1,21566,8333,13233,4.9,12.7,14234,8.4,25.4,0,912,912,4537
1989,38860,10436,11683,181333,179165,1737,15.1,1456,12.6,33576,12702,20874,7.1,18.7,29239,10453,18786,5.8,16.3,4337,2.4,32.6,0,1024,1032,6742
1990,38860,10186,11488,176773,178888,1383,11.9,1456,12.6,27234,11686,15548,6.5,15.2,31464,9255,22209,5.2,17.6,-4230,-2.4,30.4,0,1028,1030,5884
1991,38860,10036,11397,168923,172749,1357,11.9,1383,12.1,21921,8593,13328,5,12.7,29574,7929,21645,4.6,17.1,-7653,-4.4,25.4,0,872,876,4462
1992,38860,9953,11339,162569,165387,1375,12.1,1344,11.8,24462,9298,15164,5.6,14.8,30098,12665,17433,7.7,18.2,-5636,-3.4,29.6,0,841,857,5336
1993,38860,10106,11502,171470,166957,1336,11.7,1123,9.8,30728,12856,17872,7.7,18.4,21701,7599,14102,4.6,13,9027,5.4,26,0,737,740,3415
1994,38860,10370,11789,172173,171611,1460,12.5,1132,9.7,27167,8449,18718,4.9,15.8,26043,8727,17316,5.1,15.2,1124,0.6,30.4,0,764,764,5567
1995,38860,10666,12107,178614,175342,1548,13,1194,10,26783,9485,17298,5.4,15.3,20238,6028,14210,3.4,11.5,6545,3.8,23,0,806,808,3325
1996,38860,11072,12552,179702,179327,1658,13.5,1198,9.7,26135,9722,16413,5.4,14.6,25385,9442,15943,5.3,14.2,750,0.4,28.4,0,833,833,5205
1997,38860,11264,12864,188095,184092,1651,13,1355,10.6,31923,10143,21780,5.5,17.3,23917,9583,14334,5.2,13,8006,4.3,26,0,864,864,5661
1998,38860,11589,13258,193619,190783,1721,13.2,1300,10,29875,12404,17471,6.5,15.7,24202,9510,14692,5,12.7,5673,3,25.4,0,896,896,5573
1999,38860,11877,13586,201539,197575,1634,12.2,1301,9.7,32137,12176,19961,6.2,16.3,24208,7758,16450,3.9,12.3,7929,4,24.6,0,852,852,5083
2000,38860,12074,13827,210287,205857,1592,11.6,1356,9.9,34172,13339,20833,6.5,16.6,25311,10956,14355,5.3,12.3,8861,4.3,24.6,0,849,849,4900
2001,38860,12354,14235,212596,211727,1749,12.4,1440,10.2,32462,15221,17241,7.2,15.3,30725,11327,19398,5.3,14.5,1737,0.8,29,0,882,882,4294
2002,38860,12439,14407,207108,209891,1782,12.4,1601,11.2,31538,13456,18082,6.4,15,37104,12151,24953,5.8,17.7,-5566,-2.7,30,0,826,827,5956
2003,38860,12674,14696,211352,208111,1713,11.8,1228,8.5,32053,12366,19687,5.9,15.4,25570,8259,17311,4,12.3,6483,3.1,24.6,0,800,800,5009
2004,38860,12888,14938,217611,214171,1680,11.4,1311,8.9,30359,9797,20562,4.6,14.2,23478,8605,14873,4,11,6881,3.2,22,0,860,863,4559
2005,38860,13226,15339,219754,218167,1802,11.9,1298,8.6,31177,11359,19818,5.2,14.3,28003,7743,20260,3.5,12.8,3174,1.5,25.6,0,836,836,4497
2006,38860,13321,15555,223095,220564,1867,12.1,1516,9.8,31976,12901,19075,5.8,14.5,26913,9274,17639,4.2,12.2,5063,2.3,24.4,0,1024,1024,6008
2007,38860,13397,15760,221163,221709,1765,11.3,1535,9.8,34707,12696,22011,5.7,15.7,35799,14699,21100,6.6,16.1,-1092,-0.4,31.4,0,949,950,7460
2008,38860,13212,15578,224275,222282,1491,9.6,1528,9.8,30105,9747,20358,4.4,13.5,26119,8808,17311,4,11.8,3986,1.7,23.6,0,1005,1005,6112
2009,38860,12648,15013,213946,218363,1212,7.9,1621,10.6,23165,7610,15555,3.5,10.6,31998,8098,23900,3.7,14.7,-8833,-4.1,21.2,0,981,982,5473
2010,38860,12554,14949,210803,211955,1332,8.9,1313,8.8,23798,8975,14823,4.2,11.2,26102,7439,18663,3.5,12.3,-2304,-1.1,22.4,0,752,752,3599
2011,38860,12448,14843,211299,210692,1353,9.1,1358,9.1,25089,9103,15986,4.3,11.9,23875,7170,16705,3.4,11.3,1214,0.6,22.6,0,752,753,4160
2012,38860,12486,14945,216137,213512,1458,9.8,1362,9.2,29760,9462,20298,4.4,13.9,24510,7331,17179,3.4,11.5,5250,2.4,23,0,763,768,3847
2013,38860,12504,14937,215276,214848,1297,8.7,1291,8.7,25688,7529,18159,3.5,12,24832,8498,16334,4,11.6,856,0.4,23.2,0,751,761,5262
2014,38860,12548,15012,216938,215643,1333,8.9,1181,7.9,24231,7768,16463,3.6,11.2,21641,6614,15027,3.1,10,2590,1.2,20,0,731,732,3952
1977,38900,23341,26941,401903,388802,5253,20.1,3510,13.4,87735,40688,47047,10.5,22.6,61532,28257,33275,7.3,15.8,26203,6.8,31.6,0,2265,2277,16653
1978,38900,24459,28295,460091,430822,5105,18.5,3720,13.5,114727,37281,77446,8.7,26.6,56189,29192,26997,6.8,13,58538,13.6,26,0,2442,2448,14613
1979,38900,25479,29534,488320,473499,5075,17.6,3636,12.6,103228,37414,65814,7.9,21.8,73585,26126,47459,5.5,15.5,29643,6.3,31,0,2561,2563,14239
1980,38900,25947,30104,506274,496825,4714,15.8,4038,13.5,101187,37933,63254,7.6,20.4,82288,29742,52546,6,16.6,18899,3.8,33.2,0,2775,2782,16459
1981,38900,25498,29584,478462,486581,4515,15.1,4709,15.8,78134,39009,39125,8,16.1,94371,35745,58626,7.3,19.4,-16237,-3.3,32.2,0,2787,2793,16551
1982,38900,25438,30116,456049,466701,5094,17.1,4192,14,74661,39516,35145,8.5,16,95965,30891,65074,6.6,20.6,-21304,-4.6,32,0,2269,2277,13831
1983,38900,25914,30613,446416,449473,4139,13.6,3844,12.7,75153,31855,43298,7.1,16.7,81266,25638,55628,5.7,18.1,-6113,-1.4,33.4,0,2393,2401,12562
1984,38900,27188,31973,472942,459774,4935,15.8,3601,11.5,92922,32285,60637,7,20.2,66586,24147,42439,5.3,14.5,26336,5.7,29,0,2356,2361,11865
1985,38900,27821,32611,495228,486897,4731,14.6,4153,12.9,92565,33571,58994,6.9,19,75903,29557,46346,6.1,15.6,16662,3.4,31.2,0,2710,2720,15849
1986,38900,28906,33824,509336,501720,5197,15.6,3888,11.7,95020,39297,55723,7.8,18.9,79787,31933,47854,6.4,15.9,15233,3,31.8,0,2560,2560,17043
1987,38900,29682,35027,534783,525030,5780,16.8,4456,12.9,105509,43104,62405,8.2,20.1,86002,36806,49196,7,16.4,19507,3.7,32.8,0,2849,2868,19406
1988,38900,29957,35569,555582,540601,5105,14.5,4349,12.3,110825,37409,73416,6.9,20.5,80865,33145,47720,6.1,15,29960,5.5,30,0,2917,2917,16048
1989,38900,27116,32883,595526,576016,4413,12.9,7086,20.7,150360,44660,105700,7.8,26.1,111340,66625,44715,11.6,19.3,39020,6.8,38.6,0,2634,2654,17000
1990,38900,31555,37546,617364,606067,8102,23,3287,9.3,136407,68924,67483,11.4,22.5,113812,44825,68987,7.4,18.8,22595,3.7,37.6,0,2102,2116,30148
1991,38900,32730,39110,638160,627237,5692,14.9,4076,10.6,121198,46193,75005,7.4,19.3,99352,33948,65404,5.4,15.8,21846,3.5,31.6,0,2435,2479,15661
1992,38900,33640,40277,634004,635567,5619,14.1,4298,10.8,106779,38967,67812,6.1,16.8,109905,34407,75498,5.4,17.3,-3126,-0.5,33.6,0,2686,2722,18054
1993,38900,34885,41272,655978,645029,5332,13.1,4223,10.4,114351,35197,79154,5.5,17.7,92452,30841,61611,4.8,14.3,21899,3.4,28.6,0,2650,2664,13867
1994,38900,36568,43346,690700,672926,6427,15.2,4239,10,124020,49515,74505,7.4,18.4,88472,32030,56442,4.8,13.1,35548,5.3,26.2,0,2769,2776,14879
1995,38900,37933,44895,727782,707838,6459,14.6,4696,10.6,132178,50187,81991,7.1,18.7,92290,31646,60644,4.5,13,39888,5.7,26,0,3109,3159,17977
1996,38900,39117,46392,769447,748948,6419,14.1,4785,10.5,138610,51870,86740,6.9,18.5,97612,32926,64686,4.4,13,40998,5.5,26,0,3159,3160,17961
1997,38900,40050,47711,809196,789666,6822,14.5,5479,11.6,158724,57741,100983,7.3,20.1,119664,46803,72861,5.9,15.2,39060,4.9,30.4,0,3354,3356,20007
1998,38900,40814,48542,824903,816504,6401,13.3,5405,11.2,140373,53327,87046,6.5,17.2,123574,48357,75217,5.9,15.1,16799,2.1,30.2,0,3417,3417,22908
1999,38900,40970,49092,828568,825821,6287,12.9,5660,11.6,140473,55842,84631,6.8,17,134978,55599,79379,6.7,16.3,5495,0.7,32.6,0,3596,3596,21581
2000,38900,40940,49310,849092,841003,5988,12.2,5781,11.8,146089,60158,85931,7.2,17.4,129910,52072,77838,6.2,15.4,16179,2,30.8,0,3485,3485,20384
2001,38900,41349,50243,860366,856305,6296,12.6,5830,11.7,142927,54967,87960,6.4,16.7,134806,42056,92750,4.9,15.7,8121,1,31.4,0,3374,3379,17494
2002,38900,41480,50538,839869,849024,6705,13.3,6286,12.5,146965,66347,80618,7.8,17.3,165274,55129,110145,6.5,19.5,-18309,-2.2,34.6,0,3312,3320,21047
2003,38900,42052,51121,839640,834825,6476,12.8,4966,9.8,135161,43006,92155,5.2,16.2,125531,41914,83617,5,15,9630,1.2,30,0,3308,3312,21057
2004,38900,42742,52023,849111,842298,6495,12.6,5077,9.9,129413,48605,80808,5.8,15.4,115786,42808,72978,5.1,13.7,13627,1.7,27.4,0,3313,3314,18399
2005,38900,44205,53729,886535,865524,7085,13.4,4885,9.3,144548,58322,86226,6.7,16.7,102527,35820,66707,4.1,11.8,42021,4.9,23.6,0,3190,3194,19596
2006,38900,45492,55586,922094,902519,7587,13.9,5222,9.6,151965,55871,96094,6.2,16.8,112814,41062,71752,4.5,12.5,39151,4.3,25,0,3586,3586,26839
2007,38900,46754,57220,938163,928311,7262,12.9,5537,9.8,149053,52405,96648,5.6,16.1,129349,41856,87493,4.5,13.9,19704,2.2,27.8,0,3484,3512,21276
2008,38900,47078,57739,947940,939591,6557,11.5,5510,9.6,133944,43683,90261,4.6,14.3,117246,35168,82078,3.7,12.5,16698,1.8,25,0,3852,3852,21596
2009,38900,45045,55743,882502,912452,5306,9.4,6663,11.8,101838,35319,66519,3.9,11.2,161738,39717,122021,4.4,17.7,-59900,-6.5,22.4,0,4464,4477,21014
2010,38900,44757,55596,874967,876116,5782,10.4,5518,9.9,117781,36942,80839,4.2,13.4,120079,29410,90669,3.4,13.7,-2298,-0.3,26.8,0,3511,3521,17569
2011,38900,44736,55648,870045,866254,5802,10.5,5284,9.5,119027,33954,85073,3.9,13.7,111447,29577,81870,3.4,12.9,7580,0.8,25.8,0,3460,3474,17501
2012,38900,45531,56401,894195,881312,6266,11.2,5470,9.8,130774,42034,88740,4.8,14.8,105008,35476,69532,4,11.9,25766,2.9,23.8,0,3044,3071,17738
2013,38900,46275,57313,928797,909652,5945,10.5,4968,8.8,128980,36464,92516,4,14.2,90690,28568,62122,3.1,10,38290,4.2,20,0,3157,3159,17341
2014,38900,47040,58206,966459,944632,6297,10.9,4997,8.7,148819,38754,110065,4.1,15.8,105164,31210,73954,3.3,11.1,43655,4.7,22.2,0,3366,3383,17256
1977,38940,2396,2555,46375,44623,543,21.9,381,15.4,7788,3186,4602,7.1,17.5,4283,2121,2162,4.8,9.6,3505,7.9,19.2,0,285,291,1459
1978,38940,2604,2776,31152,38781,578,21.7,363,13.6,9014,4030,4984,10.4,23.2,24271,2800,21471,7.2,62.6,-15257,-39.4,46.4,0,275,276,1395
1979,38940,2787,2990,34754,32918,612,21.2,373,12.9,9466,4543,4923,13.8,28.8,5794,2725,3069,8.3,17.6,3672,11.2,35.2,0,284,285,1939
1980,38940,2977,3198,39940,37264,592,19.1,371,12,10414,3901,6513,10.5,27.9,5062,1762,3300,4.7,13.6,5352,14.3,27.2,0,289,289,1365
1981,38940,3103,3365,41780,40697,669,20.4,470,14.3,10458,4568,5890,11.2,25.7,8291,3372,4919,8.3,20.4,2167,5.3,40.8,0,327,327,1900
1982,38940,3329,3651,42606,42120,762,21.7,439,12.5,9705,4957,4748,11.8,23,8732,2251,6481,5.3,20.7,973,2.3,41.4,0,259,259,1260
1983,38940,3451,3778,41412,41361,616,16.6,497,13.4,8224,4152,4072,10,19.9,8122,2695,5427,6.5,19.6,102,0.3,39.2,0,294,294,1371
1984,38940,3801,4151,48818,45127,874,22,495,12.5,13919,7384,6535,16.4,30.8,6536,2928,3608,6.5,14.5,7383,16.3,29,0,342,342,1438
1985,38940,4019,4392,52178,50883,825,19.3,585,13.7,12069,5911,6158,11.6,23.7,9479,4113,5366,8.1,18.6,2590,5.1,37.2,0,406,407,2369
1986,38940,4249,4655,55692,53914,891,19.7,612,13.5,13041,6190,6851,11.5,24.2,9484,3559,5925,6.6,17.6,3557,6.6,35.2,0,438,438,2303
1987,38940,4603,5100,61966,58833,1072,22,598,12.2,16603,8367,8236,14.2,28.2,10337,3818,6519,6.5,17.6,6266,10.6,35.2,0,444,444,2672
1988,38940,4778,5352,64423,62780,982,18.8,715,13.7,14923,7049,7874,11.2,23.8,11637,4184,7453,6.7,18.5,3286,5.3,37,0,519,519,2497
1989,38940,5008,5618,71260,68184,995,18.1,719,13.1,16578,7166,9412,10.5,24.3,10425,4528,5897,6.6,15.3,6153,9,30.6,0,509,520,2763
1990,38940,5266,5909,71652,71190,998,17.3,649,11.3,14323,6614,7709,9.3,20.1,13398,4274,9124,6,18.8,925,1.3,37.6,0,486,489,2667
1991,38940,5303,6011,70578,71127,924,15.5,836,14,14460,6812,7648,9.6,20.3,15558,5416,10142,7.6,21.9,-1098,-1.6,40.6,0,551,551,3284
1992,38940,5459,6139,67071,68920,1009,16.6,849,14,11906,5852,6054,8.5,17.3,15603,6089,9514,8.8,22.6,-3697,-5.3,34.6,0,553,562,3010
1993,38940,5571,6242,70813,68872,863,13.9,736,11.9,14475,5882,8593,8.5,21,10593,4300,6293,6.2,15.4,3882,5.6,30.8,0,531,532,2837
1994,38940,5648,6344,73606,72150,921,14.6,794,12.6,15562,6366,9196,8.8,21.6,12650,5895,6755,8.2,17.5,2912,4.1,35,0,536,536,3544
1995,38940,5791,6485,75366,74366,939,14.6,765,11.9,13972,5817,8155,7.8,18.8,11972,4622,7350,6.2,16.1,2000,2.7,32.2,0,539,540,2709
1996,38940,5919,6641,75042,75125,901,13.7,720,11,12038,5286,6752,7,16,12203,4431,7772,5.9,16.2,-165,-0.2,32,0,523,523,2957
1997,38940,6003,6755,79634,77370,980,14.6,869,13,16765,7712,9053,10,21.7,12236,6178,6058,8,15.8,4529,5.9,31.6,0,553,553,2567
1998,38940,6091,6845,82500,81024,950,14,842,12.4,14947,5866,9081,7.2,18.4,11994,5743,6251,7.1,14.8,2953,3.6,29.6,0,563,563,3013
1999,38940,6155,6964,83648,82948,1013,14.7,880,12.7,15600,7041,8559,8.5,18.8,14200,6270,7930,7.6,17.1,1400,1.7,34.2,0,594,594,3069
2000,38940,6157,6991,89334,87487,891,12.8,846,12.1,16114,6349,9765,7.3,18.4,12420,5591,6829,6.4,14.2,3694,4.2,28.4,0,528,528,2724
2001,38940,6329,7182,91637,90539,971,13.7,840,11.8,14571,6214,8357,6.9,16.1,12375,4428,7947,4.9,13.7,2196,2.4,27.4,0,487,489,2187
2002,38940,6499,7339,90467,89860,1081,14.9,920,12.7,16758,6361,10397,7.1,18.6,15544,6562,8982,7.3,17.3,1214,1.3,34.6,0,503,503,2731
2003,38940,6723,7585,94031,91372,1192,16,800,10.8,17983,7519,10464,8.2,19.7,12664,4803,7861,5.3,13.9,5319,5.8,27.8,0,547,547,2746
2004,38940,7209,8072,100076,96849,1356,17.3,784,10,20480,9085,11395,9.4,21.1,14026,6126,7900,6.3,14.5,6454,6.6,29,0,558,558,2898
2005,38940,7644,8552,106434,102914,1397,16.8,850,10.2,21187,8718,12469,8.5,20.6,14146,4948,9198,4.8,13.7,7041,6.9,27.4,0,620,620,3294
2006,38940,8034,9004,112719,109205,1429,16.3,891,10.2,21631,8418,13213,7.7,19.8,14602,5059,9543,4.6,13.4,7029,6.4,26.8,0,646,646,3282
2007,38940,8085,9088,112303,112032,1309,14.5,1165,12.9,20206,9036,11170,8.1,18,19664,6981,12683,6.2,17.6,542,0.4,35.2,0,838,840,4850
2008,38940,7833,8884,107988,109866,1100,12.3,1228,13.7,16485,7410,9075,6.7,15,20240,5990,14250,5.5,18.4,-3755,-3.4,30,0,930,930,4081
2009,38940,7485,8499,98901,102935,990,11.4,1260,14.5,12673,6248,6425,6.1,12.3,20741,7000,13741,6.8,20.1,-8068,-7.8,24.6,0,881,887,4247
2010,38940,7387,8425,96322,97371,981,11.6,1016,12,11951,5642,6309,5.8,12.3,14049,5264,8785,5.4,14.4,-2098,-2.1,24.6,0,729,729,3913
2011,38940,7408,8471,99255,97614,1022,12.1,926,11,15844,7484,8360,7.7,16.2,12561,5199,7362,5.3,12.9,3283,3.3,25.8,0,639,641,2864
2012,38940,7604,8679,101013,100280,1017,11.9,829,9.7,14604,5538,9066,5.5,14.6,13137,4618,8519,4.6,13.1,1467,1.5,26.2,0,548,554,2854
2013,38940,7779,8848,101659,101196,1038,11.9,895,10.2,15131,5610,9521,5.5,15,14204,5305,8899,5.2,14,927,1,28,0,582,582,2953
2014,38940,7877,8974,106082,103614,1078,12.1,895,10.1,16474,7535,8939,7.3,15.9,11537,4606,6931,4.4,11.1,4937,4.8,22.2,0,645,646,3386
1977,39100,7501,8214,119301,117304,1218,15,992,12.2,21532,8774,12758,7.5,18.4,17537,7255,10282,6.2,15,3995,3.4,30,0,646,648,3911
1978,39100,7684,8403,130288,124787,1127,13.6,929,11.2,26538,7710,18828,6.2,21.3,15536,5755,9781,4.6,12.5,11002,8.8,25,0,647,647,2906
1979,39100,7811,8548,133467,131816,1125,13.3,932,11,21612,7261,14351,5.5,16.4,18310,4907,13403,3.7,13.9,3302,2.5,27.8,0,671,672,2910
1980,39100,7891,8639,134428,133489,993,11.6,867,10.1,19672,7425,12247,5.6,14.7,17794,6659,11135,5,13.3,1878,1.4,26.6,0,604,607,2701
1981,39100,7750,8441,132963,132509,983,11.5,1105,13,20778,7024,13754,5.3,15.7,19869,7430,12439,5.6,15,909,0.7,30,0,664,664,3261
1982,39100,7915,8685,137138,135026,1197,14,886,10.3,21265,8857,12408,6.6,15.7,17040,6089,10951,4.5,12.6,4225,3.1,25.2,0,535,536,2935
1983,39100,8139,8924,135953,135835,1039,11.8,853,9.7,18789,6152,12637,4.5,13.8,18552,6779,11773,5,13.7,237,0.1,27.4,0,598,598,3389
1984,39100,8521,9341,145404,140605,1217,13.3,810,8.9,22628,6706,15922,4.8,16.1,13029,4544,8485,3.2,9.3,9599,6.8,18.6,0,557,558,2601
1985,39100,9060,9903,156710,152368,1395,14.5,856,8.9,23968,7203,16765,4.7,15.7,15284,5392,9892,3.5,10,8684,5.7,20,0,599,599,3101
1986,39100,9526,10423,162278,159361,1551,15.3,991,9.8,24374,9127,15247,5.7,15.3,18539,6382,12157,4,11.6,5835,3.7,23.2,0,668,671,3669
1987,39100,10069,11072,175670,171437,1801,16.7,1097,10.2,28414,11633,16781,6.8,16.6,19948,7551,12397,4.4,11.6,8466,5,23.2,0,736,739,3527
1988,39100,10340,11498,173976,173147,1751,15.5,1280,11.4,29979,12957,17022,7.5,17.3,28321,8403,19918,4.9,16.4,1658,0.9,32.8,0,887,887,4392
1989,39100,10627,11856,178210,176368,1633,14,1303,11.2,26979,10247,16732,5.8,15.3,23294,8070,15224,4.6,13.2,3685,2.1,26.4,0,939,944,4865
1990,39100,10721,11976,176804,177319,1384,11.6,1182,9.9,22478,8833,13645,5,12.7,23508,7077,16431,4,13.3,-1030,-0.6,25.4,0,861,861,4576
1991,39100,10635,11966,172010,174389,1320,11,1331,11.1,20168,7964,12204,4.6,11.6,24925,7330,17595,4.2,14.3,-4757,-2.7,23.2,0,875,878,4064
1992,39100,10516,11852,167601,169310,1358,11.4,1373,11.5,25011,9329,15682,5.5,14.8,28428,8151,20277,4.8,16.8,-3417,-2,29.6,0,901,910,4227
1993,39100,10618,12021,164123,166054,1386,11.6,1180,9.9,24585,9737,14848,5.9,14.8,28447,7591,20856,4.6,17.1,-3862,-2.3,29.6,0,805,807,3671
1994,39100,10546,11999,160059,161965,1302,10.8,1286,10.7,22976,9135,13841,5.6,14.2,26787,8072,18715,5,16.5,-3811,-2.3,28.4,0,882,882,3817
1995,39100,10780,12245,163640,161702,1462,12.1,1182,9.8,25183,9570,15613,5.9,15.6,21307,8501,12806,5.3,13.2,3876,2.4,26.4,0,780,787,3626
1996,39100,10894,12352,164705,164005,1370,11.1,1219,9.9,24851,9032,15819,5.5,15.2,23451,8937,14514,5.4,14.3,1400,0.9,28.6,0,811,811,3416
1997,39100,11085,12547,161959,163491,1475,11.8,1285,10.3,24504,8706,15798,5.3,15,27568,10110,17458,6.2,16.9,-3064,-1.9,30,0,822,822,3967
1998,39100,11226,12696,167615,164791,1392,11,1218,9.7,27211,10166,17045,6.2,16.5,21563,6491,15072,3.9,13.1,5648,3.4,26.2,0,822,822,3510
1999,39100,11331,12846,175206,171456,1336,10.5,1155,9,28279,10631,17648,6.2,16.5,20778,7778,13000,4.5,12.1,7501,4.4,24.2,0,770,770,3354
2000,39100,11463,13028,188507,181576,1360,10.5,1175,9.1,34752,9272,25480,5.1,19.1,20889,7788,13101,4.3,11.5,13863,7.6,23,0,757,757,3849
2001,39100,11689,13345,192574,190833,1449,11,1268,9.6,27459,9859,17600,5.2,14.4,23976,7058,16918,3.7,12.6,3483,1.8,25.2,0,756,756,2951
2002,39100,11965,13703,196033,194221,1752,13,1384,10.2,32782,13287,19495,6.8,16.9,29157,9815,19342,5.1,15,3625,1.9,30,0,739,740,3929
2003,39100,12199,13997,202475,198567,1625,11.8,1159,8.4,29896,11430,18466,5.8,15.1,22079,7265,14814,3.7,11.1,7817,4,22.2,0,810,811,4731
2004,39100,12500,14308,204992,203248,1631,11.5,1225,8.7,26584,8197,18387,4,13.1,23096,6664,16432,3.3,11.4,3488,1.7,22.8,0,775,776,3715
2005,39100,12777,14620,204597,204422,1715,11.9,1304,9,24991,9309,15682,4.6,12.2,24640,7528,17112,3.7,12.1,351,0.1,24.2,0,890,891,4791
2006,39100,12948,14875,208226,206005,1699,11.5,1325,9,26305,9567,16738,4.6,12.8,21862,7374,14488,3.6,10.6,4443,2.2,21.2,0,937,937,4980
2007,39100,13062,15080,206761,207257,1720,11.5,1494,10,27640,10898,16742,5.3,13.3,28631,8458,20173,4.1,13.8,-991,-0.5,26.6,0,959,963,4991
2008,39100,13064,15062,204209,204601,1527,10.2,1417,9.4,25476,9067,16409,4.4,12.5,26259,7972,18287,3.9,12.8,-783,-0.3,25,0,935,935,4701
2009,39100,12736,14742,197413,200223,1347,9.1,1581,10.6,21720,7447,14273,3.7,10.8,27339,6896,20443,3.4,13.7,-5619,-2.9,21.6,0,1038,1040,4364
2010,39100,12665,14670,201601,199182,1416,9.7,1404,9.6,28041,13383,14658,6.7,14.1,23203,7145,16058,3.6,11.6,4838,2.5,23.2,0,947,950,4130
2011,39100,12542,14545,206194,203458,1387,9.5,1412,9.7,26532,9405,17127,4.6,13,21059,6172,14887,3,10.4,5473,2.6,20.8,0,869,869,3429
2012,39100,12675,14698,199933,199551,1527,10.5,1342,9.2,24623,6575,18048,3.3,12.3,23858,7047,16811,3.5,12,765,0.3,24,0,859,863,3678
2013,39100,12588,14585,201240,200299,1329,9.1,1461,10,23133,7620,15513,3.8,11.5,21251,7238,14013,3.6,10.6,1882,0.9,21.2,0,892,893,4103
2014,39100,12638,14643,207467,203879,1526,10.5,1377,9.5,28454,12246,16208,6,14,21278,6763,14515,3.3,10.4,7176,3.6,20.8,0,910,911,4450
1977,39140,1213,1282,9309,8958,307,25.3,165,13.6,2241,1207,1034,13.5,25,1539,628,911,7,17.2,702,7.8,34.4,0,108,108,322
1978,39140,1198,1274,10482,9843,284,22.2,269,21,2870,1360,1510,13.8,29.2,1592,1063,529,10.8,16.2,1278,13,32.4,0,171,171,636
1979,39140,1380,1456,12686,11607,287,21,118,8.6,3787,1545,2242,13.3,32.6,1628,648,980,5.6,14,2159,18.6,28,1,2,2,
1980,39140,1513,1594,15130,13922,364,23.9,210,13.8,4787,1871,2916,13.4,34.4,2371,896,1475,6.4,17,2416,17.4,34,0,163,163,658
1981,39140,1523,1602,14233,14481,286,18,257,16.1,3214,1592,1622,11,22.2,3710,1582,2128,10.9,25.6,-496,-3.4,44.4,0,180,180,927
1982,39140,1567,1672,14063,14083,376,23,280,17.1,3058,1913,1145,13.6,21.7,3097,1182,1915,8.4,22,-39,-0.3,43.4,0,161,161,757
1983,39140,1622,1742,14168,13775,322,18.9,253,14.8,3287,1749,1538,12.7,23.9,2501,972,1529,7.1,18.2,786,5.7,36.4,0,174,174,721
1984,39140,1778,1901,15188,14679,425,23.3,269,14.8,4069,1915,2154,13,27.7,3051,1139,1912,7.8,20.8,1018,6.9,41.6,0,197,197,824
1985,39140,1942,2056,18144,17347,406,20.5,257,12.9,4046,1853,2193,10.7,23.3,2451,1012,1439,5.8,14.1,1595,9.2,28.2,0,168,168,632
1986,39140,2060,2182,20254,19171,440,20.8,295,13.9,5145,2237,2908,11.7,26.8,2978,1418,1560,7.4,15.5,2167,11.3,31,0,208,209,956
1987,39140,2256,2400,22425,21540,543,23.7,305,13.3,5567,2620,2947,12.2,25.8,3797,1526,2271,7.1,17.6,1770,8.2,35.2,0,217,217,1130
1988,39140,2306,2464,22412,21585,433,17.8,348,14.3,5627,2623,3004,12.2,26.1,3972,1597,2375,7.4,18.4,1655,7.7,36.8,0,240,240,1104
1989,39140,2411,2577,23396,22906,474,18.8,356,14.1,5404,2689,2715,11.7,23.6,4423,2097,2326,9.2,19.3,981,4.3,38.6,0,226,229,1344
1990,39140,2537,2707,24420,23847,480,18.2,321,12.2,4862,2174,2688,9.1,20.4,3715,1534,2181,6.4,15.6,1147,4.8,31.2,0,237,237,957
1991,39140,2684,2875,25385,24931,510,18.3,334,12,5479,2632,2847,10.6,22,4571,2216,2355,8.9,18.3,908,3.7,36.6,0,222,223,1578
1992,39140,2752,2957,27386,26373,489,16.8,384,13.2,6658,3095,3563,11.7,25.2,4632,1875,2757,7.1,17.6,2026,7.6,35.2,0,268,273,1067
1993,39140,2888,3099,29976,28682,505,16.7,360,11.9,6704,2596,4108,9.1,23.4,4116,1732,2384,6,14.4,2588,9,28.8,0,265,265,1155
1994,39140,3098,3322,32537,31210,585,18.2,347,10.8,7143,2804,4339,9,22.9,4489,1997,2492,6.4,14.4,2654,8.5,28.8,0,245,245,1466
1995,39140,3266,3492,35016,33728,582,17.1,381,11.2,7336,3257,4079,9.7,21.8,4759,1814,2945,5.4,14.1,2577,7.7,28.2,0,290,290,1329
1996,39140,3380,3621,36884,35868,589,16.6,439,12.3,7287,2942,4345,8.2,20.3,5254,1824,3430,5.1,14.6,2033,5.7,29.2,0,326,326,1290
1997,39140,3581,3862,38780,37779,677,18.1,436,11.6,8742,4283,4459,11.3,23.1,6739,2458,4281,6.5,17.8,2003,5.3,35.6,0,301,301,1479
1998,39140,3645,3935,40831,39690,602,15.4,506,13,8512,3687,4825,9.3,21.4,6230,2240,3990,5.6,15.7,2282,5.7,31.4,0,354,354,1488
1999,39140,3782,4079,43476,42194,652,16.3,512,12.8,8926,3729,5197,8.8,21.2,6361,2941,3420,7,15.1,2565,6.1,30.2,0,348,348,1854
2000,39140,3880,4199,45649,44553,617,14.9,485,11.7,9233,3927,5306,8.8,20.7,7041,2547,4494,5.7,15.8,2192,4.9,31.6,0,361,361,1706
2001,39140,4014,4351,46183,45620,684,16,577,13.5,8803,3814,4989,8.4,19.3,7676,3254,4422,7.1,16.8,1127,2.5,33.6,0,360,360,1677
2002,39140,4137,4523,48718,47594,783,17.6,622,14,10637,4655,5982,9.8,22.3,8389,3248,5141,6.8,17.6,2248,4.7,35.2,0,389,391,1815
2003,39140,4262,4648,49305,48570,721,15.8,511,11.2,9246,3579,5667,7.4,19,7775,2291,5484,4.7,16,1471,3,32,0,358,358,1493
2004,39140,4410,4801,53502,51241,710,15,497,10.5,10622,3945,6677,7.7,20.7,6100,2446,3654,4.8,11.9,4522,8.8,23.8,0,339,339,1492
2005,39140,4616,5069,57057,55157,813,16.5,517,10.5,10992,4911,6081,8.9,19.9,7191,2695,4496,4.9,13,3801,6.9,26,0,390,390,2043
2006,39140,4917,5418,63057,59910,926,17.7,527,10.1,13381,5663,7718,9.5,22.3,7087,2893,4194,4.8,11.8,6294,10.5,23.6,0,362,362,2033
2007,39140,5064,5586,63594,63279,846,15.4,670,12.2,11745,4999,6746,7.9,18.6,11114,3410,7704,5.4,17.6,631,1,35.2,0,458,458,2300
2008,39140,4976,5529,60082,61463,728,13.1,764,13.8,8286,3251,5035,5.3,13.5,11048,3485,7563,5.7,18,-2762,-4.5,27,0,570,570,2642
2009,39140,4538,5068,54051,56931,521,9.9,893,16.9,6400,2892,3508,5.1,11.2,12159,3849,8310,6.8,21.4,-5759,-10.2,22.4,0,646,648,2424
2010,39140,4280,4799,50807,52257,459,9.3,702,14.3,6011,2251,3760,4.3,11.5,8910,3188,5722,6.1,17.1,-2899,-5.6,23,0,495,495,2289
2011,39140,4203,4726,50541,50588,510,10.7,564,11.9,5989,2218,3771,4.4,11.8,6083,1881,4202,3.7,12,-94,-0.2,23.6,0,400,401,1381
2012,39140,4214,4727,51749,51106,504,10.7,496,10.5,8394,3419,4975,6.7,16.4,7108,2422,4686,4.7,13.9,1286,2.5,27.8,0,321,325,1687
2013,39140,4210,4721,52899,52257,473,10,492,10.4,6980,2200,4780,4.2,13.4,5695,1973,3722,3.8,10.9,1285,2.5,21.8,0,315,318,1252
2014,39140,4253,4792,55025,53745,550,11.6,450,9.5,7959,2486,5473,4.6,14.8,5398,1964,3434,3.7,10,2561,4.8,20,0,329,331,1590
1977,39300,24803,27652,507113,469114,3850,14.1,3111,11.4,131148,28630,102518,6.1,28,55149,21524,33625,4.6,11.8,75999,16.2,23.6,0,2018,2034,11167
1978,39300,25220,28137,492268,499645,3436,12.3,2933,10.5,93541,28988,64553,5.8,18.7,108295,26653,81642,5.3,21.7,-14754,-3,37.4,0,2018,2028,12027
1979,39300,25745,28729,509210,500503,3460,12.2,2724,9.6,82897,26278,56619,5.3,16.6,65483,20203,45280,4,13.1,17414,3.5,26.2,0,1927,1931,11042
1980,39300,25783,28781,505664,506743,3001,10.4,2853,9.9,69655,22774,46881,4.5,13.7,71813,21413,50400,4.2,14.2,-2158,-0.5,27.4,0,2010,2016,10603
1981,39300,25166,28116,499671,501293,3057,10.8,3468,12.2,75517,28503,47014,5.7,15.1,78760,30260,48500,6,15.7,-3243,-0.6,30.2,0,2036,2046,12061
1982,39300,25292,28538,495797,498031,3533,12.5,2873,10.1,70857,29547,41310,5.9,14.2,75325,22498,52827,4.5,15.1,-4468,-0.9,28.4,0,1692,1693,10848
1983,39300,25823,29016,494384,495180,2945,10.2,2689,9.3,68457,21416,47041,4.3,13.8,70049,21937,48112,4.4,14.1,-1592,-0.3,27.6,0,1839,1843,11457
1984,39300,26614,29821,527220,511393,3573,12.2,2749,9.3,89438,30882,58556,6,17.5,57784,20351,37433,4,11.3,31654,6.2,22.6,0,1836,1840,9908
1985,39300,27447,30712,540429,533875,3777,12.5,2919,9.6,82488,27019,55469,5.1,15.5,69379,25369,44010,4.8,13,13109,2.5,26,0,1994,1998,15454
1986,39300,28487,31910,558313,548125,4377,14,3067,9.8,92167,36511,55656,6.7,16.8,71791,26491,45300,4.8,13.1,20376,3.7,26.2,0,2035,2040,15343
1987,39300,29813,33483,581416,570741,5050,15.4,3343,10.2,98895,37549,61346,6.6,17.3,77546,29794,47752,5.2,13.6,21349,3.7,27.2,0,2292,2310,15562
1988,39300,30374,34119,589501,583905,4539,13.4,3715,11,99577,35694,63883,6.1,17.1,88386,34146,54240,5.8,15.1,11191,2,30.2,0,2490,2490,15698
1989,39300,30919,34967,601093,597018,4446,12.9,3719,10.8,99353,41793,57560,7,16.6,91202,32112,59090,5.4,15.3,8151,1.3,30.6,0,2661,2703,20592.5
1990,39300,30605,34795,573317,586416,3930,11.3,3807,10.9,74412,29769,44643,5.1,12.7,100609,31415,69194,5.4,17.2,-26197,-4.5,25.4,0,2737,2744,18817
1991,39300,29776,34087,543360,558285,3557,10.3,4204,12.2,71357,30417,40940,5.4,12.8,101209,30076,71133,5.4,18.1,-29852,-5.3,25.6,0,2649,2681,16236
1992,39300,29243,33678,531521,536309,3766,11.1,3854,11.4,78604,29049,49555,5.4,14.7,88180,31311,56869,5.8,16.4,-9576,-1.7,29.4,0,2510,2555,17123
1993,39300,29705,34103,544170,537964,3616,10.7,3175,9.4,82558,31858,50700,5.9,15.3,70145,24614,45531,4.6,13,12413,2.3,26,0,2094,2101,11052
1994,39300,30087,34518,541840,543196,3782,11,3316,9.7,82866,32951,49915,6.1,15.3,85577,28212,57365,5.2,15.8,-2711,-0.5,30.6,0,2206,2211,13396
1995,39300,30400,34988,558503,549979,3849,11.1,3270,9.4,84000,30164,53836,5.5,15.3,66951,22102,44849,4,12.2,17049,3.1,24.4,0,2184,2192,11456
1996,39300,30664,35292,561135,559851,3760,10.7,3389,9.6,74495,26689,47806,4.8,13.3,71927,25711,46216,4.6,12.8,2568,0.5,25.6,0,2244,2246,12743
1997,39300,31039,35783,577174,569664,3960,11.1,3499,9.8,88424,31951,56473,5.6,15.5,73403,26368,47035,4.6,12.9,15021,2.6,25.8,0,2295,2295,12382
1998,39300,31266,35959,592328,584745,3681,10.3,3434,9.6,87729,30073,57656,5.1,15,72562,24252,48310,4.1,12.4,15167,2.6,24.8,0,2271,2271,12328
1999,39300,31195,36110,598084,595093,3590,10,3403,9.4,83669,28017,55652,4.7,14.1,77688,26853,50835,4.5,13.1,5981,1,26.2,0,2356,2356,12522
2000,39300,31302,36355,606977,601735,3617,10,3373,9.3,96572,36059,60513,6,16,86088,35196,50892,5.8,14.3,10484,1.7,28.6,0,2171,2171,14937
2001,39300,31758,36959,605696,607237,3697,10,3546,9.6,78276,29684,48592,4.9,12.9,81358,23900,57458,3.9,13.4,-3082,-0.5,25.8,0,2188,2188,11299
2002,39300,31843,37240,608520,607815,4235,11.4,3903,10.5,93894,38548,55346,6.3,15.4,92484,31137,61347,5.1,15.2,1410,0.2,30.4,0,2069,2069,11135
2003,39300,32372,37815,618015,611033,4252,11.4,3196,8.5,88848,29057,59791,4.8,14.5,74883,22917,51966,3.8,12.3,13965,2.2,24.6,0,2059,2071,11272
2004,39300,32542,38111,630747,622408,4178,11,3643,9.6,88788,28800,59988,4.6,14.3,72111,24962,47149,4,11.6,16677,2.7,23.2,0,2620,2625,13470
2005,39300,32791,38581,635771,631530,4145,10.8,3436,9,81214,33139,48075,5.2,12.9,72731,21708,51023,3.4,11.5,8483,1.4,23,0,2399,2401,13662
2006,39300,32979,39085,638991,635729,4441,11.5,3630,9.4,87807,34314,53493,5.4,13.8,81283,24051,57232,3.8,12.8,6524,1,25.6,0,2495,2500,14194
2007,39300,32687,39021,648134,642876,3928,10.1,3906,10,94380,33314,61066,5.2,14.7,83864,27072,56792,4.2,13,10516,1.7,26,0,2499,2519,14836
2008,39300,32127,38462,636984,640305,3448,8.9,3782,9.8,77749,29020,48729,4.5,12.1,84391,22841,61550,3.6,13.2,-6642,-1.1,24.2,0,2519,2521,13998
2009,39300,30625,36779,602274,616602,2802,7.5,4039,10.8,63243,19516,43727,3.2,10.3,91899,26351,65548,4.3,14.9,-28656,-4.6,20.6,0,2585,2589,15583
2010,39300,30059,36320,583983,591495,3148,8.6,3388,9.3,61384,22971,38413,3.9,10.4,76407,18303,58104,3.1,12.9,-15023,-2.5,20.8,0,2168,2169,11601
2011,39300,29675,35994,591105,586580,3097,8.6,3219,8.9,67997,20209,47788,3.4,11.6,58947,18619,40328,3.2,10,9050,1.6,20,0,2030,2035,9773
2012,39300,29890,36182,597722,593495,3376,9.4,3173,8.8,74282,23388,50894,3.9,12.5,65828,20338,45490,3.4,11.1,8454,1.4,22.2,0,1853,1870,10330
2013,39300,29742,36081,603939,600637,2904,8.1,3048,8.5,66177,17194,48983,2.9,11,59574,17000,42574,2.8,9.9,6603,1.1,19.8,0,1845,1849,9900
2014,39300,29676,35974,609078,604581,3105,8.6,3001,8.4,69801,21641,48160,3.6,11.5,60807,18689,42118,3.1,10.1,8994,1.4,20.2,0,1933,1935,12485
1977,39340,2626,2821,46714,41728,651,24.2,381,14.2,16467,4262,12205,10.2,39.5,6494,2512,3982,6,15.6,9973,23.9,31.2,0,264,264,1953
1978,39340,2550,2755,51040,48776,513,18.4,541,19.4,10880,3640,7240,7.5,22.3,6351,3697,2654,7.6,13,4529,9.3,26,0,314,314,2121
1979,39340,2906,3124,55365,53276,585,19.9,248,8.4,10799,4879,5920,9.2,20.3,6620,2381,4239,4.5,12.4,4179,7.9,24.8,1,2,2,
1980,39340,2970,3198,55932,55548,559,17.7,457,14.5,9583,3889,5694,7,17.3,8814,2711,6103,4.9,15.9,769,1.4,31.8,0,332,332,1916
1981,39340,2896,3135,53759,54679,511,16.2,538,17,8133,3715,4418,6.8,14.9,9973,4210,5763,7.7,18.2,-1840,-3.3,29.8,0,335,335,2180
1982,39340,2880,3178,54490,54019,560,17.7,457,14.5,9542,4493,5049,8.3,17.7,8600,3363,5237,6.2,15.9,942,1.8,31.8,0,258,258,1961
1983,39340,2956,3265,53647,54075,466,14.5,412,12.8,9008,3982,5026,7.4,16.7,9863,3357,6506,6.2,18.2,-855,-1.5,33.4,0,258,259,1521
1984,39340,3061,3375,57214,55430,539,16.2,431,13,9926,3809,6117,6.9,17.9,6357,2884,3473,5.2,11.5,3569,6.4,23,0,286,286,1986
1985,39340,3179,3494,58896,58035,574,16.7,457,13.3,9218,3668,5550,6.3,15.9,7496,3061,4435,5.3,12.9,1722,3,25.8,0,314,314,1825
1986,39340,3206,3519,58672,58748,522,14.9,479,13.7,11447,4999,6448,8.5,19.5,11599,3429,8170,5.8,19.7,-152,-0.2,39,0,310,310,1949
1987,39340,3225,3559,62846,61831,594,16.8,531,15,10904,3903,7001,6.3,17.6,8876,3588,5288,5.8,14.4,2028,3.2,28.8,0,348,359,2303
1988,39340,3247,3582,67266,64874,566,15.9,517,14.5,13368,5290,8078,8.2,20.6,8585,3299,5286,5.1,13.2,4783,7.4,26.4,0,358,358,1816
1989,39340,3295,3636,74734,71228,549,15.2,494,13.7,15663,5076,10587,7.1,22,8651,3823,4828,5.4,12.1,7012,9.9,24.2,0,331,340,2581
1990,39340,3373,3727,81279,77889,531,14.4,401,10.9,15770,4508,11262,5.8,20.2,8990,3377,5613,4.3,11.5,6780,8.7,23,0,286,287,2421
1991,39340,3541,3932,85258,83263,605,15.8,402,10.5,15207,6464,8743,7.8,18.3,11217,3339,7878,4,13.5,3990,4.8,27,0,267,267,2512
1992,39340,3704,4130,87562,86468,677,16.8,478,11.8,16473,6381,10092,7.4,19.1,14285,4981,9304,5.8,16.5,2188,2.6,33,0,337,341,2923
1993,39340,3859,4290,91053,89208,685,16.3,499,11.9,16749,4999,11750,5.6,18.8,13059,7272,5787,8.2,14.6,3690,4.2,29.2,0,342,342,3974
1994,39340,4125,4580,98046,94453,816,18.4,510,11.5,19082,7774,11308,8.2,20.2,11895,5119,6776,5.4,12.6,7187,7.6,25.2,0,356,356,3534
1995,39340,4369,4846,104601,101265,834,17.7,546,11.6,19746,7942,11804,7.8,19.5,13073,4433,8640,4.4,12.9,6673,6.6,25.8,0,399,399,2712
1996,39340,4608,5097,114734,109570,899,18.1,630,12.7,23160,10855,12305,9.9,21.1,12832,4760,8072,4.3,11.7,10328,9.4,23.4,0,453,454,3126
1997,39340,4744,5295,121908,118288,898,17.3,687,13.2,24090,10333,13757,8.7,20.4,16849,6708,10141,5.7,14.2,7241,6.2,28.4,0,479,479,3366
1998,39340,4874,5476,131691,126707,925,17.2,709,13.2,26364,10951,15413,8.6,20.8,16396,6529,9867,5.2,12.9,9968,7.9,25.8,0,514,514,4303
1999,39340,5111,5772,137327,134444,1072,19.1,755,13.4,25420,10190,15230,7.6,18.9,19653,7181,12472,5.3,14.6,5767,4.3,29.2,0,519,519,4137
2000,39340,5266,5970,143873,140570,1030,17.5,814,13.9,26307,10348,15959,7.4,18.7,19701,6917,12784,4.9,14,6606,4.7,28,0,528,528,3446
2001,39340,5575,6327,146481,145472,1172,19,888,14.4,29390,9073,20317,6.2,20.2,27371,13272,14099,9.1,18.8,2019,1.4,37.6,0,540,542,9866
2002,39340,5964,6704,143893,144282,1382,21.3,981,15.1,27375,10740,16635,7.4,19,28152,13011,15141,9,19.5,-777,-0.5,38,0,513,514,6601
2003,39340,6211,6966,149017,145961,1330,19.5,923,13.6,29288,13090,16198,9,20.1,23177,7189,15988,4.9,15.9,6111,4.2,31.8,0,665,665,4881
2004,39340,6509,7270,163136,155246,1336,18.8,927,13.1,40420,11014,29406,7.1,26,24639,6981,17658,4.5,15.9,15781,10.1,31.8,0,642,642,4948
2005,39340,6855,7664,166123,164114,1394,18.7,913,12.3,36254,11099,25155,6.8,22.1,32237,6061,26176,3.7,19.6,4017,2.5,39.2,0,665,665,4688
2006,39340,7392,8304,176469,170875,1657,20.8,930,11.7,32680,13377,19303,7.8,19.1,21492,6342,15150,3.7,12.6,11188,6.5,25.2,0,670,675,4917
2007,39340,8053,9069,188776,181966,1764,20.3,990,11.4,35007,12653,22354,7,19.2,21386,8558,12828,4.7,11.8,13621,7.4,23.6,0,673,675,5601
2008,39340,8226,9244,192250,190165,1487,16.3,1243,13.6,30371,10812,19559,5.7,16,26200,10711,15489,5.6,13.8,4171,2.2,27.6,0,935,935,7778
2009,39340,7839,8886,188857,190214,1223,13.5,1491,16.5,29767,7324,22443,3.9,15.6,32481,8946,23535,4.7,17.1,-2714,-1.5,31.2,0,1052,1052,5553
2010,39340,7870,8918,172503,180462,1360,15.3,1255,14.1,21081,10508,10573,5.8,11.7,36999,9655,27344,5.4,20.5,-15918,-8.8,23.4,0,853,862,7581
2011,39340,7905,8978,180321,176146,1274,14.3,1153,12.9,27191,11703,15488,6.6,15.4,18841,7069,11772,4,10.7,8350,4.7,21.4,0,768,771,4540
2012,39340,8226,9331,189328,184877,1422,15.5,1090,11.9,30317,10524,19793,5.7,16.4,21414,6997,14417,3.8,11.6,8903,4.8,23.2,0,729,733,4378
2013,39340,8504,9638,195896,192838,1310,13.8,1055,11.1,27435,9362,18073,4.9,14.2,21318,8039,13279,4.2,11.1,6117,3.1,22.2,0,667,669,4964
2014,39340,8845,9990,203693,199401,1464,15,1054,10.8,31682,12025,19657,6,15.9,23098,7274,15824,3.6,11.6,8584,4.3,23.2,0,729,729,5018
1977,39380,2090,2279,30623,30245,403,18.2,278,12.5,6095,3679,2416,12.2,20.2,5338,2439,2899,8.1,17.6,757,2.6,35.2,0,196,196,1509
1978,39380,1989,2195,31238,30892,366,16.4,423,18.9,5367,2030,3337,6.6,17.4,4674,2607,2067,8.4,15.1,693,2.3,30.2,0,241,241,1086
1979,39380,2204,2415,33782,32531,370,16.1,168,7.3,5797,2195,3602,6.7,17.8,3294,1183,2111,3.6,10.1,2503,7.7,20.2,0,,,
1980,39380,2223,2433,33209,33498,307,12.7,280,11.6,4188,1778,2410,5.3,12.5,4766,1563,3203,4.7,14.2,-578,-1.7,25,0,207,207,877
1981,39380,2105,2302,36503,34713,266,11.3,377,16,9902,2086,7816,6,28.5,6321,2939,3382,8.5,18.2,3581,10.3,36.4,0,227,227,1073
1982,39380,2078,2299,30412,33357,336,14.6,316,13.7,4908,2022,2886,6.1,14.7,10798,7196,3602,21.6,32.4,-5890,-17.7,29.4,0,182,184,932
1983,39380,2094,2311,26726,28299,279,12.1,278,12.1,3833,1727,2106,6.1,13.5,6979,1601,5378,5.7,24.7,-3146,-11.2,27,0,182,182,1002
1984,39380,2140,2356,26189,26448,318,13.6,272,11.7,4530,1783,2747,6.7,17.1,5047,2120,2927,8,19.1,-517,-2,34.2,0,170,171,690
1985,39380,2216,2435,27285,26846,340,14.2,275,11.5,5169,2183,2986,8.1,19.3,4291,1675,2616,6.2,16,878,3.3,32,0,193,194,977
1986,39380,2249,2460,28423,27834,311,12.7,276,11.3,5351,2156,3195,7.7,19.2,4173,1418,2755,5.1,15,1178,4.2,30,0,181,181,722
1987,39380,2258,2465,29234,29479,340,13.8,318,12.9,4778,2123,2655,7.2,16.2,5267,2274,2993,7.7,17.9,-489,-1.7,32.4,0,200,209,960
1988,39380,2239,2466,30631,29758,294,11.9,289,11.7,5412,1926,3486,6.5,18.2,3665,1458,2207,4.9,12.3,1747,5.9,24.6,0,215,215,962
1989,39380,2210,2437,30793,30810,235,9.6,264,10.8,4577,1649,2928,5.4,14.9,4610,1337,3273,4.3,15,-33,-0.1,29.8,0,177,183,944
1990,39380,2229,2462,33669,32192,317,12.9,269,11,6972,2499,4473,7.8,21.7,4017,1597,2420,5,12.5,2955,9.2,25,0,197,197,1001
1991,39380,2253,2498,34137,33904,260,10.5,224,9,5273,2296,2977,6.8,15.6,4807,1329,3478,3.9,14.2,466,1.4,28.4,0,143,146,784
1992,39380,2235,2486,35430,34773,259,10.4,252,10.1,5969,1716,4253,4.9,17.2,4655,1210,3445,3.5,13.4,1314,3.8,26.8,0,174,174,786
1993,39380,2258,2495,35239,35321,260,10.4,247,9.9,5072,1669,3403,4.7,14.4,5235,1518,3717,4.3,14.8,-163,-0.4,28.8,0,162,162,721
1994,39380,2318,2562,37974,36652,293,11.6,226,8.9,6510,2469,4041,6.7,17.8,3865,1299,2566,3.5,10.5,2645,7.3,21,0,157,157,772
1995,39380,2387,2644,40189,39099,285,10.9,193,7.4,6356,2245,4111,5.7,16.3,4176,1225,2951,3.1,10.7,2180,5.6,21.4,0,131,131,719
1996,39380,2450,2716,41005,40585,329,12.3,252,9.4,5881,2196,3685,5.4,14.5,5040,1772,3268,4.4,12.4,841,2.1,24.8,0,162,162,1088
1997,39380,2492,2786,43705,42354,362,13.1,286,10.4,7885,3160,4725,7.5,18.6,5183,1929,3254,4.6,12.2,2702,6.4,24.4,0,180,180,1018
1998,39380,2531,2838,46273,44962,332,11.8,271,9.6,7920,2808,5112,6.2,17.6,5297,1374,3923,3.1,11.8,2623,5.8,23.6,0,200,200,908
1999,39380,2541,2836,46561,46434,316,11.1,328,11.6,6999,2344,4655,5,15.1,6744,2525,4219,5.4,14.5,255,0.6,29,0,222,222,1524
2000,39380,2535,2839,48344,47553,316,11.1,310,10.9,7763,2677,5086,5.6,16.3,6181,2237,3944,4.7,13,1582,3.3,26,0,196,196,1008
2001,39380,2525,2833,44028,46293,305,10.7,335,11.8,5381,2023,3358,4.4,11.6,9910,2308,7602,5,21.4,-4529,-9.8,23.2,0,199,199,1012
2002,39380,2580,2915,44388,44158,407,14.2,318,11.1,6875,3203,3672,7.3,15.6,6415,2045,4370,4.6,14.5,460,1.1,29,0,171,171,795
2003,39380,2595,2932,43759,43952,309,10.6,251,8.6,5628,1918,3710,4.4,12.8,6013,2061,3952,4.7,13.7,-385,-0.9,25.6,0,173,173,895
2004,39380,2648,2983,45934,45397,320,10.8,252,8.5,5717,1908,3809,4.2,12.6,4642,1390,3252,3.1,10.2,1075,2.4,20.4,0,185,185,1036
2005,39380,2644,2985,45846,45730,290,9.7,267,9,5262,1653,3609,3.6,11.5,5030,1275,3755,2.8,11,232,0.5,22,0,198,203,992
2006,39380,2627,2989,46478,46121,319,10.7,287,9.6,6852,3547,3305,7.7,14.9,6137,1727,4410,3.7,13.3,715,1.6,26.6,0,199,199,1218
2007,39380,2650,3037,47734,46976,354,11.8,277,9.2,7523,3389,4134,7.2,16,6006,1516,4490,3.2,12.8,1517,3.2,25.6,0,185,185,705
2008,39380,2630,3030,49255,48493,267,8.8,265,8.8,6337,1522,4815,3.1,13.1,4812,1423,3389,2.9,9.9,1525,3.2,19.8,0,189,189,885
2009,39380,2522,2913,46028,46743,215,7.3,296,10,4713,1482,3231,3.2,10.1,6143,1684,4459,3.6,13.1,-1430,-3,20.2,0,210,210,994
2010,39380,2503,2883,46137,45912,235,8.1,250,8.7,5705,1384,4321,3,12.4,5255,986,4269,2.1,11.4,450,1,22.8,0,160,160,623
2011,39380,2454,2829,45903,45957,232,8.2,262,9.2,5507,1460,4047,3.2,12,5614,1127,4487,2.5,12.2,-107,-0.2,24,0,177,177,736
2012,39380,2455,2821,46157,45935,235,8.3,234,8.3,5330,1760,3570,3.8,11.6,4886,1352,3534,2.9,10.6,444,1,21.2,0,157,157,857
2013,39380,2444,2817,46525,46340,236,8.4,238,8.5,5081,1290,3791,2.8,11,4711,1609,3102,3.5,10.2,370,0.8,20.4,0,168,168,1119
2014,39380,2396,2745,46759,46492,216,7.8,254,9.2,5166,1536,3630,3.3,11.1,4632,1291,3341,2.8,10,534,1.1,20,0,186,188,882
1977,39460,742,785,8072,7610,202,26.6,143,18.8,2146,1176,970,15.5,28.2,1221,664,557,8.7,16,925,12.2,32,0,99,99,417
1978,39460,823,864,8420,8256,192,23.3,114,13.8,2451,1106,1345,13.4,29.7,2123,1418,705,17.2,25.7,328,4,51.4,0,77,78,621
1979,39460,926,977,10663,9553,237,25.7,121,13.1,3777,2316,1461,24.2,39.5,1556,767,789,8,16.3,2221,23.2,32.6,0,102,102,585
1980,39460,1007,1069,12020,11289,231,22.6,137,13.4,3590,2126,1464,18.8,31.8,2128,979,1149,8.7,18.9,1462,12.9,37.8,0,107,107,717
1981,39460,1084,1152,14145,13062,255,23,162,14.6,4382,1341,3041,10.3,33.5,2215,1014,1201,7.8,17,2167,16.5,34,0,99,99,643
1982,39460,1162,1248,12572,13351,283,23.6,178,14.8,2543,1557,986,11.7,19,4100,978,3122,7.3,30.7,-1557,-11.7,38,0,107,107,576
1983,39460,1181,1268,14593,13616,203,16.1,188,15,4347,1700,2647,12.5,31.9,2393,854,1539,6.3,17.6,1954,14.3,35.2,0,118,118,533
1984,39460,1312,1408,15049,14816,310,23.2,164,12.3,4091,2153,1938,14.5,27.6,3624,962,2662,6.5,24.5,467,3.1,49,0,109,109,588
1985,39460,1370,1465,15718,15368,267,18.6,207,14.4,3637,1877,1760,12.2,23.7,2936,1381,1555,9,19.1,701,4.6,38.2,0,136,137,855
1986,39460,1501,1597,17165,16375,327,21.4,190,12.4,4557,2308,2249,14.1,27.8,2976,1246,1730,7.6,18.2,1581,9.6,36.4,0,134,134,907
1987,39460,1628,1736,18488,17838,356,21.3,204,12.2,4385,1982,2403,11.1,24.6,3084,1475,1609,8.3,17.3,1301,7.3,34.6,0,144,144,936
1988,39460,1701,1822,20217,19358,303,17,217,12.2,5025,2359,2666,12.2,26,3307,1426,1881,7.4,17.1,1718,8.9,34.2,0,158,158,873
1989,39460,1832,1971,22148,21164,366,19.3,211,11.1,5431,2693,2738,12.7,25.7,3462,1781,1681,8.4,16.4,1969,9.3,32.8,0,149,149,936
1990,39460,1992,2167,23633,22922,423,20.5,218,10.5,5399,3128,2271,13.6,23.6,3976,1294,2682,5.6,17.3,1423,6.3,34.6,0,160,160,833
1991,39460,2079,2267,24357,23953,382,17.2,269,12.1,5585,2643,2942,11,23.3,4776,1591,3185,6.6,19.9,809,3.4,39.8,0,182,182,940
1992,39460,2104,2320,24557,24387,355,15.4,288,12.5,5653,3153,2500,12.9,23.2,5312,1405,3907,5.8,21.8,341,1.4,43.6,0,208,209,977
1993,39460,2144,2355,25822,25169,321,13.7,278,11.9,5324,2327,2997,9.2,21.2,4018,1968,2050,7.8,16,1306,5.2,32,0,190,190,1002
1994,39460,2196,2402,27721,26763,325,13.7,276,11.6,6134,1857,4277,6.9,22.9,4218,1845,2373,6.9,15.8,1916,7.1,31.6,0,184,184,979
1995,39460,2229,2424,26920,27168,361,15,315,13.1,4817,1962,2855,7.2,17.7,5313,2193,3120,8.1,19.6,-496,-1.9,35.4,0,218,218,1186
1996,39460,2212,2397,27001,26963,307,12.7,333,13.8,4974,2281,2693,8.5,18.4,4897,2334,2563,8.7,18.2,77,0.2,36.4,0,235,235,1120
1997,39460,2242,2472,28626,27838,354,14.5,283,11.6,5755,2379,3376,8.5,20.7,4178,1851,2327,6.6,15,1577,5.7,30,0,197,197,1007
1998,39460,2274,2494,28717,28634,314,12.6,288,11.6,4372,1503,2869,5.2,15.3,4205,1909,2296,6.7,14.7,167,0.6,29.4,0,189,189,933
1999,39460,2340,2569,30166,29449,351,13.9,274,10.8,6085,2577,3508,8.8,20.7,4651,2263,2388,7.7,15.8,1434,4.9,31.6,0,190,190,1033
2000,39460,2403,2625,34869,33526,386,14.9,330,12.7,7025,2903,4122,8.7,21,4339,2063,2276,6.2,12.9,2686,8.1,25.8,0,204,204,1024
2001,39460,2455,2695,36615,35757,379,14.2,321,12.1,6499,2117,4382,5.9,18.2,4783,2531,2252,7.1,13.4,1716,4.8,26.8,0,188,188,758
2002,39460,2564,2795,36295,36439,450,16.4,348,12.7,7190,2818,4372,7.7,19.7,7477,2164,5313,5.9,20.5,-287,-0.8,39.4,0,192,192,1048
2003,39460,2649,2895,43971,39726,456,16.1,295,10.4,12475,2607,9868,6.6,31.4,3984,1502,2482,3.8,10,8491,21.4,20,0,223,223,1075
2004,39460,2821,3066,45019,44155,528,17.8,318,10.7,7320,2143,5177,4.9,16.6,5592,1921,3671,4.4,12.7,1728,3.9,25.4,0,221,221,949
2005,39460,2960,3229,36213,35249,565,18,363,11.6,8193,3777,4416,10.7,23.2,6265,2049,4216,5.8,17.8,1928,5.4,35.6,0,258,259,1291
2006,39460,3058,3337,39451,37689,529,16.1,398,12.1,8825,3157,5668,8.4,23.4,5301,1817,3484,4.8,14.1,3524,9.3,28.2,0,298,298,1233
2007,39460,3024,3312,41670,40489,457,13.7,478,14.4,8885,4943,3942,12.2,21.9,6523,2366,4157,5.8,16.1,2362,5.8,32.2,0,337,338,1548
2008,39460,2904,3205,50916,46123,423,13,494,15.2,16556,11809,4747,25.6,35.9,6969,2118,4851,4.6,15.1,9587,20.8,30.2,0,373,374,1542
2009,39460,2729,3015,46777,48689,357,11.5,486,15.7,4713,2145,2568,4.4,9.7,8537,2277,6260,4.7,17.5,-3824,-7.8,19.4,0,330,330,1675
2010,39460,2700,2997,41482,44028,367,12.2,371,12.4,4962,2967,1995,6.7,11.3,10053,1900,8153,4.3,22.8,-5091,-11.5,22.6,0,252,252,1303
2011,39460,2771,3067,35655,38606,413,13.6,341,11.3,5961,3331,2630,8.6,15.4,11862,7514,4348,19.5,30.7,-5901,-15.3,30.8,0,223,224,1557
2012,39460,2849,3160,38125,36914,417,13.4,332,10.7,7087,3351,3736,9.1,19.2,4665,1761,2904,4.8,12.6,2422,6.6,25.2,0,217,219,1129
2013,39460,2930,3246,40851,39429,380,11.9,304,9.5,6892,2086,4806,5.3,17.5,4048,1291,2757,3.3,10.3,2844,7.2,20.6,0,222,222,1049
2014,39460,2900,3219,43733,42120,337,10.5,345,10.7,7188,2182,5006,5.2,17.1,3961,1574,2387,3.7,9.4,3227,7.7,18.8,0,252,252,1164
1977,39540,2772,2946,57326,56179,392,13.5,314,10.8,8229,2689,5540,4.8,14.6,5935,1789,4146,3.2,10.6,2294,4,21.2,0,215,219,1099
1978,39540,2875,3044,61968,59644,382,12.8,284,9.5,11319,4209,7110,7.1,19,6671,2633,4038,4.4,11.2,4648,7.8,22.4,0,203,204,1824
1979,39540,2902,3075,62786,62352,343,11.2,298,9.7,9957,1950,8007,3.1,16,9088,2405,6683,3.9,14.6,869,1.4,29.2,0,202,202,854
1980,39540,2955,3137,62132,62454,334,10.8,268,8.6,6848,2192,4656,3.5,11,7492,2231,5261,3.6,12,-644,-1,22,0,190,191,1101
1981,39540,2864,3038,58448,60073,305,9.9,370,12,7132,2673,4459,4.4,11.9,10381,2961,7420,4.9,17.3,-3249,-5.4,23.8,0,207,207,1085
1982,39540,2937,3145,56553,57103,477,15.4,327,10.6,8688,5468,3220,9.6,15.2,9787,2693,7094,4.7,17.1,-1099,-1.9,30.4,0,180,180,1160
1983,39540,3046,3262,58852,57593,342,10.7,259,8.1,12105,3677,8428,6.4,21,9586,1822,7764,3.2,16.6,2519,4.4,33.2,0,185,185,953
1984,39540,3071,3294,60568,59656,380,11.6,344,10.5,9543,2469,7074,4.1,16,7718,2036,5682,3.4,12.9,1825,3.1,25.8,0,223,224,1124
1985,39540,3129,3359,61935,61194,395,11.9,325,9.8,8125,2583,5542,4.2,13.3,6642,2166,4476,3.5,10.9,1483,2.4,21.8,0,237,237,1305
1986,39540,2963,3185,59429,60196,332,10.1,464,14.2,7535,2841,4694,4.7,12.5,9068,4061,5007,6.7,15.1,-1533,-2.6,25,0,251,251,1237
1987,39540,3194,3456,61652,60370,467,14.1,213,6.4,10172,4821,5351,8,16.8,7608,2340,5268,3.9,12.6,2564,4.2,25.2,0,70,70,824
1988,39540,3252,3522,65528,63431,412,11.8,329,9.4,10934,3929,7005,6.2,17.2,6740,2255,4485,3.6,10.6,4194,6.6,21.2,0,207,207,1248
1989,39540,3304,3583,67972,66947,384,10.8,322,9.1,10189,3143,7046,4.7,15.2,8138,2201,5937,3.3,12.2,2051,3,24.4,0,233,233,1208
1990,39540,3362,3655,71132,69500,385,10.6,304,8.4,10832,3119,7713,4.5,15.6,7567,2538,5029,3.7,10.9,3265,4.7,21.8,0,215,216,1666
1991,39540,3485,3801,69844,70417,437,11.7,296,7.9,8824,3281,5543,4.7,12.5,9969,3970,5999,5.6,14.2,-1145,-1.7,25,0,186,187,1498
1992,39540,3453,3784,72326,71127,395,10.4,392,10.3,12122,2428,9694,3.4,17,9723,3177,6546,4.5,13.7,2399,3.3,27.4,0,258,262,1631
1993,39540,3473,3821,70802,71547,391,10.3,356,9.4,9981,3674,6307,5.1,14,11470,2515,8955,3.5,16,-1489,-2,28,0,246,246,1301
1994,39540,3462,3811,71651,71190,376,9.9,373,9.8,8277,1963,6314,2.8,11.6,7354,2429,4925,3.4,10.3,923,1.3,20.6,0,265,266,1425
1995,39540,3393,3747,72628,72127,338,8.9,382,10.1,9265,2855,6410,4,12.8,8262,2322,5940,3.2,11.5,1003,1.3,23,0,268,268,1397
1996,39540,3411,3769,72549,72579,367,9.8,335,8.9,8431,2520,5911,3.5,11.6,8491,2105,6386,2.9,11.7,-60,-0.1,23.2,0,228,228,991
1997,39540,3439,3799,73603,72996,402,10.6,367,9.7,10043,4217,5826,5.8,13.8,8828,2411,6417,3.3,12.1,1215,1.7,24.2,0,238,238,1026
1998,39540,3461,3819,77061,75953,358,9.4,335,8.8,10014,2752,7262,3.6,13.2,7798,2478,5320,3.3,10.3,2216,2.9,20.6,0,225,225,1314
1999,39540,3460,3821,73506,75281,372,9.7,362,9.5,7846,3024,4822,4,10.4,11395,3428,7967,4.6,15.1,-3549,-4.7,20.8,0,244,244,1700
2000,39540,3409,3800,76717,75068,345,9.1,355,9.3,11585,3642,7943,4.9,15.4,8286,2368,5918,3.2,11,3299,4.4,22,0,213,213,1214
2001,39540,3423,3828,72061,74482,340,8.9,344,9,7897,2698,5199,3.6,10.6,12738,5453,7285,7.3,17.1,-4841,-6.5,21.2,0,206,206,917
2002,39540,3408,3830,71692,71761,401,10.5,390,10.2,11429,4046,7383,5.6,15.9,11567,4504,7063,6.3,16.1,-138,-0.2,31.8,0,204,205,1175
2003,39540,3398,3823,72442,71859,360,9.4,316,8.3,8692,3045,5647,4.2,12.1,7525,1602,5923,2.2,10.5,1167,1.6,21,0,211,211,874
2004,39540,3405,3832,71617,71881,357,9.4,305,8,7878,2221,5657,3.1,11,8405,2651,5754,3.7,11.7,-527,-0.7,22,0,207,207,1771
2005,39540,3478,3907,69897,70602,379,9.8,280,7.3,8202,2465,5737,3.5,11.6,9611,3194,6417,4.5,13.6,-1409,-2,23.2,0,179,179,865
2006,39540,3452,3895,70803,70180,384,9.9,366,9.4,9025,3154,5871,4.5,12.9,7778,2702,5076,3.9,11.1,1247,1.8,22.2,0,236,236,1802
2007,39540,3429,3860,71859,71251,360,9.3,382,9.9,9113,2990,6123,4.2,12.8,7897,2427,5470,3.4,11.1,1216,1.7,22.2,0,236,241,1410
2008,39540,3354,3788,70024,70822,279,7.3,334,8.8,7352,1742,5610,2.5,10.4,8948,2776,6172,3.9,12.6,-1596,-2.2,20.8,0,219,219,1226
2009,39540,3224,3671,64609,67221,261,7,349,9.4,5174,1924,3250,2.9,7.7,10397,3107,7290,4.6,15.5,-5223,-7.8,15.4,0,230,230,832
2010,39540,3203,3644,63087,63661,283,7.8,274,7.5,6248,2271,3977,3.6,9.8,7396,1192,6204,1.9,11.6,-1148,-1.8,19.6,0,169,169,667
2011,39540,3163,3611,65866,64358,289,8,299,8.3,8942,2219,6723,3.4,13.9,5926,2023,3903,3.1,9.2,3016,4.7,18.4,0,195,195,988
2012,39540,3163,3616,67355,66524,342,9.5,327,9.1,7890,2625,5265,3.9,11.9,6227,2556,3671,3.8,9.4,1663,2.5,18.8,0,194,194,1116
2013,39540,3159,3597,66546,66869,261,7.3,271,7.5,5875,1462,4413,2.2,8.8,6520,1371,5149,2.1,9.8,-645,-1,17.6,0,154,154,874
2014,39540,3139,3577,67701,66985,290,8.1,282,7.9,7260,2069,5191,3.1,10.8,5827,1663,4164,2.5,8.7,1433,2.1,17.4,0,198,198,1192
1977,39580,7010,7798,119635,117357,1404,18.5,965,12.7,25024,12122,12902,10.3,21.3,20468,8089,12379,6.9,17.4,4556,3.9,34.8,0,659,660,4843
1978,39580,7368,8184,125312,122479,1343,16.8,951,11.9,25726,9612,16114,7.8,21,20060,7879,12181,6.4,16.4,5666,4.6,32.8,0,675,677,3693
1979,39580,7555,8461,139000,132078,1283,15.4,949,11.4,29515,11676,17839,8.8,22.3,15670,6722,8948,5.1,11.9,13845,10.4,23.8,0,716,717,3543
1980,39580,7692,8612,141337,140024,1144,13.4,960,11.2,23342,7707,15635,5.5,16.7,20715,7698,13017,5.5,14.8,2627,1.9,29.6,0,675,677,4356
1981,39580,7669,8641,136650,135154,1234,14.3,1146,13.3,26125,12397,13728,9.2,19.3,23132,8722,14410,6.5,17.1,2993,2.2,34.2,0,719,721,4099
1982,39580,7898,9014,145243,140867,1391,15.8,939,10.6,30274,12157,18117,8.6,21.5,21522,6053,15469,4.3,15.3,8752,6.2,30.6,0,550,550,2383
1983,39580,7693,8839,148034,145784,1161,13,1208,13.5,30578,14548,16030,10,21,26077,9093,16984,6.2,17.9,4501,3.1,35.8,0,700,702,3517
1984,39580,8932,10165,170974,159705,1691,17.8,555,5.8,36435,13368,23067,8.4,22.8,13896,4399,9497,2.8,8.7,22539,14.1,17.4,0,20,20,83
1985,39580,9571,10832,183224,177717,1727,16.4,1074,10.2,34888,11967,22921,6.7,19.6,23874,8408,15466,4.7,13.4,11014,6.2,26.8,0,670,674,3947
1986,39580,10324,11691,197961,190745,2049,18.2,1141,10.1,42664,18432,24232,9.7,22.4,28232,13177,15055,6.9,14.8,14432,7.6,29.6,0,761,764,5660
1987,39580,10824,12403,206588,203562,2146,17.8,1385,11.5,40238,18498,21740,9.1,19.8,34188,11391,22797,5.6,16.8,6050,3,33.6,0,933,935,7880
1988,39580,11114,12867,214777,209964,1984,15.7,1459,11.6,46243,18773,27470,8.9,22,36617,14264,22353,6.8,17.4,9626,4.6,34.8,0,970,970,6544
1989,39580,11455,13321,227315,221255,1948,14.9,1496,11.4,44335,18608,25727,8.4,20,32216,12229,19987,5.5,14.6,12119,5.4,29.2,0,989,990,6475
1990,39580,11929,13895,240602,233707,2019,14.8,1348,9.9,43389,15948,27441,6.8,18.6,29598,10032,19566,4.3,12.7,13791,5.9,25.4,0,908,909,5424
1991,39580,12173,14259,237397,239053,2021,14.4,1643,11.7,41135,17243,23892,7.2,17.2,44446,17498,26948,7.3,18.6,-3311,-1.4,34.4,0,1026,1031,6669
1992,39580,12564,14825,243803,240694,2188,15,1555,10.7,43939,20127,23812,8.4,18.3,37721,12782,24939,5.3,15.7,6218,2.6,31.4,0,1001,1010,6515
1993,39580,12994,15251,251434,247556,2000,13.3,1549,10.3,43916,16460,27456,6.6,17.7,36162,13420,22742,5.4,14.6,7754,3.1,29.2,0,1047,1051,8462
1994,39580,13676,16045,273749,262177,2383,15.2,1514,9.7,54443,23191,31252,8.8,20.8,31300,10971,20329,4.2,11.9,23143,8.9,23.8,0,989,990,5606
1995,39580,14353,16871,287200,280259,2504,15.2,1607,9.8,53274,20180,33094,7.2,19,39391,12770,26621,4.6,14.1,13883,4.9,28.2,0,1107,1111,6570
1996,39580,15004,17625,303013,295127,2616,15.2,1802,10.5,58772,23035,35737,7.8,19.9,43000,16423,26577,5.6,14.6,15772,5.3,29.2,0,1142,1142,6999
1997,39580,15916,18739,315677,309231,3129,17.2,2009,11,64235,24875,39360,8,20.8,51343,23418,27925,7.6,16.6,12892,4.2,33.2,0,1198,1198,9174
1998,39580,16435,19434,333757,324720,2892,15.2,2154,11.3,70167,28422,41745,8.8,21.6,52093,23561,28532,7.3,16,18074,5.6,32,0,1396,1396,9313
1999,39580,17008,20227,353143,343588,2962,14.9,2137,10.8,72853,29419,43434,8.6,21.2,53743,24113,29630,7,15.6,19110,5.6,31.2,0,1392,1392,14532
2000,39580,17303,20686,370156,361457,2793,13.7,2307,11.3,70672,29066,41606,8,19.6,53274,21408,31866,5.9,14.7,17398,4.9,29.4,0,1355,1355,9653
2001,39580,17777,21311,392349,381840,2985,14.2,2534,12.1,78654,30313,48341,7.9,20.6,57636,22384,35252,5.9,15.1,21018,5.5,30.2,0,1401,1401,9464
2002,39580,18066,21667,376576,384030,3094,14.4,2715,12.6,63503,28570,34933,7.4,16.5,78410,26138,52272,6.8,20.4,-14907,-3.9,33,0,1446,1450,8362
2003,39580,18332,22049,375395,372126,3011,13.9,2161,9.9,62643,25281,37362,6.8,16.8,56105,16490,39615,4.4,15.1,6538,1.7,30.2,0,1430,1430,8674
2004,39580,18865,22683,389282,380428,3015,13.5,2156,9.7,69688,25641,44047,6.7,18.3,51980,17381,34599,4.6,13.7,17708,4.6,27.4,0,1359,1360,8142
2005,39580,19544,23519,401573,394053,3198,13.9,2123,9.2,69769,27667,42102,7,17.7,54728,17122,37606,4.3,13.9,15041,3.8,27.8,0,1403,1403,10601
2006,39580,20421,24634,419591,409534,3558,14.8,2239,9.3,76636,31584,45052,7.7,18.7,56522,21922,34600,5.4,13.8,20114,4.9,27.6,0,1476,1476,8844
2007,39580,21135,25666,432783,425836,3602,14.3,2520,10,77931,33127,44804,7.8,18.3,64036,20437,43599,4.8,15,13895,3.3,30,0,1595,1602,10065
2008,39580,21363,26074,442299,435619,3228,12.5,2507,9.7,74775,28478,46297,6.5,17.2,61415,19712,41703,4.5,14.1,13360,3.1,28.2,0,1746,1748,11827
2009,39580,20545,25617,427250,433450,2879,11.2,3050,11.8,59600,25793,33807,6,13.8,72001,18679,53322,4.3,16.6,-12401,-2.8,27.6,0,2068,2080,10281
2010,39580,20630,25440,412093,418031,2822,11.1,2829,11.1,50930,20116,30814,4.8,12.2,62807,20286,42521,4.9,15,-11877,-2.8,24.4,0,1559,1559,9445
2011,39580,20656,25551,416219,411365,2837,11.2,2528,9.9,63057,24586,38471,6,15.3,53349,17981,35368,4.4,13,9708,2.3,26,0,1653,1662,11592
2012,39580,21116,26084,437070,425879,2938,11.4,2397,9.3,71690,22044,49646,5.2,16.8,49307,16065,33242,3.8,11.6,22383,5.2,23.2,0,1457,1462,8748
2013,39580,21522,26584,457894,446977,2834,10.8,2338,8.9,71241,21337,49904,4.8,15.9,49408,17061,32347,3.8,11.1,21833,4.8,22.2,0,1522,1526,9576
2014,39580,21867,27043,462933,459175,3018,11.3,2371,8.9,63671,21766,41905,4.7,13.9,56155,19610,36545,4.3,12.2,7516,1.7,24.4,0,1594,1594,8690
1977,39660,1858,2020,20754,19987,387,19.8,247,12.6,5147,2547,2600,12.7,25.8,3612,1467,2145,7.3,18.1,1535,7.7,36.2,0,151,151,1038
1978,39660,1969,2140,23707,22220,404,19.4,281,13.5,6124,2360,3764,10.6,27.6,3149,1663,1486,7.5,14.2,2975,13.4,28.4,0,202,202,1195
1979,39660,2025,2211,25264,24438,371,17.1,281,12.9,5821,2623,3198,10.7,23.8,4168,1686,2482,6.9,17.1,1653,6.7,34.2,0,196,196,814
1980,39660,2062,2246,24951,25096,329,14.8,270,12.1,4581,2206,2375,8.8,18.3,4871,1917,2954,7.6,19.4,-290,-1.1,36.6,0,196,197,1077
1981,39660,1984,2159,23855,23896,264,12,319,14.5,4758,2518,2240,10.5,19.9,4839,1677,3162,7,20.3,-81,-0.4,39.8,0,214,215,1049
1982,39660,1985,2185,24054,23965,298,13.7,240,11,4100,1947,2153,8.1,17.1,3922,1170,2752,4.9,16.4,178,0.7,32.8,0,137,137,602
1983,39660,2099,2302,24574,24164,337,15,242,10.8,4962,2245,2717,9.3,20.5,4141,1608,2533,6.7,17.1,821,3.4,34.2,0,167,167,952
1984,39660,2144,2348,27366,26001,363,15.6,317,13.6,6534,2255,4279,8.7,25.1,3804,1640,2164,6.3,14.6,2730,10.5,29.2,0,188,188,828
1985,39660,2216,2426,29356,28850,350,14.6,273,11.4,5989,2976,3013,10.3,20.8,4976,1794,3182,6.2,17.2,1013,3.6,34.4,0,171,171,1108
1986,39660,2239,2453,28407,28859,331,13.6,291,11.9,5150,2092,3058,7.2,17.8,6054,1859,4195,6.4,21,-904,-3.2,35.6,0,181,181,1138
1987,39660,2274,2495,30486,29789,387,15.6,335,13.5,5881,2703,3178,9.1,19.7,4487,1727,2760,5.8,15.1,1394,4.6,30.2,0,213,213,1027
1988,39660,2281,2509,29538,29364,350,14,320,12.8,4993,2130,2863,7.3,17,4645,1873,2772,6.4,15.8,348,1.2,31.6,0,207,207,934
1989,39660,2304,2539,31309,30421,316,12.5,276,10.9,5820,2013,3807,6.6,19.1,4044,1427,2617,4.7,13.3,1776,5.8,26.6,0,188,188,886
1990,39660,2370,2605,32001,31602,361,14,269,10.5,5791,1873,3918,5.9,18.3,4992,2474,2518,7.8,15.8,799,2.5,31.6,0,174,175,892
1991,39660,2457,2713,34069,33011,338,12.7,232,8.7,6187,2544,3643,7.7,18.7,4071,1176,2895,3.6,12.3,2116,6.4,24.6,0,145,145,720
1992,39660,2538,2801,35364,34742,350,12.7,260,9.4,6256,2331,3925,6.7,18,5012,1682,3330,4.8,14.4,1244,3.6,28.8,0,166,166,920
1993,39660,2624,2899,37049,36136,373,13.1,261,9.2,6437,2504,3933,6.9,17.8,4611,1558,3053,4.3,12.8,1826,5,25.6,0,191,191,1008
1994,39660,2714,3001,38443,37692,390,13.2,266,9,6232,2293,3939,6.1,16.5,4730,1859,2871,4.9,12.5,1502,4,25,0,182,182,1251
1995,39660,2770,3052,40702,39613,379,12.5,310,10.2,6321,2100,4221,5.3,16,4143,1664,2479,4.2,10.5,2178,5.5,21,0,219,219,1075
1996,39660,2813,3094,40459,40586,378,12.3,339,11,5421,2339,3082,5.8,13.4,5675,1885,3790,4.6,14,-254,-0.6,26.8,0,229,229,1049
1997,39660,2871,3172,41297,40853,457,14.6,362,11.5,7259,2949,4310,7.2,17.8,6370,2053,4317,5,15.6,889,2.2,31.2,0,236,236,1083
1998,39660,2881,3194,42309,41754,369,11.6,326,10.2,6766,2654,4112,6.4,16.2,5655,1873,3782,4.5,13.5,1111,2.7,27,0,236,236,1242
1999,39660,2878,3205,42829,42532,346,10.8,325,10.2,6028,2076,3952,4.9,14.2,5433,1468,3965,3.5,12.8,595,1.4,25.6,0,217,217,872
2000,39660,2930,3257,46917,44871,381,11.8,335,10.4,8636,2892,5744,6.4,19.2,4544,1835,2709,4.1,10.1,4092,9.1,20.2,0,207,207,926
2001,39660,2979,3321,47834,47407,391,11.9,358,10.9,7140,2913,4227,6.1,15.1,6285,2011,4274,4.2,13.3,855,1.8,26.6,0,215,215,967
2002,39660,3052,3396,46578,47185,498,14.8,419,12.5,7920,3255,4665,6.9,16.8,9134,3685,5449,7.8,19.4,-1214,-2.6,33.6,0,242,242,1839
2003,39660,3092,3440,45370,45803,405,11.9,304,8.9,6072,2225,3847,4.9,13.3,6937,2642,4295,5.8,15.1,-865,-1.8,26.6,0,196,196,796
2004,39660,3171,3530,47446,46350,410,11.8,304,8.7,7012,2343,4669,5.1,15.1,4820,1446,3374,3.1,10.4,2192,4.7,20.8,0,217,217,828
2005,39660,3226,3601,48714,47995,399,11.2,305,8.6,7663,2443,5220,5.1,16,6225,1654,4571,3.4,13,1438,3,26,0,224,224,1235
2006,39660,3280,3663,50413,49416,430,11.9,341,9.4,7696,3005,4691,6.1,15.6,5701,1946,3755,3.9,11.5,1995,4.1,23,0,227,227,1314
2007,39660,3350,3752,49412,49846,448,12.1,344,9.3,6540,2474,4066,5,13.1,7408,2485,4923,5,14.9,-868,-1.8,26.2,0,212,212,1256
2008,39660,3381,3804,49517,48630,401,10.6,330,8.8,7344,2736,4608,5.6,15.1,5570,1449,4121,3,11.5,1774,3.6,23,0,221,224,977
2009,39660,3313,3736,48306,48832,339,9,383,10.2,5556,1753,3803,3.6,11.4,6607,1534,5073,3.1,13.5,-1051,-2.1,22.8,0,257,257,978
2010,39660,3308,3727,47284,47560,305,8.2,298,8,4874,1607,3267,3.4,10.2,5426,1593,3833,3.3,11.4,-552,-1.2,20.4,0,182,182,857
2011,39660,3312,3743,47029,47121,333,8.9,299,8,5458,1536,3922,3.3,11.6,5642,1349,4293,2.9,12,-184,-0.4,23.2,0,193,194,863
2012,39660,3386,3828,49472,48278,379,10,315,8.3,6982,2290,4692,4.7,14.5,4593,1371,3222,2.8,9.5,2389,5,19,0,186,187,741
2013,39660,3400,3836,50872,50144,340,8.9,331,8.7,6658,2183,4475,4.4,13.3,5201,1517,3684,3,10.4,1457,2.9,20.8,0,209,209,1133
2014,39660,3412,3849,52049,51364,356,9.3,326,8.5,6632,2678,3954,5.2,12.9,5262,2110,3152,4.1,10.2,1370,2.7,20.4,0,219,220,1613
1977,39740,5156,5712,117043,111656,741,13.1,579,10.3,23106,6399,16707,5.7,20.7,12331,4278,8053,3.8,11,10775,9.7,22,0,402,404,2269
1978,39740,5193,5751,114721,115872,621,10.8,584,10.2,18778,5665,13113,4.9,16.2,21080,8635,12445,7.5,18.2,-2302,-2,32.4,0,392,395,4041
1979,39740,5244,5828,117343,116002,646,11.2,546,9.4,16627,4849,11778,4.2,14.3,13945,5065,8880,4.4,12,2682,2.3,24,0,378,379,2436
1980,39740,5175,5763,117102,117180,517,8.9,572,9.9,16306,3996,12310,3.4,13.9,16462,6075,10387,5.2,14,-156,-0.1,27.8,0,404,404,2076
1981,39740,5021,5613,119358,117825,559,9.8,658,11.6,17989,6307,11682,5.4,15.3,14923,5841,9082,5,12.7,3066,2.6,25.4,0,393,394,2202
1982,39740,5068,5723,117217,118210,668,11.8,494,8.7,16262,8804,7458,7.4,13.8,18247,4980,13267,4.2,15.4,-1985,-1.6,27.6,0,281,283,1822
1983,39740,5212,5869,116811,117118,562,9.7,469,8.1,14594,6158,8436,5.3,12.5,15207,4068,11139,3.5,13,-613,-0.5,25,0,282,284,1667
1984,39740,5290,5945,125212,121613,637,10.8,553,9.4,20877,7010,13867,5.8,17.2,13678,6436,7242,5.3,11.2,7199,6,22.4,0,330,330,1580
1985,39740,5410,6073,125782,125575,635,10.6,515,8.6,16013,4802,11211,3.8,12.8,15598,5519,10079,4.4,12.4,415,0.4,24.8,0,330,330,2630
1986,39740,5608,6284,126110,125919,753,12.2,529,8.6,16673,7006,9667,5.6,13.2,16290,4677,11613,3.7,12.9,383,0.3,25.8,0,346,348,2098
1987,39740,5835,6565,132748,131067,813,12.6,536,8.3,19876,7542,12334,5.8,15.2,16514,6476,10038,4.9,12.6,3362,2.6,25.2,0,341,349,2309
1988,39740,5892,6654,137301,134969,729,11,617,9.3,20622,8269,12353,6.1,15.3,15958,5110,10848,3.8,11.8,4664,3.5,23.6,0,440,440,2662
1989,39740,6002,6799,137466,136038,724,10.8,567,8.4,17644,5295,12349,3.9,13,14788,5430,9358,4,10.9,2856,2.1,21.8,0,392,392,3254
1990,39740,6080,6924,140260,139012,688,10,535,7.8,18556,5086,13470,3.7,13.3,16059,4146,11913,3,11.6,2497,1.7,23.2,0,382,383,2787
1991,39740,6145,7001,135746,137818,720,10.3,642,9.2,16693,6913,9780,5,12.1,20836,5948,14888,4.3,15.1,-4143,-3,24.2,0,392,397,2337
1992,39740,6189,7089,135746,135760,701,9.9,592,8.4,17735,6479,11256,4.8,13.1,17762,6201,11561,4.6,13.1,-27,0,26.2,0,395,400,3042
1993,39740,6207,7106,135394,135516,626,8.8,586,8.3,17511,5849,11662,4.3,12.9,17754,5634,12120,4.2,13.1,-243,-0.2,25.8,0,409,412,2962
1994,39740,6218,7114,135239,135253,607,8.5,578,8.1,16401,5825,10576,4.3,12.1,16429,5062,11367,3.7,12.1,-28,0,24.2,0,395,398,2598
1995,39740,6344,7246,139051,137101,706,9.8,554,7.7,17657,5043,12614,3.7,12.9,13756,4217,9539,3.1,10,3901,2.9,20,0,371,371,2005
1996,39740,6353,7260,138235,138746,592,8.2,564,7.8,14695,4762,9933,3.4,10.6,15717,5090,10627,3.7,11.3,-1022,-0.7,21.2,0,365,365,2355
1997,39740,6387,7297,142471,140081,759,10.4,719,9.9,21390,6707,14683,4.8,15.3,16609,6286,10323,4.5,11.9,4781,3.4,23.8,0,444,444,2260
1998,39740,6463,7370,143036,142672,673,9.2,590,8,18689,6540,12149,4.6,13.1,17961,5737,12224,4,12.6,728,0.5,25.2,0,387,387,2289
1999,39740,6482,7391,145006,144273,698,9.5,674,9.1,20674,7260,13414,5,14.3,19207,6418,12789,4.4,13.3,1467,1,26.6,0,410,410,2913
2000,39740,6551,7475,155492,150134,698,9.4,617,8.3,28376,15715,12661,10.5,18.9,17660,5629,12031,3.7,11.8,10716,7.1,23.6,0,360,360,2378
2001,39740,6581,7565,150393,153366,701,9.3,662,8.8,20046,8289,11757,5.4,13.1,25991,6495,19496,4.2,16.9,-5945,-3.8,26.2,0,406,406,3227
2002,39740,6638,7646,145426,147833,758,10,672,8.8,17979,7321,10658,5,12.2,22792,7455,15337,5,15.4,-4813,-3.2,24.4,0,360,362,2267
2003,39740,6621,7648,144104,144244,740,9.7,610,8,18807,5870,12937,4.1,13,19089,5440,13649,3.8,13.2,-282,-0.2,26,0,384,384,2621
2004,39740,6728,7716,144049,143558,740,9.7,613,8,18991,5178,13813,3.6,13.2,18010,6256,11754,4.4,12.5,981,0.7,25,0,404,404,2821
2005,39740,6778,7779,146636,144873,783,10.1,660,8.5,18954,6743,12211,4.7,13.1,15429,4584,10845,3.2,10.7,3525,2.4,21.4,0,445,445,2487
2006,39740,6804,7858,150140,148225,778,10,645,8.3,19912,7341,12571,5,13.4,16081,6052,10029,4.1,10.8,3831,2.6,21.6,0,456,461,3234
2007,39740,6806,7871,151828,150830,718,9.1,683,8.7,18550,6177,12373,4.1,12.3,16554,4795,11759,3.2,11,1996,1.3,22,0,402,406,2236
2008,39740,6784,7899,153703,152099,716,9.1,622,7.9,17858,4838,13020,3.2,11.7,14649,3734,10915,2.5,9.6,3209,2.1,19.2,0,466,467,3073
2009,39740,6605,7710,143528,148056,544,7,660,8.5,12641,4039,8602,2.7,8.5,21696,5260,16436,3.6,14.7,-9055,-6.2,17,0,434,434,2926
2010,39740,6532,7634,146169,144285,565,7.4,593,7.8,18825,5080,13745,3.5,13,15056,3276,11780,2.3,10.4,3769,2.6,20.8,0,387,387,1919
2011,39740,6386,7496,144880,145298,502,6.7,564,7.5,16065,4396,11669,3,11.1,16900,8320,8580,5.7,11.6,-835,-0.5,22.2,0,375,375,7068
2012,39740,6465,7562,146822,145665,590,7.9,528,7,15979,4692,11287,3.2,11,13664,4095,9569,2.8,9.4,2315,1.6,18.8,0,325,329,2508
2013,39740,6429,7538,147491,147017,527,7,531,7.1,14616,4057,10559,2.8,9.9,13667,4006,9661,2.7,9.3,949,0.6,18.6,0,345,347,3245
2014,39740,6377,7524,150526,148774,576,7.7,533,7.1,16909,5322,11587,3.6,11.4,13404,3857,9547,2.6,9,3505,2.4,18,0,354,355,2477
1977,39820,2287,2426,22099,21355,633,27.7,340,14.9,6072,3276,2796,15.3,28.4,4583,2748,1835,12.9,21.5,1489,6.9,43,0,225,226,1235
1978,39820,2470,2617,25423,23765,597,23.7,407,16.1,7122,3072,4050,12.9,30,3806,2047,1759,8.6,16,3316,14,32,0,263,263,1122
1979,39820,2713,2858,27834,26544,649,23.7,378,13.8,7485,3816,3669,14.4,28.2,4904,2261,2643,8.5,18.5,2581,9.7,37,0,279,280,1060
1980,39820,2809,2956,50637,39134,577,19.9,444,15.3,29339,2965,26374,7.6,75,6332,2748,3584,7,16.2,23007,58.8,32.4,0,322,322,1793
1981,39820,2696,2829,27054,38759,454,15.7,528,18.3,5511,2595,2916,6.7,14.2,28921,2460,26461,6.3,74.6,-23410,-60.4,28.4,0,331,332,1477
1982,39820,2653,2824,25650,26268,463,16.4,412,14.6,4820,2318,2502,8.8,18.3,6055,1860,4195,7.1,23.1,-1235,-4.8,36.6,0,230,230,990
1983,39820,2726,2886,26155,25820,421,14.7,391,13.7,5620,2381,3239,9.2,21.8,4949,2014,2935,7.8,19.2,671,2.6,38.4,0,243,243,1211
1984,39820,2917,3084,29779,27934,553,18.5,354,11.9,7539,3023,4516,10.8,27,3849,1365,2484,4.9,13.8,3690,13.2,27.6,0,224,224,980
1985,39820,3055,3222,30111,30064,532,16.9,407,12.9,6439,2404,4035,8,21.4,6345,2796,3549,9.3,21.1,94,0.3,42.2,0,257,258,1350
1986,39820,3238,3405,32154,31137,601,18.1,406,12.3,7603,3126,4477,10,24.4,5568,2195,3373,7,17.9,2035,6.5,35.8,0,232,232,1087
1987,39820,3393,3574,35465,33764,642,18.4,439,12.6,9053,3319,5734,9.8,26.8,5651,2441,3210,7.2,16.7,3402,10.1,33.4,0,293,293,1372
1988,39820,3450,3644,38420,36845,516,14.3,422,11.7,9644,3189,6455,8.7,26.2,6493,2665,3828,7.2,17.6,3151,8.6,35.2,0,297,297,1452
1989,39820,3266,3473,37509,38023,487,13.7,648,18.2,7860,2709,5151,7.1,20.7,8888,3958,4930,10.4,23.4,-1028,-2.7,41.4,0,316,316,1603
1990,39820,3601,3836,42227,39805,751,20.6,360,9.9,10857,5220,5637,13.1,27.3,6012,2156,3856,5.4,15.1,4845,12.2,30.2,0,254,255,1382
1991,39820,3772,4027,41855,41968,590,15,391,10,7922,3308,4614,7.9,18.9,8148,2513,5635,6,19.4,-226,-0.5,37.8,0,273,283,1686
1992,39820,3724,4006,40987,41434,527,13.1,522,13,7442,2856,4586,6.9,18,8336,2875,5461,6.9,20.1,-894,-2.1,36,0,359,360,1972
1993,39820,3624,3897,40154,40549,426,10.8,513,13,6302,1854,4448,4.6,15.5,7092,2662,4430,6.6,17.5,-790,-2,31,0,352,352,1557
1994,39820,3608,3880,40500,40288,462,11.9,456,11.7,6855,2361,4494,5.9,17,6431,2306,4125,5.7,16,424,1,32,0,306,306,1283
1995,39820,3534,3809,40982,40606,425,11.1,461,12,6951,2838,4113,7,17.1,6198,2257,3941,5.6,15.3,753,1.8,30.6,0,305,305,1244
1996,39820,3528,3822,41734,41390,451,11.8,451,11.8,7169,2765,4404,6.7,17.3,6481,2079,4402,5,15.7,688,1.6,31.4,0,306,306,1236
1997,39820,3536,3855,42951,42272,488,12.7,442,11.5,8408,3429,4979,8.1,19.9,7050,2463,4587,5.8,16.7,1358,3.2,33.4,0,291,291,1448
1998,39820,3509,3856,43916,43419,444,11.5,426,11,7676,3296,4380,7.6,17.7,6681,2014,4667,4.6,15.4,995,2.3,30.8,0,300,300,1338
1999,39820,3511,3849,43392,43604,415,10.8,422,11,6951,2665,4286,6.1,15.9,7375,3032,4343,7,16.9,-424,-1,31.8,0,262,262,1240
2000,39820,3518,3869,45727,44724,427,11.1,415,10.8,7538,2888,4650,6.5,16.9,5532,1945,3587,4.3,12.4,2006,4.5,24.8,0,256,256,1282
2001,39820,3579,3940,47543,46748,463,11.8,424,10.8,7960,2953,5007,6.3,17,6369,2595,3774,5.6,13.6,1591,3.4,27.2,0,235,235,1202
2002,39820,3623,3993,49126,48278,553,14,495,12.5,9301,3714,5587,7.7,19.3,7605,3080,4525,6.4,15.8,1696,3.5,31.6,0,263,263,1418
2003,39820,3691,4072,51158,49841,525,13.1,374,9.3,9204,3886,5318,7.8,18.5,6570,2606,3964,5.2,13.2,2634,5.3,26.4,0,270,272,1478
2004,39820,3715,4094,51645,51320,485,11.9,425,10.4,8220,3313,4907,6.5,16,7569,2088,5481,4.1,14.7,651,1.3,29.4,0,288,288,1248
2005,39820,3783,4195,51552,51135,523,12.6,392,9.5,7923,3408,4515,6.7,15.5,7089,1685,5404,3.3,13.9,834,1.6,27.8,0,304,304,1389
2006,39820,3812,4241,53096,52203,502,11.9,437,10.4,8551,2764,5787,5.3,16.4,6765,2420,4345,4.6,13,1786,3.4,26,0,320,320,1878
2007,39820,3874,4317,53131,53026,532,12.4,439,10.3,9074,3474,5600,6.6,17.1,8864,2817,6047,5.3,16.7,210,0.4,33.4,0,287,287,1652
2008,39820,3765,4217,52474,52652,436,10.3,484,11.4,6802,3086,3716,5.9,12.9,7157,2374,4783,4.5,13.6,-355,-0.7,25.8,0,349,349,1672
2009,39820,3552,3992,47955,50070,279,6.8,475,11.6,4433,1483,2950,3,8.9,8662,1893,6769,3.8,17.3,-4229,-8.4,17.8,0,338,338,1396
2010,39820,3429,3860,46195,46938,308,7.9,401,10.2,4587,1517,3070,3.2,9.8,6072,1788,4284,3.8,12.9,-1485,-3.1,19.6,0,255,255,1035
2011,39820,3335,3760,45441,45693,312,8.2,378,9.9,4945,1437,3508,3.1,10.8,5449,1771,3678,3.9,11.9,-504,-1.1,21.6,0,262,262,1221
2012,39820,3357,3780,46184,45843,365,9.7,367,9.8,6093,1937,4156,4.2,13.3,5410,1990,3420,4.3,11.8,683,1.5,23.6,0,245,245,1100
2013,39820,3285,3699,47473,46704,290,7.8,370,9.9,6083,2253,3830,4.8,13,4545,1751,2794,3.7,9.7,1538,3.3,19.4,0,256,258,1153
2014,39820,3280,3676,47014,47101,338,9.2,335,9.1,5082,1433,3649,3,10.8,5255,1580,3675,3.4,11.2,-173,-0.4,21.6,0,229,229,1067
1977,39900,4249,4645,66883,62696,1112,25.1,661,14.9,17929,8536,9393,13.6,28.6,9554,5010,4544,8,15.2,8375,13.4,30.4,0,473,475,3308
1978,39900,4175,4585,78180,72293,894,19.4,900,19.5,23546,9082,14464,12.6,32.6,11771,7228,4543,10,16.3,11775,16.3,32.6,0,490,492,2919
1979,39900,4881,5326,96731,87549,1120,22.6,426,8.6,30347,13751,16596,15.7,34.7,11983,4068,7915,4.6,13.7,18364,21,27.4,0,24,24,414
1980,39900,5008,5494,98282,96944,1030,19,823,15.2,21696,8383,13313,8.6,22.4,19019,6853,12166,7.1,19.6,2677,2.8,39.2,0,614,616,5289
1981,39900,4955,5438,96003,96748,928,17,926,17,20425,10255,10170,10.6,21.1,21914,6180,15734,6.4,22.7,-1489,-1.6,42.2,0,560,564,3348
1982,39900,5143,5707,94408,95015,1078,19.3,744,13.3,20045,10672,9373,11.2,21.1,21259,6733,14526,7.1,22.4,-1214,-1.3,42.2,0,429,430,3012
1983,39900,5234,5790,92281,93426,810,14.1,747,13,16136,8223,7913,8.8,17.3,18426,5950,12476,6.4,19.7,-2290,-2.4,34.6,0,494,495,3523
1984,39900,5529,6093,104910,98386,1021,17.2,716,12.1,27506,8388,19118,8.5,28,14458,7122,7336,7.2,14.7,13048,13.3,29.4,0,456,456,2603
1985,39900,5688,6244,109982,107432,978,15.9,823,13.3,19923,6239,13684,5.8,18.5,14822,6083,8739,5.7,13.8,5101,4.7,27.6,0,529,530,2733
1986,39900,5901,6472,112591,111373,1096,17.2,844,13.3,20795,8439,12356,7.6,18.7,18358,7508,10850,6.7,16.5,2437,2.2,33,0,586,586,3969
1987,39900,6192,6826,117339,116214,1263,19,881,13.2,27749,12338,15411,10.6,23.9,25499,8543,16956,7.4,21.9,2250,2,43.8,0,568,571,5624
1988,39900,6232,6924,120096,118460,1028,15,910,13.2,26155,8549,17606,7.2,22.1,22882,10014,12868,8.5,19.3,3273,2.8,38.6,0,593,593,3664
1989,39900,6395,7129,122933,121541,1067,15.2,860,12.2,24795,10227,14568,8.4,20.4,22013,8639,13374,7.1,18.1,2782,2.3,36.2,0,550,550,4363
1990,39900,6567,7347,130437,126797,1078,14.9,808,11.2,26270,7680,18590,6.1,20.7,18991,6858,12133,5.4,15,7279,5.7,30,0,544,544,3816
1991,39900,6750,7571,127258,128642,1110,14.9,883,11.8,20384,7707,12677,6,15.8,23151,8167,14984,6.3,18,-2767,-2.2,31.6,0,549,556,4979
1992,39900,6931,7774,126273,126769,1151,15,900,11.7,19677,7376,12301,5.8,15.5,20669,6580,14089,5.2,16.3,-992,-0.8,31,0,542,545,2847
1993,39900,7044,7822,128351,127214,994,12.7,908,11.6,19923,6008,13915,4.7,15.7,17649,6313,11336,5,13.9,2274,1.8,27.8,0,522,529,2748
1994,39900,7381,8177,135497,131851,1197,15,810,10.1,23195,7339,15856,5.6,17.6,15902,6043,9859,4.6,12.1,7293,5.5,24.2,0,518,519,2792
1995,39900,7650,8477,139781,137464,1258,15.1,914,11,23015,8982,14033,6.5,16.7,18380,7048,11332,5.1,13.4,4635,3.3,26.8,0,611,611,4788
1996,39900,7824,8675,147259,143485,1247,14.5,1013,11.8,27665,11525,16140,8,19.3,20117,7616,12501,5.3,14,7548,5.3,28,0,670,670,3209
1997,39900,8023,8917,153468,150520,1361,15.4,1116,12.7,31068,12593,18475,8.4,20.6,25171,9334,15837,6.2,16.7,5897,3.9,33.4,0,662,662,3926
1998,39900,8221,9170,156906,154984,1323,14.6,1029,11.4,24589,9167,15422,5.9,15.9,20745,6977,13768,4.5,13.4,3844,2.5,26.8,0,660,660,3745
1999,39900,8435,9460,160710,158788,1386,14.9,1091,11.7,27523,11894,15629,7.5,17.3,23679,8839,14840,5.6,14.9,3844,2.4,29.8,0,699,699,4122
2000,39900,8512,9629,168090,164419,1325,13.9,1166,12.2,32212,11370,20842,6.9,19.6,24869,11310,13559,6.9,15.1,7343,4.5,30.2,0,707,707,4044
2001,39900,8655,9787,173356,171081,1317,13.5,1237,12.7,28126,10204,17922,6,16.4,23575,8224,15351,4.8,13.8,4551,2.6,27.6,0,750,752,4318
2002,39900,8811,9997,176186,176217,1512,15.3,1269,12.9,31371,13454,17917,7.6,17.8,31432,10305,21127,5.8,17.8,-61,0,35.6,0,713,713,5040
2003,39900,8901,10107,175885,175449,1378,13.8,1087,10.9,27140,9844,17296,5.6,15.5,26267,7173,19094,4.1,15,873,0.5,30,0,752,757,3768
2004,39900,9101,10337,182667,178733,1426,14,1062,10.4,29752,11287,18465,6.3,16.6,21884,6474,15410,3.6,12.2,7868,4.4,24.4,0,726,729,3837
2005,39900,9272,10586,195362,188746,1418,13.6,1061,10.2,33774,12804,20970,6.8,17.9,20541,6707,13834,3.6,10.9,13233,7,21.8,0,752,752,4292
2006,39900,9594,10988,199156,196856,1640,15.2,1166,10.8,35538,14321,21217,7.3,18.1,30938,9275,21663,4.7,15.7,4600,2.4,31.4,0,807,808,5783
2007,39900,9759,11244,201383,199768,1540,13.9,1239,11.2,36721,14196,22525,7.1,18.4,33491,10221,23270,5.1,16.8,3230,1.6,33.6,0,800,801,5424
2008,39900,9708,11229,194683,197526,1275,11.4,1201,10.7,29476,11394,18082,5.8,14.9,35161,10082,25079,5.1,17.8,-5685,-2.9,29.8,0,863,867,5172
2009,39900,9311,10827,174637,183819,1091,9.9,1370,12.5,21315,9874,11441,5.4,11.6,39678,10573,29105,5.8,21.6,-18363,-10,23.2,0,938,938,6949
2010,39900,9038,10524,167779,170780,1076,10.1,1261,11.9,20188,8224,11964,4.8,11.8,26189,7569,18620,4.4,15.3,-6001,-3.5,23.6,0,855,856,4663
2011,39900,8880,10382,166048,166460,1061,10.2,1119,10.7,21055,6996,14059,4.2,12.6,21878,7516,14362,4.5,13.1,-823,-0.5,25.2,0,769,772,4792
2012,39900,8845,10300,173896,169850,1050,10.2,1128,10.9,29425,13724,15701,8.1,17.3,21333,6885,14448,4.1,12.6,8092,4.7,25.2,0,719,726,3548
2013,39900,8892,10390,170799,172007,1058,10.3,950,9.2,23393,8287,15106,4.8,13.6,25809,6348,19461,3.7,15,-2416,-1.4,27.2,0,632,633,4040
2014,39900,9013,10490,177446,173610,1081,10.4,890,8.6,25676,7945,17731,4.6,14.8,18004,6972,11032,4,10.4,7672,4.4,20.8,0,601,602,4673
1977,40060,12920,15239,263607,263918,2361,15.7,1871,12.5,48634,21527,27107,8.2,18.4,49257,15298,33959,5.8,18.7,-623,-0.3,36.8,0,1266,1274,8716
1978,40060,13403,15809,290327,277040,2234,14.4,1656,10.7,62584,17092,45492,6.2,22.6,36010,17989,18021,6.5,13,26574,9.6,26,0,1131,1132,10467
1979,40060,13673,16119,302673,296306,2080,13,1696,10.6,53494,17062,36432,5.8,18.1,40759,12937,27822,4.4,13.8,12735,4.3,27.6,0,1171,1172,5817
1980,40060,13775,16274,310797,306560,2045,12.6,1805,11.1,47986,14993,32993,4.9,15.7,39512,12531,26981,4.1,12.9,8474,2.8,25.8,0,1245,1249,6108
1981,40060,13469,15976,306536,306631,1959,12.2,2118,13.2,45503,18305,27198,6,14.8,45692,18179,27513,5.9,14.9,-189,-0.1,29.6,0,1241,1246,7051
1982,40060,13538,16336,312402,309617,2345,14.5,1821,11.3,51055,20345,30710,6.6,16.5,45484,14371,31113,4.6,14.7,5571,1.8,29.4,0,1033,1033,6049
1983,40060,14101,16900,313026,312251,2020,12.2,1643,9.9,46738,16394,30344,5.3,15,45188,14155,31033,4.5,14.5,1550,0.5,29,0,1041,1048,6426
1984,40060,13913,16800,316017,308328,2250,13.4,2213,13.1,55442,18824,36618,6.1,18,40064,15009,25055,4.9,13,15378,5,26,0,1124,1124,6321
1985,40060,15498,18495,332160,331859,2546,14.4,1036,5.9,51450,19296,32154,5.8,15.5,50847,12732,38115,3.8,15.3,603,0.2,30.6,0,41,48,1537
1986,40060,16181,19259,351681,341885,2698,14.3,1907,10.1,63129,24862,38267,7.3,18.5,43536,15587,27949,4.6,12.7,19593,5.8,25.4,0,1167,1172,6860
1987,40060,16781,20227,362790,356937,3214,16.3,2200,11.1,67820,26426,41394,7.4,19,56114,18990,37124,5.3,15.7,11706,3.3,31.4,0,1402,1413,8981
1988,40060,17152,20777,385066,371340,2861,14,2209,10.8,76720,28291,48429,7.6,20.7,49267,18756,30511,5.1,13.3,27453,7.4,26.6,0,1415,1415,6700
1989,40060,17560,21480,394169,390161,2861,13.5,2214,10.5,64670,24763,39907,6.3,16.6,56654,17112,39542,4.4,14.5,8016,2.1,29,0,1423,1437,9184
1990,40060,18051,22171,403363,398392,2828,13,2026,9.3,63511,25341,38170,6.4,15.9,53569,16173,37396,4.1,13.4,9942,2.5,26.8,0,1306,1314,7721
1991,40060,18242,22550,396853,400222,2803,12.5,2435,10.9,57245,26568,30677,6.6,14.3,63983,21624,42359,5.4,16,-6738,-1.7,28.6,0,1455,1465,9251
1992,40060,18447,22867,396002,396381,2863,12.6,2442,10.7,60285,22785,37500,5.7,15.2,61043,19928,41115,5,15.4,-758,-0.2,30.4,0,1492,1515,10924
1993,40060,18759,23091,482000,439184,2552,11.1,2274,9.9,140662,18873,121789,4.3,32,55030,18859,36171,4.3,12.5,85632,19.5,25,0,1374,1382,7140
1994,40060,19155,23532,408807,445126,2651,11.4,2166,9.3,62895,22407,40488,5,14.1,135533,15986,119547,3.6,30.4,-72638,-16.3,28.2,0,1354,1357,7632
1995,40060,19681,24192,423023,415858,2809,11.8,2106,8.8,63202,23307,39895,5.6,15.2,48871,15273,33598,3.7,11.8,14331,3.4,23.6,0,1356,1360,7781
1996,40060,19930,24476,431125,427239,2785,11.4,2452,10.1,68230,22855,45375,5.3,16,60457,21268,39189,5,14.2,7773,1.8,28.4,0,1487,1487,7372
1997,40060,20308,24946,448987,440100,3098,12.5,2648,10.7,80135,32993,47142,7.5,18.2,62362,23969,38393,5.4,14.2,17773,4,28.4,0,1498,1498,9103
1998,40060,20460,25458,454041,451633,3284,13,2703,10.7,71989,29059,42930,6.4,15.9,67173,29169,38004,6.5,14.9,4816,1,29.8,0,1598,1598,9391
1999,40060,20628,25462,470313,463496,2869,11.3,2850,11.2,78427,30518,47909,6.6,16.9,64792,25955,38837,5.6,14,13635,2.9,28,0,1568,1568,9352
2000,40060,20615,25608,486412,478352,2775,10.9,2592,10.2,82725,30101,52624,6.3,17.3,66604,27755,38849,5.8,13.9,16121,3.4,27.8,0,1464,1464,8637
2001,40060,20878,26002,495570,491531,2968,11.5,2766,10.7,83265,35550,47715,7.2,16.9,75186,21764,53422,4.4,15.3,8079,1.6,30.6,0,1454,1456,7143
2002,40060,21254,26376,494701,494877,3359,12.8,2976,11.4,83986,32032,51954,6.5,17,84338,33592,50746,6.8,17,-352,0,34,0,1464,1465,10415
2003,40060,21570,26757,489114,490435,3168,12,2302,8.7,73058,28819,44239,5.9,14.9,75699,21914,53785,4.5,15.4,-2641,-0.5,29.8,0,1453,1460,10057
2004,40060,22200,27522,504433,493777,3292,12.2,2251,8.3,82130,32006,50124,6.5,16.6,60818,18160,42658,3.7,12.3,21312,4.3,24.6,0,1500,1505,9946
2005,40060,22680,28069,517592,508896,3226,11.6,2390,8.6,78975,32988,45987,6.5,15.5,61582,19921,41661,3.9,12.1,17393,3.4,24.2,0,1548,1554,9648
2006,40060,23179,28735,527421,520302,3507,12.4,2563,9.1,80006,31578,48428,6.1,15.4,65768,22698,43070,4.4,12.6,14238,2.8,25.2,0,1694,1700,11166
2007,40060,23561,29369,525279,525247,3392,11.7,2735,9.4,82704,26430,56274,5,15.7,82639,31739,50900,6,15.7,65,0,31.4,0,1644,1658,16966
2008,40060,23497,29321,531484,526254,2926,10,2645,9.1,75156,24445,50711,4.6,14.3,64695,17264,47431,3.3,12.3,10461,2,24.6,0,1805,1809,9915
2009,40060,22729,28613,507111,516144,2541,8.8,2961,10.3,63057,26376,36681,5.1,12.2,81123,21716,59407,4.2,15.7,-18066,-3.5,24.4,0,2023,2029,11877
2010,40060,22349,28176,477315,488497,2380,8.4,2634,9.3,59237,21731,37506,4.4,12.1,81601,28250,53351,5.8,16.7,-22364,-4.6,24.2,0,1693,1694,15978
2011,40060,21982,27797,477001,475933,2528,9.1,2580,9.3,60826,22774,38052,4.8,12.8,58689,19943,38746,4.2,12.3,2137,0.5,24.6,0,1661,1662,9655
2012,40060,22291,28134,492226,484513,2745,9.8,2432,8.7,77141,21394,55747,4.4,15.9,61714,21075,40639,4.3,12.7,15427,3.2,25.4,0,1384,1399,7432
2013,40060,22538,28485,513682,501991,2703,9.6,2293,8.1,73794,24145,49649,4.8,14.7,50412,12724,37688,2.5,10,23382,4.7,20,0,1428,1435,7544
2014,40060,22580,28664,524489,517757,2629,9.2,2247,7.9,66521,17011,49510,3.3,12.8,53057,15535,37522,3,10.2,13464,2.6,20.4,0,1529,1536,7662
1977,40140,19788,22797,298745,283068,4824,22,3084,14,76423,37458,38965,13.2,27,45069,20437,24632,7.2,15.9,31354,11.1,31.8,0,2072,2080,12103
1978,40140,20885,24044,333693,316106,4742,20.2,3479,14.9,83048,31792,51256,10.1,26.3,47874,24330,23544,7.7,15.1,35174,11.2,30.2,0,2299,2312,13778
1979,40140,22515,25854,370455,351395,5297,21.2,3280,13.2,92962,38808,54154,11,26.5,54842,22225,32617,6.3,15.6,38120,10.9,31.2,0,2413,2420,15018
1980,40140,23344,26828,378818,376124,4773,18.1,3622,13.8,78688,36169,42519,9.6,20.9,73300,24356,48944,6.5,19.5,5388,1.4,39,0,2607,2611,14626
1981,40140,23086,26638,375156,372513,4516,16.9,4370,16.4,82512,40492,42020,10.9,22.2,77226,31139,46087,8.4,20.7,5286,1.5,41.4,0,2750,2757,16181
1982,40140,23694,27843,371585,372944,5048,18.5,3544,13,74333,38738,35595,10.4,19.9,77050,25424,51626,6.8,20.7,-2717,-0.8,39.8,0,2037,2038,12120
1983,40140,24285,28437,373493,372179,4137,14.7,3704,13.2,72696,30353,42343,8.2,19.5,70067,24109,45958,6.5,18.8,2629,0.7,37.6,0,2352,2359,12353
1984,40140,26087,30406,421706,396905,5447,18.5,3461,11.8,110477,42354,68123,10.7,27.8,60875,22369,38506,5.6,15.3,49602,12.5,30.6,0,2178,2180,11504
1985,40140,27727,32059,452895,438907,5418,17.3,3817,12.2,104124,39881,64243,9.1,23.7,76147,29295,46852,6.7,17.3,27977,6.4,34.6,0,2413,2420,14467
1986,40140,29520,34080,502306,476943,6087,18.4,3925,11.9,129912,53048,76864,11.1,27.2,79185,29470,49715,6.2,16.6,50727,10.6,33.2,0,2487,2493,18070
1987,40140,31603,36670,550796,531461,6987,19.7,4251,12,140846,60502,80344,11.4,26.5,102175,43251,58924,8.1,19.2,38671,7.3,38.4,0,2853,2874,21706
1988,40140,32549,38073,581726,563619,6357,17,4702,12.6,137834,57216,80618,10.2,24.5,101619,39483,62136,7,18,36215,6.5,36,0,3285,3285,21880
1989,40140,33704,39711,630551,606950,6319,16.3,4709,12.1,145367,59565,85802,9.8,24,98164,35533,62631,5.9,16.2,47203,7.8,32.4,0,3190,3204,21886
1990,40140,35468,41777,671901,650542,6937,17,4568,11.2,152334,64085,88249,9.9,23.4,109616,40521,69095,6.2,16.8,42718,6.6,33.6,0,3203,3203,25038
1991,40140,36461,43408,643983,657987,6990,16.4,5329,12.5,125843,62454,63389,9.5,19.1,153850,47690,106160,7.2,23.4,-28007,-4.3,38.2,0,3444,3470,28342
1992,40140,36081,43448,633624,638600,6488,14.9,6208,14.3,125272,52827,72445,8.3,19.6,135224,44455,90769,7,21.2,-9952,-1.6,39.2,0,4159,4189,25073
1993,40140,35239,42516,642704,637339,5544,12.9,6135,14.3,128714,53547,75167,8.4,20.2,117983,44698,73285,7,18.5,10731,1.7,37,0,4200,4244,23876
1994,40140,34710,41921,647636,644637,5630,13.3,5960,14.1,121755,53322,68433,8.3,18.9,115758,47266,68492,7.3,18,5997,0.9,36,0,3896,3915,26018
1995,40140,35056,42309,669379,657896,5676,13.5,5067,12,123809,47253,76556,7.2,18.8,100843,36730,64113,5.6,15.3,22966,3.5,30.6,0,3419,3433,20074
1996,40140,35375,42650,681742,673764,5683,13.4,5140,12.1,123452,47516,75936,7.1,18.3,107496,41724,65772,6.2,16,15956,2.3,32,0,3410,3410,22677
1997,40140,36048,43524,712043,697981,6283,14.6,5403,12.5,145058,59331,85727,8.5,20.8,116934,50173,66761,7.2,16.8,28124,4,33.6,0,3216,3216,22838
1998,40140,36683,44366,749507,729533,6113,13.9,5146,11.7,148255,57225,91030,7.8,20.3,108307,43288,65019,5.9,14.8,39948,5.5,29.6,0,3440,3440,22846
1999,40140,37743,45780,798920,777437,6398,14.2,4984,11.1,156331,63466,92865,8.2,20.1,113364,46553,66811,6,14.6,42967,5.5,29.2,0,3195,3195,22902
2000,40140,38467,46716,841598,818784,6498,14.1,5559,12,167865,65089,102776,7.9,20.5,122237,53802,68435,6.6,14.9,45628,5.6,29.8,0,3418,3418,24904
2001,40140,39727,48320,867939,856299,6796,14.3,5624,11.8,156485,62671,93814,7.3,18.3,133204,52423,80781,6.1,15.6,23281,2.7,31.2,0,3333,3338,22452
2002,40140,41236,50225,893061,878462,7916,16.1,5921,12,176560,79392,97168,9,20.1,147363,52862,94501,6,16.8,29197,3.3,33.6,0,3415,3421,22713
2003,40140,42498,51830,940730,908947,7775,15.3,5259,10.3,185552,77123,108429,8.5,20.4,121985,42117,79868,4.6,13.4,63567,7,26.8,0,3741,3781,27491
2004,40140,43677,53232,995758,964077,7711,14.7,5628,10.7,191719,71328,120391,7.4,19.9,128357,48016,80341,5,13.3,63362,6.6,26.6,0,3901,3906,28519
2005,40140,45845,56148,1052738,1021569,8901,16.3,5413,9.9,197297,82423,114874,8.1,19.3,134960,47382,87578,4.6,13.2,62337,6.1,26.4,0,4009,4011,32222
2006,40140,47872,59048,1132199,1091715,9651,16.8,6238,10.9,228261,101713,126548,9.3,20.9,147294,51980,95314,4.8,13.5,80967,7.4,27,0,4559,4573,31457
2007,40140,49107,60958,1129800,1129345,9018,15,6918,11.5,201104,78135,122969,6.9,17.8,200193,61516,138677,5.4,17.7,911,0.1,35.4,0,4651,4773,33965
2008,40140,48597,60795,1084865,1101184,7778,12.8,7256,12,163815,62808,101007,5.7,14.9,196452,55813,140639,5.1,17.8,-32637,-2.9,29.8,0,5427,5434,34126
2009,40140,46605,58742,994595,1033789,6554,11,7831,13.2,127803,58641,69162,5.7,12.4,206191,55054,151137,5.3,19.9,-78388,-7.5,24.8,0,5630,5653,33455
2010,40140,45518,57666,955343,969911,6395,11,6744,11.6,122131,49908,72223,5.1,12.6,151266,45151,106115,4.7,15.6,-29135,-3,25.2,0,4677,4685,27892
2011,40140,45451,57702,976338,963970,6575,11.4,6125,10.7,144423,47683,96740,4.9,15,119687,41744,77943,4.3,12.4,24736,2.6,24.8,0,4165,4187,29231
2012,40140,46281,58609,994338,982895,6894,11.9,5944,10.2,150115,50008,100107,5.1,15.3,127228,48584,78644,4.9,12.9,22887,2.4,25.8,0,3724,3757,26715
2013,40140,46929,59293,1036734,1014420,6614,11.3,5972,10.2,163605,56028,107577,5.5,16.1,118976,44547,74429,4.4,11.7,44629,4.4,23.4,0,3883,3905,26920
2014,40140,47936,60296,1071202,1049993,7123,12,5644,9.5,168111,58251,109860,5.5,16,125693,41861,83832,4,12,42418,4,24,0,3931,3943,23853
1977,40220,4305,5016,87139,85017,758,15.4,580,11.8,14826,7424,7402,8.7,17.4,10581,3953,6628,4.6,12.4,4245,5,24.8,0,383,387,2490
1978,40220,4425,5142,91206,89176,689,13.6,556,10.9,15640,4560,11080,5.1,17.5,11580,5061,6519,5.7,13,4060,4.5,26,0,366,367,2189
1979,40220,4554,5298,95713,93375,691,13.2,514,9.8,14961,4159,10802,4.5,16,10285,3643,6642,3.9,11,4676,5,22,0,371,377,1719
1980,40220,4557,5307,96520,96072,596,11.2,570,10.8,13593,3931,9662,4.1,14.1,12696,4446,8250,4.6,13.2,897,0.9,26.4,0,415,419,2142
1981,40220,4392,5123,94921,95574,578,11.1,728,14,16478,8818,7660,9.2,17.2,17783,7847,9936,8.2,18.6,-1305,-1.4,34.4,0,436,436,2477
1982,40220,4384,5142,93062,93970,663,12.9,589,11.5,12766,5123,7643,5.5,13.6,14581,4458,10123,4.7,15.5,-1815,-1.9,27.2,0,323,323,2070
1983,40220,4512,5294,93796,93429,619,11.9,516,9.9,12676,4182,8494,4.5,13.6,11942,3681,8261,3.9,12.8,734,0.8,25.6,0,346,346,1939
1984,40220,4431,5194,100488,96995,656,12.5,720,13.7,18922,6870,12052,7.1,19.5,11936,5416,6520,5.6,12.3,6986,7.2,24.6,0,358,368,2001
1985,40220,4903,5679,107527,104414,703,12.9,266,4.9,16852,5936,10916,5.7,16.1,10625,2127,8498,2,10.2,6227,5.9,20.4,0,9,9,156
1986,40220,5116,5967,111392,109437,814,14,520,8.9,18274,7549,10725,6.9,16.7,14363,5244,9119,4.8,13.1,3911,3.6,26.2,0,343,343,2181
1987,40220,5275,6232,114495,113774,911,14.9,639,10.5,18979,7303,11676,6.4,16.7,17537,8222,9315,7.2,15.4,1442,1.3,30.8,0,394,399,2301
1988,40220,5419,6388,116819,114823,830,13.2,650,10.3,18194,8069,10125,7,15.8,14202,4355,9847,3.8,12.4,3992,3.4,24.8,0,383,383,1858
1989,40220,5484,6477,123583,120542,738,11.5,663,10.3,21983,10846,11137,9,18.2,15901,5822,10079,4.8,13.2,6082,5,26.4,0,415,426,2921
1990,40220,5543,6551,125346,124416,773,11.9,655,10.1,17488,6445,11043,5.2,14.1,15628,5763,9865,4.6,12.6,1860,1.5,25.2,0,428,430,2335
1991,40220,5617,6658,122514,123818,742,11.2,624,9.5,15280,6767,8513,5.5,12.3,17887,6100,11787,4.9,14.4,-2607,-2.1,24.6,0,385,386,2677
1992,40220,5647,6673,122266,122274,743,11.1,703,10.5,16048,6000,10048,4.9,13.1,16063,5550,10513,4.5,13.1,-15,0,26.2,0,424,427,2879
1993,40220,5786,6804,125795,124121,700,10.4,559,8.3,16664,4932,11732,4,13.4,13315,4655,8660,3.8,10.7,3349,2.7,21.4,0,357,358,2211
1994,40220,5914,6922,126668,126185,738,10.8,605,8.8,16403,5753,10650,4.6,13,15436,6368,9068,5,12.2,967,0.8,24.4,0,379,382,1721
1995,40220,5951,6941,130865,128735,709,10.2,672,9.7,19149,5152,13997,4,14.9,14889,5882,9007,4.6,11.6,4260,3.3,23.2,0,424,424,3091
1996,40220,6043,7036,130886,130821,791,11.3,667,9.5,18454,7448,11006,5.7,14.1,18324,4311,14013,3.3,14,130,0.1,28,0,422,422,1917
1997,40220,6131,7434,132231,131767,1116,15.4,711,9.8,22768,10080,12688,7.6,17.3,21840,7786,14054,5.9,16.6,928,0.7,33.2,0,398,398,2268
1998,40220,6205,7357,131109,131612,876,11.8,935,12.6,17213,6080,11133,4.6,13.1,18218,8088,10130,6.1,13.8,-1005,-0.7,26.2,0,463,463,2570
1999,40220,6179,7319,134724,133003,740,10.1,770,10.5,18275,5699,12576,4.3,13.7,14832,5269,9563,4,11.2,3443,2.5,22.4,0,425,425,2459
2000,40220,6206,7341,138393,136664,715,9.8,699,9.5,21488,6603,14885,4.8,15.7,18030,7896,10134,5.8,13.2,3458,2.5,26.4,0,394,394,2489
2001,40220,6298,7504,143708,141318,789,10.6,695,9.3,22582,10420,12162,7.4,16,17801,5497,12304,3.9,12.6,4781,3.4,25.2,0,387,387,2420
2002,40220,6324,7571,137344,140228,868,11.5,785,10.4,18619,7425,11194,5.3,13.3,24386,9338,15048,6.7,17.4,-5767,-4.1,26.6,0,403,406,2633
2003,40220,6345,7630,133438,134779,767,10.1,593,7.8,15774,5994,9780,4.4,11.7,18456,4549,13907,3.4,13.7,-2682,-2,23.4,0,400,400,2549
2004,40220,6479,7738,139694,136460,789,10.3,599,7.8,20737,7540,13197,5.5,15.2,14270,3389,10881,2.5,10.5,6467,4.7,21,0,380,380,1901
2005,40220,6535,7776,138622,138780,751,9.7,633,8.2,17104,6388,10716,4.6,12.3,17420,3884,13536,2.8,12.6,-316,-0.3,24.6,0,422,422,2059
2006,40220,6561,7862,144815,141130,819,10.5,691,8.9,22695,7593,15102,5.4,16.1,15324,5529,9795,3.9,10.9,7371,5.2,21.8,0,474,474,2811
2007,40220,6602,7922,145080,144841,816,10.3,734,9.3,23688,7549,16139,5.2,16.4,23211,7423,15788,5.1,16,477,0.4,32,0,421,426,2465
2008,40220,6604,7917,144741,144641,672,8.5,607,7.7,16750,5597,11153,3.9,11.6,16550,4345,12205,3,11.4,200,0.2,22.8,0,410,410,2766
2009,40220,6434,7748,140927,142591,558,7.1,685,8.8,15443,6377,9066,4.5,10.8,18771,3826,14945,2.7,13.2,-3328,-2.4,21.6,0,463,463,2123
2010,40220,6302,7586,133845,136872,524,6.9,642,8.4,14128,4364,9764,3.2,10.3,20182,7146,13036,5.2,14.7,-6054,-4.4,20.6,0,405,405,1729
2011,40220,6188,7484,133256,133398,576,7.7,607,8.1,14062,4664,9398,3.5,10.5,14346,4369,9977,3.3,10.8,-284,-0.3,21,0,401,402,2569
2012,40220,6178,7483,136696,134655,574,7.7,579,7.7,16972,4185,12787,3.1,12.6,12891,3996,8895,3,9.6,4081,3,19.2,0,351,361,2299
2013,40220,6177,7476,137767,137144,542,7.3,550,7.4,13946,4029,9917,2.9,10.2,12699,3744,8955,2.7,9.3,1247,0.9,18.6,0,332,333,2260
2014,40220,6130,7411,138192,137708,535,7.2,547,7.4,12866,3959,8907,2.9,9.3,11897,3753,8144,2.7,8.6,969,0.7,17.2,0,376,376,2380
1977,40340,2055,2270,48428,44280,377,17,267,12,12561,2492,10069,5.6,28.4,4265,1658,2607,3.7,9.6,8296,18.8,19.2,0,172,172,1086
1978,40340,2141,2354,49120,48768,321,13.9,238,10.3,9569,1980,7589,4.1,19.6,8864,1567,7297,3.2,18.2,705,1.4,36.4,0,168,168,1103
1979,40340,2161,2358,51279,50165,276,11.7,258,11,7640,2121,5519,4.2,15.2,5411,1889,3522,3.8,10.8,2229,4.4,21.6,0,177,177,972
1980,40340,2186,2385,52226,51726,268,11.3,233,9.8,6548,1860,4688,3.6,12.7,5547,1845,3702,3.6,10.7,1001,2,21.4,0,159,159,1203
1981,40340,2121,2311,50653,50987,251,10.7,295,12.6,5377,2230,3147,4.4,10.5,6044,2111,3933,4.1,11.9,-667,-1.4,21,0,160,161,1035
1982,40340,2128,2345,51224,51146,281,12.1,233,10,5731,2142,3589,4.2,11.2,5575,1853,3722,3.6,10.9,156,0.3,21.8,0,131,131,880
1983,40340,2190,2415,50784,50805,280,11.8,237,10,5864,2678,3186,5.3,11.5,5905,1542,4363,3,11.6,-41,-0.1,23,0,146,146,787
1984,40340,2292,2514,54879,52821,332,13.5,229,9.3,7855,2525,5330,4.8,14.9,3739,1405,2334,2.7,7.1,4116,7.8,14.2,0,138,138,672
1985,40340,2352,2593,56244,55904,334,13.1,266,10.4,5846,2023,3823,3.6,10.5,5165,2390,2775,4.3,9.2,681,1.3,18.4,0,180,180,1540
1986,40340,2378,2620,55929,56064,313,12,275,10.6,5862,2737,3125,4.9,10.5,6132,2585,3547,4.6,10.9,-270,-0.4,21,0,175,175,1143
1987,40340,2367,2633,58383,57577,349,13.3,326,12.4,7182,2668,4514,4.6,12.5,5569,2625,2944,4.6,9.7,1613,2.8,19.4,0,187,188,1161
1988,40340,2364,2645,58704,58170,316,12,280,10.6,7160,2669,4491,4.6,12.3,6091,2140,3951,3.7,10.5,1069,1.8,21,0,171,171,924
1989,40340,2396,2690,63517,61114,296,11.1,253,9.5,8836,2714,6122,4.4,14.5,4030,1505,2525,2.5,6.6,4806,7.9,13.2,0,174,174,907
1990,40340,2479,2767,66411,64947,313,11.5,231,8.5,7738,2233,5505,3.4,11.9,4809,1803,3006,2.8,7.4,2929,4.5,14.8,0,145,147,1233
1991,40340,2550,2876,64116,65257,341,12.1,229,8.1,6471,2800,3671,4.3,9.9,8752,1911,6841,2.9,13.4,-2281,-3.5,19.8,0,155,156,1373
1992,40340,2576,2954,66822,65447,348,11.9,264,9,8631,2408,6223,3.7,13.2,5880,2058,3822,3.1,9,2751,4.2,18,0,168,170,1125
1993,40340,2664,3049,69916,68390,307,10.2,206,6.9,8372,2585,5787,3.8,12.2,5320,1174,4146,1.7,7.8,3052,4.4,15.6,0,142,142,717
1994,40340,2740,3142,69102,69450,345,11.1,241,7.8,6438,2075,4363,3,9.3,7134,2086,5048,3,10.3,-696,-1,18.6,0,165,165,976
1995,40340,2797,3188,68384,68703,361,11.4,299,9.5,5881,2167,3714,3.2,8.6,6519,2348,4171,3.4,9.5,-638,-0.9,17.2,0,176,178,850
1996,40340,2879,3253,70744,69618,328,10.2,256,8,7091,2019,5072,2.9,10.2,4838,1417,3421,2,6.9,2253,3.3,13.8,0,151,151,678
1997,40340,2961,3360,73970,72398,425,12.8,320,9.7,9789,3375,6414,4.7,13.5,6645,3104,3541,4.3,9.2,3144,4.3,18.4,0,161,161,1147
1998,40340,3012,3422,77925,75903,376,11.1,303,8.9,9733,2999,6734,4,12.8,5688,2172,3516,2.9,7.5,4045,5.3,15,0,201,201,1369
1999,40340,3015,3454,80985,79766,363,10.6,329,9.6,9957,2805,7152,3.5,12.5,7518,2387,5131,3,9.4,2439,3.1,18.8,0,196,196,1245
2000,40340,3098,3542,87488,84115,404,11.6,314,9,12960,3525,9435,4.2,15.4,6213,2648,3565,3.1,7.4,6747,8,14.8,0,178,178,938
2001,40340,3199,3680,91137,89379,433,12,332,9.2,11395,5214,6181,5.8,12.7,7878,2156,5722,2.4,8.8,3517,3.9,17.6,0,193,193,1050
2002,40340,3258,3773,90510,90815,522,14,428,11.5,11114,4119,6995,4.5,12.2,11724,3625,8099,4,12.9,-610,-0.7,24.4,0,204,204,1435
2003,40340,3328,3843,91794,90889,441,11.6,318,8.4,12393,2989,9404,3.3,13.6,10583,2426,8157,2.7,11.6,1810,2,23.2,0,196,196,1027
2004,40340,3413,3940,91322,91167,424,10.9,289,7.4,8224,2281,5943,2.5,9,7913,1843,6070,2,8.7,311,0.3,17.4,0,171,172,971
2005,40340,3434,3971,91394,91219,423,10.7,359,9.1,8825,3725,5100,4.1,9.7,8475,2527,5948,2.8,9.3,350,0.4,18.6,0,244,244,1388
2006,40340,3433,3978,93019,92118,434,10.9,388,9.8,8949,2539,6410,2.8,9.7,7147,2585,4562,2.8,7.8,1802,1.9,15.6,0,221,221,978
2007,40340,3460,3993,107552,100337,431,10.8,414,10.4,22660,5655,17005,5.6,22.6,8230,2520,5710,2.5,8.2,14430,14.4,16.4,0,241,242,1378
2008,40340,3427,3965,106458,106867,378,9.6,343,8.7,9127,3216,5911,3,8.5,9944,2894,7050,2.7,9.3,-817,-0.8,17,0,217,217,1790
2009,40340,3415,3963,89301,97590,354,9,328,8.3,20916,2616,18300,2.7,21.4,37494,1553,35941,1.6,38.4,-16578,-17,42.8,0,207,207,1004
2010,40340,3364,3922,88470,88834,296,7.5,320,8.1,6213,2059,4154,2.3,7,6941,1723,5218,1.9,7.8,-728,-0.8,14,0,195,195,1229
2011,40340,3349,3916,88857,88587,305,7.8,295,7.5,7078,2102,4976,2.4,8,6537,1506,5031,1.7,7.4,541,0.6,14.8,0,181,181,785
2012,40340,3406,3953,91402,90002,366,9.3,327,8.3,8748,2327,6421,2.6,9.7,5947,1724,4223,1.9,6.6,2801,3.1,13.2,0,152,152,856
2013,40340,3433,3981,78765,84864,333,8.4,295,7.5,9700,1799,7901,2.1,11.4,21897,2206,19691,2.6,25.8,-12197,-14.4,22.8,0,179,179,969
2014,40340,3488,4037,97012,87659,350,8.8,268,6.7,31467,,,,35.9,12760,4983,7777,5.7,14.6,18707,21.3,29.2,1,176,177,1076
1977,40380,13246,15324,306393,298976,2172,14.3,1775,11.7,51043,16358,34685,5.5,17.1,36208,13683,22525,4.6,12.1,14835,5,24.2,0,1171,1172,6774
1978,40380,13559,15664,347059,340744,2020,13,1681,10.9,50327,14636,35691,4.3,14.8,37696,18922,18774,5.6,11.1,12631,3.7,22.2,0,1144,1150,11502
1979,40380,13596,15760,352753,349786,1808,11.5,1629,10.4,44385,12400,31985,3.5,12.7,38451,11175,27276,3.2,11,5934,1.7,22,0,1141,1145,4982
1980,40380,13549,15711,328249,325574,1569,10,1573,10,44801,10830,33971,3.3,13.8,39450,12520,26930,3.8,12.1,5351,1.7,24.2,0,1076,1080,6378
1981,40380,13204,15299,322730,324143,1585,10.2,1891,12.2,40931,13638,27293,4.2,12.6,43758,14580,29178,4.5,13.5,-2827,-0.9,25.2,0,1089,1092,5159
1982,40380,13459,15878,329135,326157,2106,13.5,1442,9.2,49490,20191,29299,6.2,15.2,43535,11008,32527,3.4,13.3,5955,1.9,26.6,0,834,835,5149
1983,40380,13898,16438,326373,327802,1925,11.9,1468,9.1,40961,15202,25759,4.6,12.5,43818,13289,30529,4.1,13.4,-2857,-0.9,25,0,940,959,5094
1984,40380,14376,16987,369686,362406,2023,12.1,1482,8.9,48263,15166,33097,4.2,13.3,33703,10654,23049,2.9,9.3,14560,4,18.6,0,935,937,4675
1985,40380,14848,17503,394684,382877,2161,12.5,1644,9.5,62230,25418,36812,6.6,16.3,38618,16111,22507,4.2,10.1,23612,6.2,20.2,0,1059,1066,6164
1986,40380,15206,17938,419443,406822,2138,12.1,1646,9.3,68640,19871,48769,4.9,16.9,43398,12449,30949,3.1,10.7,25242,6.2,21.4,0,1050,1050,5486
1987,40380,15551,18435,412860,417568,2450,13.5,1901,10.4,63957,19284,44673,4.6,15.3,73373,23468,49905,5.6,17.6,-9416,-2.3,30.6,0,1186,1203,8997
1988,40380,15857,18866,412936,411215,2296,12.3,1791,9.6,68050,18988,49062,4.6,16.5,64608,15611,48997,3.8,15.7,3442,0.8,31.4,0,1171,1171,6062
1989,40380,16199,19309,425369,419585,2271,11.9,1863,9.8,58484,19377,39107,4.6,13.9,46916,15467,31449,3.7,11.2,11568,2.7,22.4,0,1212,1220,7827
1990,40380,16371,19630,426187,425517,2208,11.3,1789,9.2,53346,18243,35103,4.3,12.5,52006,14789,37217,3.5,12.2,1340,0.3,24.4,0,1174,1177,6865
1991,40380,16530,19941,415819,420630,2211,11.2,1897,9.6,45381,19186,26195,4.6,10.8,55003,15347,39656,3.6,13.1,-9622,-2.3,21.6,0,1194,1198,6993
1992,40380,16343,19856,416682,416013,2046,10.3,2050,10.3,56331,20370,35961,4.9,13.5,54993,14878,40115,3.6,13.2,1338,0.3,26.4,0,1305,1333,7538
1993,40380,16422,19910,415918,416269,1916,9.6,1818,9.1,53627,17677,35950,4.2,12.9,54330,15359,38971,3.7,13.1,-703,-0.2,25.8,0,1180,1191,5778
1994,40380,16275,19789,420496,418031,1870,9.4,1923,9.7,53416,16305,37111,3.9,12.8,48485,14285,34200,3.4,11.6,4931,1.2,23.2,0,1238,1239,6789
1995,40380,16460,20020,423198,422178,2148,10.8,1877,9.4,56388,20587,35801,4.9,13.4,54348,16015,38333,3.8,12.9,2040,0.5,25.8,0,1176,1181,6748
1996,40380,16480,20168,428653,422505,2108,10.5,1915,9.5,64871,29164,35707,6.9,15.4,52575,15842,36733,3.7,12.4,12296,3,24.8,0,1230,1230,6092
1997,40380,16555,20271,429549,429360,2149,10.6,2034,10.1,64975,18598,46377,4.3,15.1,64596,27700,36896,6.5,15,379,0.1,30,0,1201,1201,8207
1998,40380,16525,20234,437111,433431,1961,9.7,1952,9.6,56095,16109,39986,3.7,12.9,48734,14111,34623,3.3,11.2,7361,1.7,22.4,0,1261,1261,6216
1999,40380,16526,20419,442565,440129,1988,9.8,1770,8.7,59991,20178,39813,4.6,13.6,55119,15810,39309,3.6,12.5,4872,1.1,25,0,1136,1136,6834
2000,40380,16504,20510,442198,441955,2045,10,1925,9.4,62019,22832,39187,5.2,14,61533,20142,41391,4.6,13.9,486,0.1,27.8,0,1092,1092,7333
2001,40380,16738,20794,442914,443370,1971,9.5,1896,9.2,61992,19060,42932,4.3,14,62904,19140,43764,4.3,14.2,-912,-0.2,28,0,1105,1110,6999
2002,40380,16826,20834,434010,438445,2350,11.3,2267,10.9,60802,23854,36948,5.4,13.9,69672,23039,46633,5.3,15.9,-8870,-2,27.8,0,1107,1111,9774
2003,40380,16905,20917,436809,433277,2122,10.2,1742,8.4,62237,19121,43116,4.4,14.4,55172,17236,37936,4,12.7,7065,1.7,25.4,0,1128,1133,7234
2004,40380,17159,21110,441538,437275,2128,10.2,1757,8.4,55520,16256,39264,3.7,12.7,46993,14786,32207,3.4,10.7,8527,2,21.4,0,1142,1144,6770
2005,40380,17251,21210,439555,439292,2115,10,1833,8.7,51938,17584,34354,4,11.8,51412,17958,33454,4.1,11.7,526,0.1,23.4,0,1261,1261,11563
2006,40380,17192,21281,438501,438139,2177,10.3,1914,9,48662,17013,31649,3.9,11.1,47937,14968,32969,3.4,10.9,725,0.2,21.8,0,1353,1357,9789
2007,40380,17284,21355,436666,436980,2164,10.2,2043,9.6,56422,20465,35957,4.7,12.9,57049,18690,38359,4.3,13.1,-627,-0.2,25.8,0,1232,1241,7058
2008,40380,17398,21500,432068,433393,2022,9.5,1681,7.9,50592,15510,35082,3.6,11.7,53242,14953,38289,3.5,12.3,-2650,-0.6,23.4,0,1142,1143,7375
2009,40380,17114,21208,422086,425711,1711,8,1853,8.7,41406,12512,28894,2.9,9.7,48655,13057,35598,3.1,11.4,-7249,-1.7,19.4,0,1147,1154,5847
2010,40380,17119,21198,417737,419556,1697,8,1616,7.6,40160,11746,28414,2.8,9.6,43798,10299,33499,2.5,10.4,-3638,-0.8,19.2,0,1038,1038,5881
2011,40380,17094,21231,423237,419769,1804,8.5,1641,7.8,44034,10835,33199,2.6,10.5,37097,9932,27165,2.4,8.8,6937,1.7,17.6,0,1101,1101,5436
2012,40380,17366,21530,430785,426636,1983,9.3,1678,7.9,50467,13605,36862,3.2,11.8,42169,13222,28947,3.1,9.9,8298,1.9,19.8,0,1021,1028,5542
2013,40380,17393,21541,436933,432903,1794,8.4,1751,8.2,50371,14660,35711,3.4,11.6,42311,12474,29837,2.9,9.8,8060,1.8,19.6,0,1082,1085,6788
2014,40380,17363,21531,430776,431996,1848,8.6,1720,8,45593,15280,30313,3.5,10.6,48032,13467,34565,3.1,11.1,-2439,-0.5,21.2,0,1155,1164,6205
1977,40420,4784,5231,104595,101575,771,14.9,611,11.8,17988,6512,11476,6.4,17.7,11948,4699,7249,4.6,11.8,6040,5.9,23.6,0,391,391,2581
1978,40420,4904,5347,113981,109285,693,13.1,580,11,19445,5402,14043,4.9,17.8,10053,4557,5496,4.2,9.2,9392,8.6,18.4,0,379,383,2560
1979,40420,4987,5449,120193,117044,677,12.5,552,10.2,17204,4943,12261,4.2,14.7,10905,3847,7058,3.3,9.3,6299,5.4,18.6,0,391,394,2038
1980,40420,5031,5507,115090,117611,695,12.7,617,11.3,13324,4919,8405,4.2,11.3,18365,4591,13774,3.9,15.6,-5041,-4.3,22.6,0,441,442,2712
1981,40420,4821,5279,105113,109292,572,10.6,740,13.8,11246,5089,6157,4.7,10.3,19604,6848,12756,6.3,17.9,-8358,-7.6,20.6,0,417,420,2440
1982,40420,4883,5426,107592,107164,754,14.1,558,10.4,16910,7092,9818,6.6,15.8,16053,4278,11775,4,15,857,0.8,30,0,310,310,1632
1983,40420,4786,5352,97979,102901,561,10.4,646,12,12674,6376,6298,6.2,12.3,22517,7224,15293,7,21.9,-9843,-9.6,24.6,0,351,353,2121
1984,40420,5087,5657,107075,103153,709,12.9,451,8.2,17654,5841,11813,5.7,17.1,9810,3873,5937,3.8,9.5,7844,7.6,19,0,221,221,1260
1985,40420,5164,5751,113152,110549,686,12,602,10.5,16639,5480,11159,5,15.1,11435,3985,7450,3.6,10.3,5204,4.8,20.6,0,398,400,2141
1986,40420,5254,5854,114754,113503,683,11.8,559,9.6,15232,5480,9752,4.8,13.4,12731,4208,8523,3.7,11.2,2501,2.2,22.4,0,378,380,2244
1987,40420,5343,5989,114812,114931,760,12.8,606,10.2,17221,6252,10969,5.4,15,17459,6740,10719,5.9,15.2,-238,-0.2,30,0,369,369,2370
1988,40420,5420,6107,125678,119808,715,11.8,565,9.4,24262,8748,15514,7.3,20.3,12522,4921,7601,4.1,10.5,11740,9.8,21,0,376,376,1969
1989,40420,5469,6165,127967,126832,666,10.9,610,9.9,18635,6316,12319,5,14.7,16365,4822,11543,3.8,12.9,2270,1.8,25.8,0,408,408,3268
1990,40420,5526,6249,128537,128069,670,10.8,559,9,17001,5977,11024,4.7,13.3,16064,4942,11122,3.9,12.5,937,0.8,25,0,363,364,3154
1991,40420,5628,6407,128896,128694,707,11.2,562,8.9,17409,6213,11196,4.8,13.5,17005,4872,12133,3.8,13.2,404,0.3,26.4,0,359,364,2671
1992,40420,5736,6517,129369,128978,716,11.1,573,8.9,17468,5156,12312,4,13.5,16686,5586,11100,4.3,12.9,782,0.6,25.8,0,361,367,2916
1993,40420,5876,6656,128395,128706,668,10.2,527,8,14468,3933,10535,3.1,11.2,15089,4629,10460,3.6,11.7,-621,-0.5,22.4,0,356,357,1915
1994,40420,5944,6725,133787,131036,652,9.7,559,8.4,18092,5628,12464,4.3,13.8,12590,3837,8753,2.9,9.6,5502,4.2,19.2,0,372,372,1734
1995,40420,6065,6856,139358,136574,726,10.7,576,8.5,18634,6027,12607,4.4,13.6,13065,4042,9023,3,9.6,5569,4,19.2,0,387,387,1933
1996,40420,6068,6852,138853,139188,686,10,682,10,15632,5261,10371,3.8,11.2,16301,4916,11385,3.5,11.7,-669,-0.5,22.4,0,442,442,2579
1997,40420,6092,6928,139831,139378,776,11.3,688,10,18688,7651,11037,5.5,13.4,17782,6135,11647,4.4,12.8,906,0.6,25.6,0,409,409,2404
1998,40420,6082,6922,140251,140014,649,9.4,642,9.3,17428,6273,11155,4.5,12.4,16953,6255,10698,4.5,12.1,475,0.3,24.2,0,414,414,3113
1999,40420,6103,6964,141070,140675,687,9.9,644,9.3,18256,7921,10335,5.6,13,17466,5749,11717,4.1,12.4,790,0.6,24.8,0,414,414,2491
2000,40420,6048,6925,144373,142707,649,9.3,690,9.9,19386,7283,12103,5.1,13.6,16053,5277,10776,3.7,11.2,3333,2.4,22.4,0,420,420,2539
2001,40420,6042,6976,142630,143336,649,9.3,642,9.2,16211,6661,9550,4.6,11.3,17622,4229,13393,3,12.3,-1411,-1,22.6,0,400,400,2423
2002,40420,6000,6926,135494,139176,757,10.9,794,11.4,17123,6858,10265,4.9,12.3,24487,7630,16857,5.5,17.6,-7364,-5.3,24.6,0,415,418,2702
2003,40420,5965,6900,138328,136029,689,10,584,8.5,20836,8118,12718,6,15.3,16237,5176,11061,3.8,11.9,4599,3.4,23.8,0,387,387,2721
2004,40420,5988,6915,137436,136945,636,9.2,566,8.2,16996,6103,10893,4.5,12.4,16013,5234,10779,3.8,11.7,983,0.7,23.4,0,362,362,2686
2005,40420,6092,7035,136094,136391,723,10.4,554,8,16652,6271,10381,4.6,12.2,17245,4821,12424,3.5,12.6,-593,-0.4,24.4,0,368,369,3098
2006,40420,6112,7087,140010,137593,766,10.9,655,9.3,20589,9037,11552,6.6,15,15754,4529,11225,3.3,11.4,4835,3.6,22.8,0,434,434,2620
2007,40420,6147,7147,143044,141612,740,10.4,674,9.5,20224,6712,13512,4.7,14.3,17359,5400,11959,3.8,12.3,2865,2,24.6,0,429,430,3120
2008,40420,6098,7122,142359,142395,671,9.4,638,9,16125,5172,10953,3.6,11.3,16197,4933,11264,3.5,11.4,-72,-0.1,22.6,0,435,435,2765
2009,40420,5845,6872,129714,135256,528,7.6,690,9.9,12890,5525,7365,4.1,9.5,23973,5642,18331,4.2,17.7,-11083,-8.2,19,0,459,459,3968
2010,40420,5732,6743,125322,127241,504,7.4,589,8.7,12189,3336,8853,2.6,9.6,16026,3308,12718,2.6,12.6,-3837,-3,19.2,0,369,370,1873
2011,40420,5655,6660,127408,126110,546,8.2,563,8.4,14648,5144,9504,4.1,11.6,12052,4092,7960,3.2,9.6,2596,2,19.2,0,378,378,2845
2012,40420,5699,6674,129690,128458,580,8.7,580,8.7,18005,5681,12324,4.4,14,15540,4140,11400,3.2,12.1,2465,1.9,24.2,0,313,314,1912
2013,40420,5624,6604,130540,129890,528,8,573,8.7,14247,4107,10140,3.2,11,12947,4922,8025,3.8,10,1300,1,20,0,343,345,2499
2014,40420,5536,6545,129724,129847,508,7.8,520,7.9,12087,3951,8136,3,9.3,12332,4376,7956,3.4,9.5,-245,-0.2,18.6,0,366,366,2527
1977,40580,2013,2237,39114,39057,370,16.8,296,13.4,7196,3300,3896,8.4,18.4,7082,3491,3591,8.9,18.1,114,0.3,36.2,0,210,211,2234
1978,40580,2085,2318,40951,39900,321,14.1,240,10.5,7113,2102,5011,5.3,17.8,5010,1605,3405,4,12.6,2103,5.2,25.2,0,169,169,960
1979,40580,2088,2326,41884,41415,294,12.7,279,12,5830,1766,4064,4.3,14.1,4891,1803,3088,4.4,11.8,939,2.3,23.6,0,204,204,1050
1980,40580,2080,2311,40800,41337,256,11,263,11.3,5412,1985,3427,4.8,13.1,6485,3016,3469,7.3,15.7,-1073,-2.6,26.2,0,181,183,1027
1981,40580,1992,2217,40404,40406,250,11.1,323,14.3,5232,2264,2968,5.6,12.9,5236,1906,3330,4.7,13,-4,-0.1,25.8,0,199,199,906
1982,40580,1983,2238,40209,40292,286,12.8,241,10.8,5627,2707,2920,6.7,14,5793,2093,3700,5.2,14.4,-166,-0.4,28,0,160,160,1008
1983,40580,1877,2129,40061,40073,243,11.1,336,15.4,6190,2088,4102,5.2,15.4,6213,2249,3964,5.6,15.5,-23,-0.1,30.8,0,197,198,1466
1984,40580,2115,2367,42616,41436,324,14.4,128,5.7,7023,1901,5122,4.6,16.9,4663,998,3665,2.4,11.3,2360,5.6,22.6,0,4,4,8
1985,40580,2192,2439,44455,43859,312,13,244,10.1,6701,2677,4024,6.1,15.3,5509,1588,3921,3.6,12.6,1192,2.7,25.2,0,155,155,661
1986,40580,2265,2528,48461,46464,321,12.9,226,9.1,8877,3146,5731,6.8,19.1,4882,2052,2830,4.4,10.5,3995,8.6,21,0,155,155,627
1987,40580,2302,2596,49835,49205,345,13.5,269,10.5,10153,4330,5823,8.8,20.6,8893,3983,4910,8.1,18.1,1260,2.5,36.2,0,169,169,1535
1988,40580,2308,2622,52235,50598,326,12.5,278,10.7,9871,3989,5882,7.9,19.5,6596,3223,3373,6.4,13,3275,6.5,26,0,185,185,1023
1989,40580,2339,2669,55495,54250,296,11.2,255,9.6,10031,3305,6726,6.1,18.5,7541,2906,4635,5.4,13.9,2490,4.6,27.8,0,164,164,1389
1990,40580,2384,2724,56901,56143,306,11.4,230,8.5,7449,2548,4901,4.5,13.3,5932,1161,4771,2.1,10.6,1517,2.7,21.2,0,170,171,816
1991,40580,2410,2765,52732,54592,292,10.6,258,9.4,6255,2376,3879,4.4,11.5,9975,3550,6425,6.5,18.3,-3720,-6.8,23,0,163,163,1483
1992,40580,2432,2781,53531,53177,279,10,262,9.4,7211,2891,4320,5.4,13.6,6503,2369,4134,4.5,12.2,708,1.4,24.4,0,152,153,893
1993,40580,2421,2760,54876,54193,247,8.9,259,9.3,8070,1680,6390,3.1,14.9,6704,2920,3784,5.4,12.4,1366,2.5,24.8,0,167,167,1205
1994,40580,2427,2782,55679,55234,278,10,242,8.7,8156,3425,4731,6.2,14.8,7265,2485,4780,4.5,13.2,891,1.6,26.4,0,172,172,958
1995,40580,2468,2819,58053,57866,276,9.9,234,8.4,7253,2083,5170,3.6,12.5,6878,2004,4874,3.5,11.9,375,0.6,23.8,0,170,172,957
1996,40580,2475,2830,57098,57563,285,10.1,273,9.7,7636,2536,5100,4.4,13.3,8565,3640,4925,6.3,14.9,-929,-1.6,26.6,0,160,160,1103
1997,40580,2525,2901,57697,57423,346,12.1,269,9.4,8615,3299,5316,5.7,15,8066,2750,5316,4.8,14,549,1,28,0,168,168,1105
1998,40580,2548,2915,57614,57677,310,10.7,293,10.1,7696,2975,4721,5.2,13.3,7821,3053,4768,5.3,13.6,-125,-0.3,26.6,0,191,191,1199
1999,40580,2546,2946,56593,57103,334,11.4,305,10.4,8040,2964,5076,5.2,14.1,9060,2803,6257,4.9,15.9,-1020,-1.8,28.2,0,187,187,1126
2000,40580,2522,2926,57645,56988,332,11.3,346,11.8,10617,2962,7655,5.2,18.6,9303,4093,5210,7.2,16.3,1314,2.3,32.6,0,193,193,1404
2001,40580,2547,2957,57274,57537,301,10.2,291,9.9,8957,3092,5865,5.4,15.6,9483,2901,6582,5,16.5,-526,-0.9,31.2,0,156,156,713
2002,40580,2526,2933,57333,57248,294,10,308,10.5,9192,4331,4861,7.6,16.1,9022,2728,6294,4.8,15.8,170,0.3,31.6,0,176,176,773
2003,40580,2522,2912,55256,56022,265,9.1,225,7.8,7070,2617,4453,4.7,12.6,8601,1743,6858,3.1,15.4,-1531,-2.8,25.2,0,148,148,884
2004,40580,2511,2920,56653,55848,289,9.9,247,8.5,8048,2391,5657,4.3,14.4,6437,1886,4551,3.4,11.5,1611,2.9,23,0,169,169,1155
2005,40580,2494,2917,57506,56955,274,9.4,258,8.9,11277,6763,4514,11.9,19.8,10175,3077,7098,5.4,17.9,1102,1.9,35.8,0,186,186,1885
2006,40580,2489,2930,58431,57900,296,10.1,266,9.1,8284,3326,4958,5.7,14.3,7222,2353,4869,4.1,12.5,1062,1.8,25,0,175,175,1335
2007,40580,2485,2952,55919,57164,295,10,267,9.1,8471,2535,5936,4.4,14.8,10961,5019,5942,8.8,19.2,-2490,-4.4,29.6,0,163,163,4195
2008,40580,2442,2907,56559,56069,224,7.7,233,8,8010,2805,5205,5,14.3,7030,1347,5683,2.4,12.5,980,1.8,25,0,167,167,1003
2009,40580,2331,2793,52188,54135,181,6.4,260,9.2,3990,1399,2591,2.6,7.4,7884,1769,6115,3.3,14.6,-3894,-7.2,14.8,0,177,177,1095
2010,40580,2293,2779,49178,50572,213,7.7,215,7.7,4817,1830,2987,3.6,9.5,7604,1303,6301,2.6,15,-2787,-5.5,19,0,141,141,758
2011,40580,2229,2715,48970,48826,174,6.4,215,7.9,5021,1282,3739,2.6,10.3,4732,1442,3290,3,9.7,289,0.6,19.4,0,155,155,813
2012,40580,2212,2703,47087,47110,214,7.9,232,8.6,5687,1999,3688,4.2,12.1,5732,1251,4481,2.7,12.2,-45,-0.1,24.2,0,139,139,643
2013,40580,2156,2627,44493,45381,180,6.8,246,9.3,5541,1960,3581,4.3,12.2,7316,3888,3428,8.6,16.1,-1775,-3.9,24.4,0,170,170,1605
2014,40580,2123,2586,44948,44414,183,7.1,191,7.4,5390,1403,3987,3.2,12.1,4322,1744,2578,3.9,9.7,1068,2.4,19.4,0,132,134,951
1977,40660,1332,1449,24700,24849,226,15.8,190,13.2,3238,1308,1930,5.3,13,3536,1338,2198,5.4,14.2,-298,-1.2,26,0,127,127,819
1978,40660,1352,1468,27627,26166,206,14.1,185,12.7,5085,1610,3475,6.2,19.4,2162,1068,1094,4.1,8.3,2923,11.1,16.6,0,138,138,620
1979,40660,1336,1451,27302,27441,176,12.1,181,12.4,3662,1461,2201,5.3,13.3,3940,1581,2359,5.8,14.4,-278,-1.1,26.6,0,132,132,1001
1980,40660,1336,1448,28290,27778,177,12.2,177,12.2,3888,1994,1894,7.2,14,2863,835,2028,3,10.3,1025,3.7,20.6,0,112,112,437
1981,40660,1302,1410,27708,27887,168,11.8,192,13.5,3208,1308,1900,4.7,11.5,3566,1498,2068,5.4,12.8,-358,-1.3,23,0,123,123,636
1982,40660,1281,1398,25794,26739,160,11.4,170,12.1,3000,1604,1396,6,11.2,4889,1295,3594,4.8,18.3,-1889,-7.1,22.4,0,102,102,599
1983,40660,1307,1424,24163,24968,173,12.3,152,10.8,2441,1030,1411,4.1,9.8,4051,2070,1981,8.3,16.2,-1610,-6.4,19.6,0,102,102,915
1984,40660,1392,1508,26553,25351,232,15.8,149,10.2,4653,1657,2996,6.5,18.4,2248,902,1346,3.6,8.9,2405,9.5,17.8,0,97,97,576
1985,40660,1402,1516,26501,26611,181,12,173,11.4,2780,877,1903,3.3,10.4,3000,1005,1995,3.8,11.3,-220,-0.9,20.8,0,113,113,543
1986,40660,1433,1562,26954,26722,204,13.3,150,9.7,3977,1778,2199,6.7,14.9,3513,1184,2329,4.4,13.1,464,1.8,26.2,0,96,96,511
1987,40660,1471,1601,29405,28532,223,14.1,183,11.6,5488,2028,3460,7.1,19.2,3741,1494,2247,5.2,13.1,1747,6.1,26.2,0,106,106,591
1988,40660,1489,1631,30512,30284,202,12.5,158,9.8,4160,1430,2730,4.7,13.7,3703,1377,2326,4.5,12.2,457,1.5,24.4,0,119,119,560
1989,40660,1479,1620,31903,31213,155,9.5,167,10.3,4934,1944,2990,6.2,15.8,3554,1441,2113,4.6,11.4,1380,4.4,22.8,0,110,114,810
1990,40660,1490,1627,31420,31565,181,11.1,163,10,4385,1434,2951,4.5,13.9,4674,2069,2605,6.6,14.8,-289,-0.9,27.8,0,105,105,1739
1991,40660,1507,1665,30930,31077,199,12.1,156,9.5,4854,2603,2251,8.4,15.6,5148,1777,3371,5.7,16.6,-294,-1,31.2,0,100,100,1141
1992,40660,1511,1661,33554,32141,201,12.1,196,11.8,6621,2594,4027,8.1,20.6,3794,1329,2465,4.1,11.8,2827,8.8,23.6,0,123,125,634
1993,40660,1591,1743,33135,33359,217,12.7,139,8.2,4325,1770,2555,5.3,13,4772,1262,3510,3.8,14.3,-447,-1.3,26,0,94,94,742
1994,40660,1566,1727,35209,34238,194,11.2,206,11.9,5915,1817,4098,5.3,17.3,3972,1930,2042,5.6,11.6,1943,5.7,23.2,0,132,132,787
1995,40660,1587,1740,36769,35981,194,11.2,175,10.1,5189,1728,3461,4.8,14.4,3613,1294,2319,3.6,10,1576,4.4,20,0,108,109,761
1996,40660,1617,1766,34922,36131,187,10.7,158,9,3599,1207,2392,3.3,10,6016,1715,4301,4.7,16.7,-2417,-6.7,20,0,105,105,755
1997,40660,1593,1759,36346,35604,188,10.7,187,10.6,6861,2651,4210,7.4,19.3,5376,2587,2789,7.3,15.1,1485,4.2,30.2,0,120,120,1210
1998,40660,1607,1777,38985,37852,203,11.5,184,10.4,6129,1501,4628,4,16.2,3862,1313,2549,3.5,10.2,2267,6,20.4,0,115,115,649
1999,40660,1635,1820,38473,38739,225,12.5,182,10.1,5419,1838,3581,4.7,14,5951,3419,2532,8.8,15.4,-532,-1.4,28,0,133,133,2507
2000,40660,1632,1820,37327,37884,201,11,197,10.8,5267,2125,3142,5.6,13.9,6380,2400,3980,6.3,16.8,-1113,-2.9,27.8,0,124,124,824
2001,40660,1643,1838,36721,37063,207,11.3,204,11.1,4930,1706,3224,4.6,13.3,5614,1630,3984,4.4,15.1,-684,-1.8,26.6,0,116,116,658
2002,40660,1636,1842,36115,36416,227,12.4,218,11.9,5445,2735,2710,7.5,15,6046,2382,3664,6.5,16.6,-601,-1.6,30,0,120,120,804
2003,40660,1621,1824,35329,35395,188,10.3,168,9.2,3850,1311,2539,3.7,10.9,3981,1012,2969,2.9,11.2,-131,-0.3,21.8,0,116,116,601
2004,40660,1654,1857,35482,35316,201,10.9,157,8.5,4743,2019,2724,5.7,13.4,4411,2269,2142,6.4,12.5,332,0.9,25,0,109,109,1194
2005,40660,1662,1880,36410,35633,185,9.9,152,8.2,4932,1492,3440,4.2,13.8,3377,871,2506,2.4,9.5,1555,4.3,19,0,106,106,425
2006,40660,1662,1888,36433,36319,187,9.9,158,8.4,4038,1313,2725,3.6,11.1,3810,1020,2790,2.8,10.5,228,0.6,21,0,113,113,608
2007,40660,1687,1923,39990,38195,190,10,155,8.1,8095,4993,3102,13.1,21.2,4504,1203,3301,3.1,11.8,3591,9.4,23.6,0,107,110,637
2008,40660,1660,1899,36201,37801,168,8.9,169,8.9,4175,1581,2594,4.2,11,7374,1778,5596,4.7,19.5,-3199,-8.5,22,0,128,128,1121
2009,40660,1595,1814,34428,35122,152,8.2,211,11.4,3460,1494,1966,4.3,9.9,4848,1484,3364,4.2,13.8,-1388,-3.9,19.8,0,138,138,982
2010,40660,1566,1785,34396,34501,149,8.3,157,8.8,3525,1335,2190,3.9,10.2,3734,1146,2588,3.3,10.8,-209,-0.6,20.4,0,107,107,680
2011,40660,1550,1769,33924,33895,155,8.8,158,8.9,3876,1855,2021,5.5,11.4,3818,1640,2178,4.8,11.3,58,0.1,22.6,0,108,108,993
2012,40660,1549,1776,33822,33783,173,9.8,167,9.4,3788,1272,2516,3.8,11.2,3709,1047,2662,3.1,11,79,0.2,22,0,103,103,411
2013,40660,1527,1751,34008,33561,139,7.9,156,8.9,3921,1230,2691,3.7,11.7,3026,1053,1973,3.1,9,895,2.7,18,0,94,94,448
2014,40660,1520,1756,33784,33743,163,9.3,139,8,4595,2682,1913,7.9,13.6,4512,1967,2545,5.8,13.4,83,0.2,26.8,0,93,93,461
1977,40900,16397,18890,240776,229576,4196,23.1,2726,15,59687,30532,29155,13.3,26,37286,17670,19616,7.7,16.2,22401,9.8,32.4,0,1715,1723,10462
1978,40900,17202,19777,275002,257800,3913,20.2,3006,15.5,73665,27302,46363,10.6,28.6,39261,21477,17784,8.3,15.2,34404,13.4,30.4,0,1863,1878,11033
1979,40900,18548,21299,296570,285443,4398,21.4,2727,13.3,67967,30482,37485,10.7,23.8,45712,17118,28594,6,16,22255,7.8,32,0,1874,1874,9748
1980,40900,19377,22259,296496,296035,4121,18.9,2998,13.8,59371,27145,32226,9.2,20.1,58449,19831,38618,6.7,19.7,922,0.4,39.4,0,2130,2134,12112
1981,40900,19144,21979,298894,295410,3657,16.6,3650,16.5,64868,28348,36520,9.6,22,57900,23626,34274,8,19.6,6968,2.4,39.2,0,2237,2243,12096
1982,40900,19532,22826,306543,303022,4204,18.8,3057,13.6,74970,30975,43995,10.2,24.7,67928,20700,47228,6.8,22.4,7042,2.3,44.8,0,1645,1647,9728
1983,40900,20235,23539,297556,299842,3536,15.3,2964,12.8,63083,29563,33520,9.9,21,67654,18200,49454,6.1,22.6,-4571,-1.6,42,0,1800,1841,10336
1984,40900,21479,24895,310142,296850,4145,17.1,2802,11.6,71375,28045,43330,9.4,24,44790,18019,26771,6.1,15.1,26585,8.9,30.2,0,1723,1732,8759
1985,40900,22576,26013,349988,338668,4342,17.1,3247,12.8,76647,30677,45970,9.1,22.6,54007,24332,29675,7.2,15.9,22640,6.7,31.8,0,1983,1999,11553
1986,40900,23864,27404,375594,362308,4611,17.3,3105,11.6,82916,34067,48849,9.4,22.9,56344,22726,33618,6.3,15.6,26572,7.3,31.2,0,1976,1976,13068
1987,40900,24849,28711,395624,388881,5003,17.8,3577,12.7,96305,40181,56124,10.3,24.8,82819,44613,38206,11.5,21.3,13486,3.5,42.6,0,2254,2276,29497
1988,40900,25211,29446,413432,400879,4636,16,3683,12.7,97809,40482,57327,10.1,24.4,72702,28394,44308,7.1,18.1,25107,6.3,36.2,0,2446,2446,13537
1989,40900,24070,28482,430675,421861,4244,14.7,5174,17.9,103531,34899,68632,8.3,24.5,85904,40847,45057,9.7,20.4,17627,4.1,40.8,0,2355,2367,15438
1990,40900,26990,31622,460905,445447,6315,21,3005,10,108105,52334,55771,11.7,24.3,77189,21272,55917,4.8,17.3,30916,7,34.6,0,1984,1984,10976
1991,40900,28264,33246,469975,466515,5278,16.3,3665,11.3,94262,40504,53758,8.7,20.2,87344,28554,58790,6.1,18.7,6918,1.5,37.4,0,2225,2248,16479
1992,40900,27935,33146,466377,467051,4664,14,4474,13.5,86016,31929,54087,6.8,18.4,87365,28516,58849,6.1,18.7,-1349,-0.3,36.8,0,2935,2981,16718
1993,40900,27441,32462,460094,462914,3797,11.6,4253,13,81025,29312,51713,6.3,17.5,86664,32359,54305,7,18.7,-5639,-1.2,35,0,2823,2843,15998
1994,40900,27363,32405,472579,466116,4104,12.7,3981,12.3,87724,33618,54106,7.2,18.8,74797,29177,45620,6.3,16,12927,2.8,32,0,2509,2524,14214
1995,40900,27453,32595,493229,482539,4104,12.6,3725,11.5,90317,29992,60325,6.2,18.7,68937,26866,42071,5.6,14.3,21380,4.4,28.6,0,2489,2493,14115
1996,40900,27749,32938,508133,500495,4035,12.3,3582,10.9,89241,30287,58954,6.1,17.8,73964,26548,47416,5.3,14.8,15277,3,29.6,0,2291,2291,12841
1997,40900,28013,33378,523793,516279,4419,13.3,3964,11.9,101385,38028,63357,7.4,19.6,86357,33370,52987,6.5,16.7,15028,2.9,33.4,0,2255,2255,14821
1998,40900,28330,33886,552474,537956,4362,13,3762,11.2,109362,43207,66155,8,20.3,80326,30752,49574,5.7,14.9,29036,5.4,29.8,0,2387,2387,14939
1999,40900,28902,34661,578015,565232,4542,13.3,3774,11,113817,43965,69852,7.8,20.1,88251,35590,52661,6.3,15.6,25566,4.5,31.2,0,2315,2315,13593
2000,40900,29307,35263,602221,590180,4489,12.8,3907,11.2,116536,40564,75972,6.9,19.7,92453,39427,53026,6.7,15.7,24083,4,31.4,0,2279,2279,13729
2001,40900,29856,36244,636732,620782,4790,13.4,4164,11.6,124823,53341,71482,8.6,20.1,92923,33929,58994,5.5,15,31900,5.1,30,0,2414,2416,14310
2002,40900,30642,37309,641357,637376,5681,15.5,4513,12.3,124845,58887,65958,9.2,19.6,116882,41483,75399,6.5,18.3,7963,1.3,36.6,0,2366,2375,15148
2003,40900,31295,38111,673247,651268,5425,14.5,3898,10.4,135238,46720,88518,7.2,20.8,91280,29970,61310,4.6,14,43958,6.8,28,0,2557,2632,17521
2004,40900,31600,38499,682109,673575,5007,13.1,4106,10.7,123655,49211,74444,7.3,18.4,106586,43322,63264,6.4,15.8,17069,2.6,31.6,0,2697,2704,27409
2005,40900,32633,40058,702669,690758,5858,14.9,3943,10.1,115562,48492,67070,7,16.7,91740,31555,60185,4.6,13.3,23822,3.4,26.6,0,2735,2739,20275
2006,40900,33457,41258,724840,711892,5963,14.7,4410,10.9,125079,53141,71938,7.5,17.6,99183,34432,64751,4.8,13.9,25896,3.7,27.8,0,3004,3008,21094
2007,40900,33928,41977,712203,717002,5821,14,4816,11.6,114801,47019,67782,6.6,16,124398,43897,80501,6.1,17.3,-9597,-1.3,32,0,3070,3091,18364
2008,40900,33494,41682,695691,700455,5041,12.1,4837,11.6,100895,41053,59842,5.9,14.4,110423,31477,78946,4.5,15.8,-9528,-1.4,28.8,0,3443,3461,19298
2009,40900,32549,40641,643233,666500,4466,10.9,5061,12.3,76658,34722,41936,5.2,11.5,123191,36017,87174,5.4,18.5,-46533,-7,23,0,3515,3519,18856
2010,40900,31619,39585,622068,629703,3980,10,4538,11.4,75093,28262,46831,4.5,11.9,90363,26652,63711,4.2,14.4,-15270,-2.5,23.8,0,2957,2968,15571
2011,40900,31464,39480,626519,623219,4207,10.7,4051,10.3,83911,30482,53429,4.9,13.5,77310,24830,52480,4,12.4,6601,1.1,24.8,0,2698,2702,15649
2012,40900,31895,39988,629059,626979,4638,11.7,4089,10.3,90380,30393,59987,4.8,14.4,86220,31978,54242,5.1,13.8,4160,0.6,27.6,0,2443,2458,16810
2013,40900,32218,40309,663759,645232,4262,10.7,3920,9.8,106530,31136,75394,4.8,16.5,69476,24802,44674,3.8,10.8,37054,5.7,21.6,0,2501,2517,14449
2014,40900,32663,40797,670560,664642,4474,11.1,3666,9.1,90898,28549,62349,4.3,13.7,79061,27128,51933,4.1,11.9,11837,1.8,23.8,0,2504,2506,13133
1977,40980,3216,3649,72777,71205,541,15.1,412,11.5,15462,8900,6562,12.5,21.7,12317,2453,9864,3.4,17.3,3145,4.4,34.6,0,257,258,1274
1978,40980,3317,3750,79406,76105,490,13.2,386,10.4,11390,3285,8105,4.3,15,4788,2192,2596,2.9,6.3,6602,8.7,12.6,0,238,238,938
1979,40980,3346,3803,83644,81467,451,11.9,381,10.1,11988,4207,7781,5.2,14.7,7633,2163,5470,2.7,9.4,4355,5.3,18.8,0,256,256,1321
1980,40980,3280,3740,77138,80249,399,10.6,436,11.6,11379,3196,8183,4,14.2,17601,8535,9066,10.6,21.9,-6222,-7.7,28.4,0,294,294,1481
1981,40980,3213,3639,73894,75474,393,10.7,469,12.7,7368,3340,4028,4.4,9.8,10528,3679,6849,4.9,13.9,-3160,-4.1,19.6,0,247,248,1371
1982,40980,3169,3613,66228,69948,404,11.1,403,11.1,7097,3499,3598,5,10.1,14537,3468,11069,5,20.8,-7440,-10.7,20.2,0,200,202,1275
1983,40980,3214,3653,65676,66023,324,8.9,305,8.4,8123,4082,4041,6.2,12.3,8817,1517,7300,2.3,13.4,-694,-1.1,24.6,0,165,165,562
1984,40980,3297,3750,73349,69638,415,11.2,338,9.1,18218,9103,9115,13.1,26.2,10796,7395,3401,10.6,15.5,7422,10.7,31,0,200,200,983
1985,40980,3355,3791,72081,72394,427,11.3,374,9.9,8146,2517,5629,3.5,11.3,8772,2866,5906,4,12.1,-626,-0.8,22.6,0,215,215,1522
1986,40980,3451,3902,73871,72974,479,12.5,359,9.3,9636,4002,5634,5.5,13.2,7841,2416,5425,3.3,10.7,1795,2.5,21.4,0,229,229,1020
1987,40980,3549,4065,76083,75167,537,13.5,372,9.3,10196,3508,6688,4.7,13.6,8364,2781,5583,3.7,11.1,1832,2.5,22.2,0,249,253,1747
1988,40980,3563,4070,76059,76045,388,9.5,383,9.4,9473,2958,6515,3.9,12.5,9445,3568,5877,4.7,12.4,28,0.1,24.8,0,227,227,1097
1989,40980,3659,4204,80280,78121,469,11.3,334,8.1,11623,3670,7953,4.7,14.9,7305,2153,5152,2.8,9.4,4318,5.5,18.8,0,214,214,1312
1990,40980,3676,4254,79865,80069,403,9.5,346,8.2,8599,3089,5510,3.9,10.7,9007,2096,6911,2.6,11.2,-408,-0.5,21.4,0,219,219,1182
1991,40980,3728,4314,79238,79537,394,9.2,332,7.8,8631,3007,5624,3.8,10.9,9228,2399,6829,3,11.6,-597,-0.7,21.8,0,198,198,1441
1992,40980,3810,4391,80088,79661,430,9.9,337,7.7,9372,2750,6622,3.5,11.8,8517,2544,5973,3.2,10.7,855,1.1,21.4,0,193,196,1170
1993,40980,3804,4365,78904,79454,354,8.1,366,8.4,7750,2053,5697,2.6,9.8,8850,2429,6421,3.1,11.1,-1100,-1.3,19.6,0,230,232,1382
1994,40980,3874,4443,79464,79170,413,9.4,332,7.5,8934,2999,5935,3.8,11.3,8345,2916,5429,3.7,10.5,589,0.8,21,0,213,219,1278
1995,40980,3968,4565,83228,81261,470,10.4,338,7.5,11836,4397,7439,5.4,14.6,7901,2439,5462,3,9.7,3935,4.9,19.4,0,230,230,1571
1996,40980,4026,4614,83324,83358,432,9.4,381,8.3,9272,3623,5649,4.3,11.1,9340,2933,6407,3.5,11.2,-68,-0.1,22.2,0,234,234,1519
1997,40980,4007,4594,85565,84427,432,9.4,452,9.8,12325,4338,7987,5.1,14.6,10049,3129,6920,3.7,11.9,2276,2.7,23.8,0,275,275,1421
1998,40980,3949,4547,85949,85740,374,8.2,413,9,9683,3350,6333,3.9,11.3,9264,2813,6451,3.3,10.8,419,0.5,21.6,0,243,243,1372
1999,40980,3957,4578,88897,87634,402,8.8,374,8.2,11124,4075,7049,4.7,12.7,8597,2743,5854,3.1,9.8,2527,2.9,19.6,0,225,225,1194
2000,40980,3957,4598,90735,89830,402,8.8,386,8.4,11337,4357,6980,4.9,12.6,9527,3051,6476,3.4,10.6,1810,2,21.2,0,210,210,1123
2001,40980,3886,4550,89259,90049,349,7.6,422,9.2,10229,3806,6423,4.2,11.4,11808,2916,8892,3.2,13.1,-1579,-1.7,22.8,0,231,231,1222
2002,40980,3856,4537,85548,87289,459,10.1,467,10.3,12018,6338,5680,7.3,13.8,15499,4992,10507,5.7,17.8,-3481,-4,27.6,0,209,209,1541
2003,40980,3809,4476,87003,85933,364,8.1,347,7.7,12254,4362,7892,5.1,14.3,10114,3634,6480,4.2,11.8,2140,2.5,23.6,0,210,211,1587
2004,40980,3802,4461,85520,86071,380,8.5,370,8.3,10746,3701,7045,4.3,12.5,11847,3423,8424,4,13.8,-1101,-1.3,25,0,218,218,2014
2005,40980,3726,4380,82174,83467,341,7.7,367,8.3,9963,2889,7074,3.5,11.9,12548,4157,8391,5,15,-2585,-3.1,23.8,0,235,241,2432
2006,40980,3667,4351,81962,81883,363,8.3,361,8.3,11086,4202,6884,5.1,13.5,10927,3018,7909,3.7,13.3,159,0.2,26.6,0,231,231,1490
2007,40980,3632,4316,80239,81077,377,8.7,403,9.3,11260,3112,8148,3.8,13.9,12935,3570,9365,4.4,16,-1675,-2.1,27.8,0,231,234,1307
2008,40980,3582,4287,78746,79231,355,8.3,330,7.7,9866,3722,6144,4.7,12.5,10835,3500,7335,4.4,13.7,-969,-1.2,25,0,222,222,1492
2009,40980,3479,4155,76498,77517,260,6.2,370,8.8,8451,2241,6210,2.9,10.9,10489,2712,7777,3.5,13.5,-2038,-2.6,21.8,0,218,218,1519
2010,40980,3398,4058,73811,75218,261,6.4,327,8,7370,1978,5392,2.6,9.8,10184,3020,7164,4,13.5,-2814,-3.7,19.6,0,174,174,1864
2011,40980,3349,4015,75631,74575,280,7,296,7.4,10182,3512,6670,4.7,13.7,8069,3562,4507,4.8,10.8,2113,2.9,21.6,0,174,174,2166
2012,40980,3381,4029,76819,76158,306,7.6,302,7.5,10121,3220,6901,4.2,13.3,8798,3812,4986,5,11.6,1323,1.7,23.2,0,160,164,1667
2013,40980,3385,4014,79389,77997,256,6.4,260,6.5,8880,2914,5966,3.7,11.4,6096,1515,4581,1.9,7.8,2784,3.6,15.6,0,165,165,938
2014,40980,3365,3991,78244,78330,289,7.3,279,7,7157,1510,5647,1.9,9.1,7328,2196,5132,2.8,9.4,-171,-0.3,18.2,0,198,201,1634
1977,41060,2209,2333,32588,31589,348,15.2,250,10.9,6422,2427,3995,7.7,20.3,4424,1841,2583,5.8,14,1998,6.3,28,0,177,178,1010
1978,41060,2311,2441,35595,34094,353,14.8,243,10.2,7084,2173,4911,6.4,20.8,4082,1455,2627,4.3,12,3002,8.8,24,0,178,178,936
1979,41060,2399,2542,39691,37600,349,14,230,9.2,8141,2828,5313,7.5,21.7,3959,1351,2608,3.6,10.5,4182,11.2,21,0,178,178,909
1980,41060,2443,2585,39996,39848,288,11.2,245,9.6,5586,1406,4180,3.5,14,5290,2058,3232,5.2,13.3,296,0.7,26.6,0,176,176,1209
1981,41060,2428,2570,40857,39957,285,11.1,276,10.7,6631,2309,4322,5.8,16.6,4830,1859,2971,4.7,12.1,1801,4.5,24.2,0,165,165,736
1982,41060,2426,2591,40439,40592,311,12.1,260,10.1,5881,2622,3259,6.5,14.5,6187,1525,4662,3.8,15.2,-306,-0.7,29,0,152,152,733
1983,41060,2541,2704,40020,40081,309,11.7,215,8.1,5957,2439,3518,6.1,14.9,6078,2167,3911,5.4,15.2,-121,-0.3,29.8,0,160,160,733
1984,41060,2656,2833,43542,41881,344,12.4,217,7.8,7463,2554,4909,6.1,17.8,4140,1527,2613,3.6,9.9,3323,7.9,19.8,0,144,144,755
1985,41060,2742,2918,45604,45013,327,11.3,247,8.6,6947,2115,4832,4.7,15.4,5765,1720,4045,3.8,12.8,1182,2.6,25.6,0,170,170,815
1986,41060,2782,2961,49184,47385,359,12.2,312,10.6,8597,3503,5094,7.4,18.1,4998,2066,2932,4.4,10.5,3599,7.6,21,0,198,200,1225
1987,41060,2857,3037,52695,51281,405,13.5,308,10.3,8349,2456,5893,4.8,16.3,5521,2581,2940,5,10.8,2828,5.5,21.6,0,206,207,1363
1988,41060,2905,3115,53602,52482,393,12.8,297,9.7,7756,2652,5104,5.1,14.8,5515,1730,3785,3.3,10.5,2241,4.3,21,0,220,220,1203
1989,41060,2951,3184,58283,56278,375,11.9,304,9.7,9162,2508,6654,4.5,16.3,5151,1987,3164,3.5,9.2,4011,7.1,18.4,0,224,224,1516
1990,41060,3022,3266,59623,58926,346,10.7,244,7.6,8093,2672,5421,4.5,13.7,6698,1964,4734,3.3,11.4,1395,2.3,22.8,0,179,179,1277
1991,41060,3144,3406,62542,61064,395,11.8,254,7.6,9051,3274,5777,5.4,14.8,6095,1494,4601,2.4,10,2956,4.8,20,0,158,159,898
1992,41060,3210,3501,65134,63833,388,11.2,282,8.2,10242,2352,7890,3.7,16,7640,2161,5479,3.4,12,2602,4,24,0,186,192,1345
1993,41060,3255,3552,65400,65219,338,9.6,287,8.1,7907,2011,5896,3.1,12.1,7544,2005,5539,3.1,11.6,363,0.5,23.2,0,204,204,1368
1994,41060,3313,3631,67429,66282,372,10.4,278,7.7,8789,3381,5408,5.1,13.3,6495,2114,4381,3.2,9.8,2294,3.5,19.6,0,197,197,1391
1995,41060,3411,3738,71419,69412,381,10.3,265,7.2,9960,2554,7406,3.7,14.3,5946,1834,4112,2.6,8.6,4014,5.7,17.2,0,200,200,1157
1996,41060,3523,3841,73559,72588,409,10.8,312,8.2,9243,3409,5834,4.7,12.7,7300,2130,5170,2.9,10.1,1943,2.6,20.2,0,206,206,1526
1997,41060,3580,3918,72750,73155,437,11.2,353,9.1,9904,3771,6133,5.2,13.5,10714,4056,6658,5.5,14.6,-810,-1.1,27,0,215,215,1818
1998,41060,3680,4032,76207,74471,434,10.9,318,8,12127,4660,7467,6.3,16.3,8654,3025,5629,4.1,11.6,3473,4.7,23.2,0,220,220,1606
1999,41060,3803,4187,79352,77889,458,11.1,298,7.3,11162,4550,6612,5.8,14.3,8236,2353,5883,3,10.6,2926,3.7,21.2,0,190,190,1113
2000,41060,3851,4241,83765,81631,391,9.3,344,8.2,11536,3313,8223,4.1,14.1,7269,2577,4692,3.2,8.9,4267,5.2,17.8,0,222,222,1632
2001,41060,3932,4362,83455,83696,448,10.4,349,8.1,9875,3709,6166,4.4,11.8,10357,3310,7047,4,12.4,-482,-0.6,23.6,0,224,224,1527
2002,41060,3971,4419,85316,83995,497,11.3,428,9.8,13115,4767,8348,5.7,15.6,10472,2848,7624,3.4,12.5,2643,3.1,25,0,230,231,1413
2003,41060,4105,4555,84024,84011,477,10.7,294,6.6,10057,3644,6413,4.3,12,10031,2459,7572,2.9,11.9,26,0.1,23.8,0,198,198,1303
2004,41060,4164,4620,85581,84637,444,9.7,350,7.6,9831,2878,6953,3.4,11.6,7943,2282,5661,2.7,9.4,1888,2.2,18.8,0,209,210,1264
2005,41060,4281,4757,88085,86772,505,10.8,338,7.2,10772,3538,7234,4.1,12.4,8145,2092,6053,2.4,9.4,2627,3,18.8,0,233,233,1550
2006,41060,4321,4825,90746,89321,488,10.2,386,8.1,11821,3494,8327,3.9,13.2,8970,3151,5819,3.5,10,2851,3.2,20,0,243,243,1738
2007,41060,4346,4857,94940,92850,453,9.4,419,8.7,13760,4476,9284,4.8,14.8,9579,3249,6330,3.5,10.3,4181,4.5,20.6,0,219,219,1354
2008,41060,4339,4858,94532,94540,412,8.5,379,7.8,10377,3388,6989,3.6,11,10393,3279,7114,3.5,11,-16,0,22,0,257,257,2390
2009,41060,4153,4680,90925,92634,302,6.3,461,9.7,10589,5616,4973,6.1,11.4,14006,2341,11665,2.5,15.1,-3417,-3.7,22.8,0,281,281,1557
2010,41060,4139,4671,87584,89083,352,7.5,327,7,7423,2625,4798,2.9,8.3,10421,2419,8002,2.7,11.7,-2998,-3.4,16.6,0,190,190,1624
2011,41060,4160,4701,88520,87965,398,8.5,341,7.3,9355,2606,6749,3,10.6,8247,1796,6451,2,9.4,1108,1.2,18.8,0,224,224,1243
2012,41060,4136,4688,90526,89424,362,7.7,351,7.5,11333,2772,8561,3.1,12.7,9130,2805,6325,3.1,10.2,2203,2.5,20.4,0,193,195,1192
2013,41060,4174,4735,92063,91630,322,6.9,286,6.1,10011,2420,7591,2.6,10.9,9144,2066,7078,2.3,10,867,0.9,20,0,173,173,1070
2014,41060,4184,4749,94409,93144,365,7.7,327,6.9,9300,2442,6858,2.6,10,6770,1823,4947,2,7.3,2530,2.7,14.6,0,208,211,1213
1977,41100,454,471,3738,3510,133,30,75,16.9,1167,703,464,20,33.2,710,472,238,13.4,20.2,457,13,40.4,0,50,50,378
1978,41100,423,440,4297,3997,80,17.6,101,22.2,1253,467,786,11.7,31.3,653,464,189,11.6,16.3,600,15,32.6,0,57,57,226
1979,41100,500,518,4918,4618,110,23,39,8.1,1317,551,766,11.9,28.5,716,202,514,4.4,15.5,601,13,31,1,1,1,
1980,41100,522,541,5298,5090,102,19.3,71,13.4,1223,597,626,11.7,24,806,290,516,5.7,15.8,417,8.2,31.6,0,52,52,220
1981,41100,520,536,5227,5157,88,16.4,86,16,1034,452,582,8.8,20.1,894,434,460,8.4,17.3,140,2.8,34.6,0,53,53,246
1982,41100,530,550,5114,5128,101,18.6,77,14.2,1015,535,480,10.4,19.8,1042,341,701,6.6,20.3,-27,-0.5,39.6,0,45,45,210
1983,41100,559,580,5355,5225,106,18.8,77,13.6,1276,571,705,10.9,24.4,1015,345,670,6.6,19.4,261,5,38.8,0,60,60,281
1984,41100,614,638,6352,5835,127,20.9,64,10.5,1785,984,801,16.9,30.6,750,358,392,6.1,12.9,1035,17.7,25.8,0,46,46,278
1985,41100,691,716,8361,7553,165,24.4,86,12.7,2765,1112,1653,14.7,36.6,1148,576,572,7.6,15.2,1617,21.4,30.4,0,57,57,367
1986,41100,749,777,9491,8979,164,22,101,13.5,3142,1825,1317,20.3,35,2117,947,1170,10.5,23.6,1025,11.4,47.2,0,73,73,576
1987,41100,798,837,9233,9348,183,22.6,112,13.9,2065,1080,985,11.6,22.1,2294,742,1552,7.9,24.5,-229,-2.4,44.2,0,83,83,536
1988,41100,810,852,9198,8962,164,19.4,146,17.3,2185,981,1204,10.9,24.4,1712,922,790,10.3,19.1,473,5.3,38.2,0,97,97,555
1989,41100,837,892,10166,9641,165,18.9,119,13.7,2653,1378,1275,14.3,27.5,1603,849,754,8.8,16.6,1050,10.9,33.2,0,97,97,698
1990,41100,902,959,11411,10773,161,17.4,89,9.6,2538,1056,1482,9.8,23.6,1262,390,872,3.6,11.7,1276,11.9,23.4,0,57,57,244
1991,41100,1025,1093,12716,12079,233,22.7,104,10.1,3268,1523,1745,12.6,27.1,1994,658,1336,5.4,16.5,1274,10.6,33,0,71,71,460
1992,41100,1108,1180,13873,13242,230,20.2,135,11.9,3565,1641,1924,12.4,26.9,2302,979,1323,7.4,17.4,1263,9.5,34.8,0,89,90,620
1993,41100,1189,1269,15384,14619,236,19.3,140,11.4,3688,1527,2161,10.4,25.2,2157,869,1288,5.9,14.8,1531,10.4,29.6,0,105,105,631
1994,41100,1359,1444,19084,17251,344,25.4,171,12.6,6300,3359,2941,19.5,36.5,2634,1484,1150,8.6,15.3,3666,21.2,30.6,0,130,130,897
1995,41100,1490,1578,20758,19847,343,22.7,192,12.7,5304,2060,3244,10.4,26.7,3481,1494,1987,7.5,17.5,1823,9.2,35,0,139,139,925
1996,41100,1582,1671,21468,21125,317,19.5,218,13.4,4595,2154,2441,10.2,21.8,3908,1633,2275,7.7,18.5,687,3.3,37,0,162,162,956
1997,41100,1719,1828,22559,22030,393,22.5,234,13.4,5292,2734,2558,12.4,24,4233,1746,2487,7.9,19.2,1059,4.8,38.4,0,158,158,1256
1998,41100,1786,1905,23509,22991,355,19,256,13.7,5053,2283,2770,9.9,22,4016,1688,2328,7.3,17.5,1037,4.5,35,0,169,169,1163
1999,41100,1876,2001,24784,24192,351,18,256,13.1,5096,2233,2863,9.2,21.1,3912,1611,2301,6.7,16.2,1184,4.9,32.4,0,167,167,866
2000,41100,1971,2114,25737,25255,365,17.7,247,12,5438,2463,2975,9.8,21.5,4474,2024,2450,8,17.7,964,3.8,35.4,0,174,174,1448
2001,41100,2108,2250,27774,26835,405,18.5,294,13.4,5867,2697,3170,10.1,21.9,3988,1831,2157,6.8,14.9,1879,7,29.8,0,182,184,1111
2002,41100,2231,2375,29814,28778,424,18.4,294,12.7,6987,3117,3870,10.8,24.3,4914,1521,3393,5.3,17.1,2073,7.2,34.2,0,166,166,834
2003,41100,2366,2531,31220,30374,454,18.6,258,10.6,7077,3534,3543,11.6,23.3,5385,1684,3701,5.5,17.7,1692,5.6,35.4,0,186,186,1129
2004,41100,2604,2782,33991,32478,539,20.3,268,10.1,7760,3311,4449,10.2,23.9,4733,1832,2901,5.6,14.6,3027,9.3,29.2,0,179,179,1312
2005,41100,2863,3065,37641,35775,616,21.1,311,10.7,8833,3666,5167,10.2,24.7,5100,2482,2618,6.9,14.3,3733,10.4,28.6,0,240,240,1950
2006,41100,3247,3483,43436,40491,763,23.3,331,10.1,12002,4668,7334,11.5,29.6,6111,1926,4185,4.8,15.1,5891,14.5,30.2,0,235,239,1377
2007,41100,3532,3757,44688,43967,700,19.4,408,11.3,10519,3704,6815,8.4,23.9,9076,3510,5566,8,20.6,1443,3.3,41.2,0,280,280,1472
2008,41100,3515,3746,44771,44649,543,14.5,517,13.8,8876,3095,5781,6.9,19.9,8632,2686,5946,6,19.3,244,0.6,38.6,0,384,384,1940
2009,41100,3145,3419,39259,41844,436,12.2,702,19.6,6547,3468,3079,8.3,15.6,11716,3936,7780,9.4,28,-5169,-12.4,31.2,0,498,498,2955
2010,41100,3056,3321,36119,37607,427,12.7,503,15,5151,2315,2836,6.2,13.7,8127,2827,5300,7.5,21.6,-2976,-7.9,27.4,0,347,347,2122
2011,41100,3038,3312,36775,36577,411,12.4,406,12.3,5933,2702,3231,7.4,16.2,5537,2581,2956,7.1,15.1,396,1.1,30.2,0,276,276,2081
2012,41100,3142,3425,37870,37267,484,14.4,366,10.9,6596,2449,4147,6.6,17.7,5389,2335,3054,6.3,14.5,1207,3.2,29,0,246,247,1623
2013,41100,3310,3598,40214,38996,486,13.9,326,9.3,7142,3279,3863,8.4,18.3,4705,1374,3331,3.5,12.1,2437,6.2,24.2,0,215,215,848
2014,41100,3461,3742,43070,41590,490,13.4,337,9.2,7105,2320,4785,5.6,17.1,4144,1682,2462,4,10,2961,7.1,20,0,221,221,845
1977,41140,2097,2286,32622,32583,340,15,289,12.8,5258,2326,2932,7.1,16.1,5179,2100,3079,6.4,15.9,79,0.2,31.8,0,191,191,1264
1978,41140,2154,2344,33645,33131,327,14.1,264,11.4,5416,2072,3344,6.3,16.3,4387,1936,2451,5.8,13.2,1029,3.1,26.4,0,187,187,829
1979,41140,2140,2329,34700,34162,260,11.1,265,11.3,5899,1979,3920,5.8,17.3,4822,2148,2674,6.3,14.1,1077,3.2,28.2,0,194,194,1335
1980,41140,2127,2308,34106,34417,261,11.3,276,11.9,4794,1713,3081,5,13.9,5416,1787,3629,5.2,15.7,-622,-1.8,27.8,0,209,209,891
1981,41140,2039,2192,32460,32890,243,10.9,329,14.7,4496,1952,2544,5.9,13.7,5356,2217,3139,6.7,16.3,-860,-2.6,27.4,0,198,198,972
1982,41140,2021,2205,32764,32573,302,13.7,237,10.8,4879,2147,2732,6.6,15,4497,1211,3286,3.7,13.8,382,1.2,27.6,0,143,143,671
1983,41140,2074,2263,32805,32696,242,10.8,221,9.9,4743,2113,2630,6.5,14.5,4524,1460,3064,4.5,13.8,219,0.7,27.6,0,149,149,731
1984,41140,2061,2252,33287,33001,257,11.4,258,11.4,4573,1357,3216,4.1,13.9,4001,1419,2582,4.3,12.1,572,1.8,24.2,0,162,162,868
1985,41140,2081,2266,33389,33629,243,10.7,240,10.6,4658,1620,3038,4.8,13.9,5138,2096,3042,6.2,15.3,-480,-1.4,27.8,0,161,161,588
1986,41140,2119,2308,33858,33284,269,11.8,222,9.7,7272,2340,4932,7,21.8,6123,3286,2837,9.9,18.4,1149,3.4,36.8,0,136,136,2267
1987,41140,2127,2316,34409,34498,278,12,265,11.5,5683,2643,3040,7.7,16.5,5861,2411,3450,7,17,-178,-0.5,33,0,171,175,1023
1988,41140,2066,2268,35842,34828,241,10.6,262,11.5,6481,3098,3383,8.9,18.6,4453,1938,2515,5.6,12.8,2028,5.8,25.6,0,179,179,897
1989,41140,2129,2342,37894,36875,283,12.3,210,9.1,6167,2671,3496,7.2,16.7,4129,1403,2726,3.8,11.2,2038,5.5,22.4,0,138,138,811
1990,41140,2163,2386,38933,38426,250,10.6,199,8.4,5695,1589,4106,4.1,14.8,4681,1398,3283,3.6,12.2,1014,2.6,24.4,0,141,141,735
1991,41140,2207,2440,38814,38875,262,10.9,205,8.5,4884,1954,2930,5,12.6,5005,1581,3424,4.1,12.9,-121,-0.3,25.2,0,122,122,641
1992,41140,2225,2475,38939,38874,266,10.8,222,9,5392,1630,3762,4.2,13.9,5262,2103,3159,5.4,13.5,130,0.4,27,0,148,148,854
1993,41140,2248,2504,39136,39034,227,9.1,193,7.8,4390,1270,3120,3.3,11.2,4186,1110,3076,2.8,10.7,204,0.5,21.4,0,138,138,725
1994,41140,2273,2522,38513,38798,277,11,245,9.8,5032,1384,3648,3.6,13,5601,1953,3648,5,14.4,-569,-1.4,26,0,168,168,648
1995,41140,2370,2607,39416,38913,314,12.2,211,8.2,6204,2214,3990,5.7,15.9,5198,2451,2747,6.3,13.4,1006,2.5,26.8,0,137,137,600
1996,41140,2389,2637,39542,39491,265,10.1,231,8.8,5597,2233,3364,5.7,14.2,5494,2203,3291,5.6,13.9,103,0.3,27.8,0,167,167,737
1997,41140,2379,2634,40687,40106,286,10.8,289,11,6452,2685,3767,6.7,16.1,5289,1889,3400,4.7,13.2,1163,2.9,26.4,0,200,200,1037
1998,41140,2392,2660,41217,40915,261,9.9,231,8.7,7292,4185,3107,10.2,17.8,6688,1486,5202,3.6,16.3,604,1.5,32.6,0,150,150,786
1999,41140,2410,2699,41685,41464,257,9.6,227,8.5,5571,2034,3537,4.9,13.4,5128,1006,4122,2.4,12.4,443,1,24.8,0,151,151,474
2000,41140,2381,2673,43659,42683,235,8.8,266,9.9,6856,2767,4089,6.5,16.1,4904,1691,3213,4,11.5,1952,4.6,23,0,166,166,1146
2001,41140,2345,2661,43527,43793,247,9.2,277,10.4,5674,2142,3532,4.9,13,6205,1597,4608,3.6,14.2,-531,-1.2,26,0,176,176,937
2002,41140,2394,2690,44487,43904,308,11.5,275,10.3,7436,3164,4272,7.2,16.9,6269,2344,3925,5.3,14.3,1167,2.6,28.6,0,135,135,868
2003,41140,2441,2745,44667,44510,338,12.5,251,9.3,6178,2182,3996,4.9,13.9,5864,1612,4252,3.6,13.2,314,0.7,26.4,0,168,168,1077
2004,41140,2490,2781,44153,44274,353,12.8,284,10.3,7182,2673,4509,6,16.2,7423,2763,4660,6.2,16.8,-241,-0.6,32.4,0,195,195,2106
2005,41140,2553,2838,44431,44018,324,11.6,246,8.8,6863,2088,4775,4.7,15.6,6037,1761,4276,4,13.7,826,1.9,27.4,0,171,171,586
2006,41140,2510,2828,46743,45430,331,11.7,305,10.8,8698,3492,5206,7.7,19.1,6072,1815,4257,4,13.4,2626,5.7,26.8,0,225,225,1033
2007,41140,2469,2795,48387,47630,250,8.9,278,9.9,7586,2441,5145,5.1,15.9,6072,2517,3555,5.3,12.7,1514,3.2,25.4,0,176,177,1358
2008,41140,2464,2803,51357,49604,267,9.6,237,8.5,8576,2314,6262,4.7,17.3,5069,1746,3323,3.5,10.2,3507,7.1,20.4,0,174,174,1208
2009,41140,2384,2733,48519,49869,225,8.1,272,9.8,5605,2442,3163,4.9,11.2,8304,2820,5484,5.7,16.7,-2699,-5.5,22.4,0,185,185,1746
2010,41140,2371,2711,48315,48376,218,8,232,8.6,5190,1768,3422,3.7,10.7,5311,1222,4089,2.5,11,-121,-0.3,21.4,0,160,161,818
2011,41140,2303,2646,47899,48058,217,8.1,260,9.7,4514,1527,2987,3.2,9.4,4832,1658,3174,3.4,10.1,-318,-0.7,18.8,0,182,182,1267
2012,41140,2251,2629,48359,48046,252,9.6,278,10.6,6139,1894,4245,3.9,12.8,5513,1374,4139,2.9,11.5,626,1.3,23,0,200,200,722
2013,41140,2246,2603,49173,48728,232,8.9,247,9.5,5004,1322,3682,2.7,10.3,4113,1553,2560,3.2,8.4,891,1.9,16.8,0,158,158,697
2014,41140,2281,2630,47175,48048,275,10.6,220,8.5,6168,2389,3779,5,12.8,7914,2222,5692,4.6,16.5,-1746,-3.7,25.6,0,151,151,1087
1977,41180,38533,45194,850244,823647,6821,15.3,5691,12.7,172533,58011,114522,7,20.9,119338,46538,72800,5.7,14.5,53195,6.4,29,0,3727,3756,23233
1978,41180,39205,46130,877930,864095,6178,13.5,5239,11.5,164628,52396,112232,6.1,19.1,136958,52538,84420,6.1,15.8,27670,3.3,31.6,0,3566,3587,19510
1979,41180,39814,46936,921044,898370,6015,12.9,4989,10.7,157981,49550,108431,5.5,17.6,112635,40788,71847,4.5,12.5,45346,5.1,25,0,3390,3419,19542
1980,41180,39997,47230,914048,917052,5578,11.8,5139,10.9,136307,51576,84731,5.6,14.9,142316,41532,100784,4.5,15.5,-6009,-0.6,29.8,0,3535,3545,19759
1981,41180,39282,46216,894705,898639,5527,11.9,6147,13.2,142027,54393,87634,6.1,15.8,149896,58373,91523,6.5,16.7,-7869,-0.9,31.6,0,3489,3503,19807
1982,41180,39314,47104,940993,916080,6374,13.7,4986,10.7,184171,99239,84932,10.8,20.1,134345,43568,90777,4.8,14.7,49826,5.4,29.4,0,2807,2813,16656
1983,41180,40307,47979,887947,909967,5513,11.6,4997,10.5,141707,54386,87321,6,15.6,185748,53155,132593,5.8,20.4,-44041,-4.8,31.2,0,3057,3080,17265
1984,41180,41263,49096,934546,912210,6189,12.7,5149,10.6,163579,60767,102812,6.7,17.9,118907,40700,78207,4.5,13,44672,4.9,26,0,3266,3272,21264
1985,41180,42352,50303,967028,956066,6326,12.7,5233,10.5,162190,59884,102306,6.3,17,140266,63640,76626,6.7,14.7,21924,2.3,29.4,0,3431,3460,22794
1986,41180,43952,52270,1011368,989599,6988,13.6,4921,9.6,186247,74570,111677,7.5,18.8,142708,50750,91958,5.1,14.4,43539,4.4,28.8,0,2962,2970,21829
1987,41180,44898,53930,1027355,1019367,7841,14.8,5998,11.3,184109,70568,113541,6.9,18.1,168132,67253,100879,6.6,16.5,15977,1.6,33,0,3717,3741,26076
1988,41180,44981,54435,1010668,1013779,7005,13,6131,11.3,175640,68560,107080,6.8,17.3,181861,85556,96305,8.4,17.9,-6221,-0.6,34.6,0,3965,3965,22731
1989,41180,45684,55645,1049060,1029753,6908,12.6,5715,10.4,179581,69993,109588,6.8,17.4,140966,50200,90766,4.9,13.7,38615,3.7,27.4,0,3772,3797,26121
1990,41180,46614,56677,1068693,1057597,6699,11.9,5420,9.7,164096,62596,101500,5.9,15.5,141904,44331,97573,4.2,13.4,22192,2.1,26.8,0,3437,3459,22095
1991,41180,46974,57346,1078192,1071487,6625,11.6,5946,10.4,179165,60422,118743,5.6,16.7,165755,54802,110953,5.1,15.5,13410,1.2,31,0,3619,3664,25898
1992,41180,47315,57899,1075951,1076267,6768,11.7,6042,10.5,158945,53660,105285,5,14.8,159578,47307,112271,4.4,14.8,-633,0,29.6,0,3677,3760,23042
1993,41180,47988,58382,1069950,1072435,6282,10.8,5693,9.8,149891,48865,101026,4.6,14,154861,55685,99176,5.2,14.4,-4970,-0.4,28,0,3679,3703,23361
1994,41180,48765,59279,1098286,1084501,6714,11.4,5652,9.6,161043,52251,108792,4.8,14.8,133473,44309,89164,4.1,12.3,27570,2.5,24.6,0,3722,3731,22970
1995,41180,49146,59872,1124417,1111033,6527,11,5733,9.6,166256,55566,110690,5,15,139488,48721,90767,4.4,12.6,26768,2.4,25.2,0,3809,3841,22860
1996,41180,49785,60734,1149264,1138128,6600,10.9,5700,9.5,168988,58425,110563,5.1,14.8,146716,47180,99536,4.1,12.9,22272,1.9,25.8,0,3796,3796,20722
1997,41180,49970,61100,1192119,1171255,6789,11.1,6483,10.6,198565,65972,132593,5.6,17,156836,58060,98776,5,13.4,41729,3.6,26.8,0,3920,3920,27114
1998,41180,50226,61588,1201027,1195521,6638,10.8,6024,9.8,173733,71288,102445,6,14.5,162721,51507,111214,4.3,13.6,11012,0.9,27.2,0,3868,3868,23349
1999,41180,50131,61765,1206818,1204088,6419,10.4,6181,10,175059,67207,107852,5.6,14.5,169599,64583,105016,5.4,14.1,5460,0.4,28.2,0,3927,3927,22544
2000,41180,50017,61896,1212325,1209027,6312,10.2,6162,10,184333,64005,120328,5.3,15.2,177736,57845,119891,4.8,14.7,6597,0.5,29.4,0,3732,3732,22958
2001,41180,49869,62203,1231613,1224767,6134,9.9,6268,10.1,189240,68327,120913,5.6,15.5,175549,60830,114719,5,14.3,13691,1.2,28.6,0,3669,3670,24743
2002,41180,50057,62678,1212982,1219833,7571,12.1,7014,11.2,205636,85316,120320,7,16.9,219338,71621,147717,5.9,18,-13702,-1.1,33.8,0,3523,3527,25918
2003,41180,50386,63172,1233846,1215991,6977,11.1,5514,8.8,186820,61091,125729,5,15.4,151109,44246,106863,3.6,12.4,35711,3,24.8,0,3694,3695,23198
2004,41180,51239,64103,1237133,1229586,7233,11.4,5692,9,176251,63326,112925,5.2,14.3,161157,53870,107287,4.4,13.1,15094,1.2,26.2,0,3695,3698,24697
2005,41180,51935,65309,1241948,1235954,7403,11.5,5608,8.7,166933,65015,101918,5.3,13.5,154945,47931,107014,3.9,12.5,11988,1,25,0,3814,3815,30672
2006,41180,51599,65514,1255439,1244673,7309,11.2,6543,10,189675,73257,116418,5.9,15.2,168143,59301,108842,4.8,13.5,21532,1.7,27,0,4258,4297,30561
2007,41180,51797,66298,1266173,1257439,7318,11.1,6310,9.6,191683,65344,126339,5.2,15.2,174215,52582,121633,4.2,13.9,17468,1.3,27.8,0,3950,4012,23611
2008,41180,51085,65945,1270114,1261776,6250,9.5,5938,9,183411,67139,116272,5.3,14.5,166735,44095,122640,3.5,13.2,16676,1.3,26.4,0,4056,4061,23524
2009,41180,49511,64257,1213476,1237989,5269,8.1,6369,9.8,141653,49721,91932,4,11.4,190679,54784,135895,4.4,15.4,-49026,-4,22.8,0,4211,4218,28098
2010,41180,49002,63488,1174195,1189496,5638,8.9,5701,9,133148,46903,86245,3.9,11.2,163749,40342,123407,3.4,13.8,-30601,-2.6,22.4,0,3576,3576,21289
2011,41180,48309,63154,1185000,1176888,5699,9,5619,8.9,139327,44151,95176,3.8,11.8,123102,33666,89436,2.9,10.5,16225,1.3,21,0,3713,3740,20468
2012,41180,48806,63493,1195039,1187237,6103,9.7,5681,9,156765,49792,106973,4.2,13.2,141161,43212,97949,3.6,11.9,15604,1.3,23.8,0,3295,3353,18807
2013,41180,49437,64160,1225290,1208380,6326,9.9,5575,8.8,154140,41089,113051,3.4,12.8,120319,36972,83347,3.1,10,33821,2.8,20,0,3534,3551,21374
2014,41180,50433,65316,1246124,1232683,7322,11.4,5667,8.8,149990,49565,100425,4,12.2,123107,35683,87424,2.9,10,26883,2.2,20,0,3954,3962,23027
1977,41420,4171,4503,52927,49715,950,21.8,637,14.6,14121,6318,7803,12.7,28.4,7697,3853,3844,7.8,15.5,6424,12.9,31,0,427,428,2427
1978,41420,4410,4771,59652,56295,935,20.2,659,14.2,15153,5162,9991,9.2,26.9,8439,3717,4722,6.6,15,6714,11.9,30,0,443,444,2064
1979,41420,4601,4998,63447,61427,959,19.6,687,14.1,14468,6590,7878,10.7,23.6,10428,3994,6434,6.5,17,4040,6.6,34,0,518,519,2928
1980,41420,4689,5108,64033,63735,831,16.4,712,14.1,12737,5350,7387,8.4,20,12141,4098,8043,6.4,19,596,1,38,0,496,502,2504
1981,41420,4600,5002,59756,60812,792,15.7,837,16.6,10591,4576,6015,7.5,17.4,12703,5226,7477,8.6,20.9,-2112,-3.5,34.8,0,538,539,2892
1982,41420,4457,4936,57099,58322,795,15.9,814,16.3,10836,5638,5198,9.7,18.6,13281,4872,8409,8.4,22.8,-2445,-4.2,37.2,0,443,445,2197
1983,41420,4558,5043,56524,56901,711,14.3,635,12.7,10486,4495,5991,7.9,18.4,11240,4708,6532,8.3,19.8,-754,-1.4,36.8,0,418,421,2781
1984,41420,4754,5294,59298,57780,848,16.4,599,11.6,11757,4194,7563,7.3,20.3,8720,3046,5674,5.3,15.1,3037,5.2,30.2,0,403,407,1955
1985,41420,4876,5368,64541,63095,788,14.7,744,13.9,13198,4994,8204,7.9,20.9,10306,4822,5484,7.6,16.3,2892,4.6,32.6,0,473,475,2692
1986,41420,4994,5504,66576,65552,799,14.7,650,12,12056,4974,7082,7.6,18.4,10007,3656,6351,5.6,15.3,2049,3.1,30.6,0,451,451,2178
1987,41420,5040,5576,69003,67782,871,15.7,775,14,14383,6600,7783,9.7,21.2,11940,5261,6679,7.8,17.6,2443,3.6,35.2,0,522,524,3293
1988,41420,5083,5659,69855,68124,821,14.7,673,12,14887,5914,8973,8.7,21.9,11424,4626,6798,6.8,16.8,3463,5.1,33.6,0,436,436,2563
1989,41420,4597,5165,68578,69340,653,12.1,1143,21.1,13099,4508,8591,6.5,18.9,14622,8456,6166,12.2,21.1,-1523,-2.2,37.8,0,390,394,2535
1990,41420,5328,5921,76709,72504,1319,23.8,517,9.3,20967,12570,8397,17.3,28.9,12556,6933,5623,9.6,17.3,8411,11.6,34.6,0,340,340,4508
1991,41420,5500,6141,80684,78691,860,14.3,640,10.6,15965,6669,9296,8.5,20.3,11979,4825,7154,6.1,15.2,3986,5.1,30.4,0,414,427,3029
1992,41420,5615,6266,81547,80771,896,14.4,727,11.7,15781,7042,8739,8.7,19.5,14228,6289,7939,7.8,17.6,1553,1.9,35.2,0,475,479,4167
1993,41420,5737,6370,85219,83617,766,12.1,655,10.4,14279,5206,9073,6.2,17.1,11075,4069,7006,4.9,13.2,3204,3.9,26.4,0,427,427,2293
1994,41420,6011,6665,89959,87579,973,14.9,658,10.1,15779,5387,10392,6.2,18,11018,3938,7080,4.5,12.6,4761,5.4,25.2,0,435,437,2090
1995,41420,6182,6851,91492,90588,932,13.8,717,10.6,14338,5376,8962,5.9,15.8,12529,4632,7897,5.1,13.8,1809,2,27.6,0,513,513,2813
1996,41420,6405,7111,96883,94183,937,13.4,664,9.5,16875,5807,11068,6.2,17.9,11475,3695,7780,3.9,12.2,5400,5.7,24.4,0,446,446,2319
1997,41420,6564,7320,100342,98619,1026,14.2,804,11.1,17779,6573,11206,6.7,18,14332,5207,9125,5.3,14.5,3447,3.5,29,0,524,524,2658
1998,41420,6616,7383,103166,101775,894,12.2,808,11,16799,6105,10694,6,16.5,14016,5104,8912,5,13.8,2783,2.7,27.6,0,551,551,2804
1999,41420,6639,7461,103800,103476,879,11.8,790,10.6,16123,5886,10237,5.7,15.6,15475,5590,9885,5.4,15,648,0.6,30,0,542,542,2713
2000,41420,6580,7419,105810,104873,808,10.9,858,11.5,16121,5128,10993,4.9,15.4,14246,5156,9090,4.9,13.6,1875,1.8,27.2,0,535,535,2319
2001,41420,6610,7492,104463,105311,885,11.8,886,11.8,16091,5279,10812,5,15.3,17786,5557,12229,5.3,16.9,-1695,-1.6,30.6,0,512,515,2996
2002,41420,6643,7548,102487,103295,970,12.9,883,11.8,15568,6351,9217,6.1,15.1,17184,4898,12286,4.7,16.6,-1616,-1.5,30.2,0,472,472,2311
2003,41420,6777,7700,105684,103821,989,13,719,9.5,17218,5063,12155,4.9,16.6,13491,5668,7823,5.5,13,3727,3.6,26,0,480,480,2990
2004,41420,6919,7868,107066,105865,956,12.3,722,9.3,15471,5221,10250,4.9,14.6,13068,4975,8093,4.7,12.3,2403,2.3,24.6,0,484,484,2659
2005,41420,7152,8140,110231,108254,1018,12.7,711,8.9,16243,5613,10630,5.2,15,12288,3793,8495,3.5,11.4,3955,3.6,22.8,0,487,487,2118
2006,41420,7189,8236,115492,112567,990,12.1,816,10,19766,8812,10954,7.8,17.6,13915,4311,9604,3.8,12.4,5851,5.2,24.8,0,533,533,2843
2007,41420,7378,8468,115798,115473,1057,12.7,809,9.7,18208,7478,10730,6.5,15.8,17557,7649,9908,6.6,15.2,651,0.6,30.4,0,520,528,3368
2008,41420,7433,8526,114760,115007,908,10.7,772,9.1,14614,4739,9875,4.1,12.7,15108,3988,11120,3.5,13.1,-494,-0.4,25.4,0,580,580,3226
2009,41420,7053,8152,107718,110984,635,7.6,935,11.2,11277,3629,7648,3.3,10.2,17809,3748,14061,3.4,16,-6532,-5.8,20.4,0,654,654,2482
2010,41420,6853,8033,107107,106750,723,9,781,9.7,18392,8277,10115,7.8,17.2,17678,7437,10241,7,16.6,714,0.6,33.2,0,526,526,6661
2011,41420,6751,7920,104196,105410,698,8.8,753,9.5,12223,3246,8977,3.1,11.6,14650,5226,9424,5,13.9,-2427,-2.3,23.2,0,480,482,3414
2012,41420,6828,8003,105671,104838,795,10,704,8.9,14084,4193,9891,4,13.4,12417,3894,8523,3.7,11.8,1667,1.6,23.6,0,418,422,2082
2013,41420,6922,8125,108087,106501,780,9.7,652,8.1,14667,4693,9974,4.4,13.8,11495,3607,7888,3.4,10.8,3172,3,21.6,0,407,407,2283
2014,41420,6923,8148,110723,109131,799,9.8,728,9,14070,4013,10057,3.7,12.9,10885,3582,7303,3.3,10,3185,2.9,20,0,488,488,2577
1977,41500,4816,5330,58840,55274,1038,20,702,13.6,17005,6789,10216,12.3,30.8,9872,4515,5357,8.2,17.9,7133,12.9,35.8,0,469,472,2635
1978,41500,4949,5484,60653,59787,940,17.4,786,14.5,13847,4855,8992,8.1,23.2,12115,4616,7499,7.7,20.3,1732,2.9,40.6,0,483,485,2573
1979,41500,5163,5713,64117,62387,1071,19.1,793,14.2,14740,6573,8167,10.5,23.6,11279,4424,6855,7.1,18.1,3461,5.5,36.2,0,555,555,2714
1980,41500,5282,5848,64660,64295,903,15.6,730,12.6,13256,5888,7368,9.2,20.6,12526,5136,7390,8,19.5,730,1.1,39,0,499,500,3320
1981,41500,5096,5628,63311,63771,750,13.1,898,15.7,13326,5185,8141,8.1,20.9,14245,7190,7055,11.3,22.3,-919,-1.4,41.8,0,526,528,2819
1982,41500,5229,5845,65164,64050,994,17.3,702,12.2,14027,6919,7108,10.8,21.9,11798,4659,7139,7.3,18.4,2229,3.5,36.8,0,388,388,2540
1983,41500,5384,6002,65211,64984,778,13.1,672,11.3,13141,5709,7432,8.8,20.2,12686,4692,7994,7.2,19.5,455,0.7,39,0,449,449,2452
1984,41500,5606,6243,69619,67477,878,14.4,637,10.4,14388,4898,9490,7.3,21.3,10104,4092,6012,6.1,15,4284,6.3,30,0,445,448,2496
1985,41500,5784,6435,74710,72178,846,13.3,667,10.5,17630,5586,12044,7.7,24.4,12565,5802,6763,8,17.4,5065,7,34.8,0,397,398,2386
1986,41500,6000,6638,75097,74730,1002,15.3,757,11.6,17190,7445,9745,10,23,16456,7435,9021,9.9,22,734,1,44,0,474,474,2892
1987,41500,6188,6854,80996,78987,1094,16.2,836,12.4,19463,8096,11367,10.2,24.6,15445,6293,9152,8,19.6,4018,5,39.2,0,529,532,3461
1988,41500,6233,6958,83529,82072,943,13.7,790,11.5,18025,7424,10601,9,22,15111,5005,10106,6.1,18.4,2914,3.6,36.8,0,509,509,2321
1989,41500,5957,6690,88965,86230,919,13.5,1177,17.3,23066,12084,10982,14,26.7,17596,8420,9176,9.8,20.4,5470,6.3,40.8,0,511,511,2967
1990,41500,6493,7275,90209,89370,1306,18.7,663,9.5,18910,10242,8668,11.5,21.2,17231,3487,13744,3.9,19.3,1679,1.9,38.6,0,429,429,2013
1991,41500,6572,7413,88189,89226,950,12.9,798,10.9,15813,7316,8497,8.2,17.7,17887,6571,11316,7.4,20,-2074,-2.3,35.4,0,500,500,3189
1992,41500,6506,7380,86939,87212,842,11.4,832,11.2,16916,7305,9611,8.4,19.4,17461,5247,12214,6,20,-545,-0.6,38.8,0,532,534,3121
1993,41500,6431,7268,90059,88433,744,10.2,829,11.3,18522,8264,10258,9.3,20.9,15270,4966,10304,5.6,17.3,3252,3.6,34.6,0,526,537,2207
1994,41500,6377,7186,91509,90690,778,10.8,800,11.1,16204,6845,9359,7.5,17.9,14566,5225,9341,5.8,16.1,1638,1.8,32.2,0,506,506,2797
1995,41500,6346,7173,90570,90304,775,10.8,745,10.4,13946,6253,7693,6.9,15.4,13414,4748,8666,5.3,14.9,532,0.5,29.8,0,495,496,2505
1996,41500,6438,7254,93199,91850,791,11,696,9.7,16097,5529,10568,6,17.5,13399,5797,7602,6.3,14.6,2698,2.9,29.2,0,471,471,2544
1997,41500,6538,7378,92912,92957,916,12.5,782,10.7,17310,6657,10653,7.2,18.6,17400,6949,10451,7.5,18.7,-90,-0.1,37.2,0,469,469,2619
1998,41500,6588,7417,94736,93872,865,11.7,805,10.9,18223,7171,11052,7.6,19.4,16494,6469,10025,6.9,17.6,1729,1.8,35.2,0,503,503,2460
1999,41500,6656,7504,105347,103260,863,11.6,763,10.2,17778,6371,11407,6.2,17.2,13604,4918,8686,4.8,13.2,4174,4,26.4,0,468,468,2294
2000,41500,6671,7539,102008,100318,793,10.6,737,9.8,17989,6320,11669,6.3,17.9,14608,5035,9573,5,14.6,3381,3.3,29.2,0,438,438,2304
2001,41500,6862,7780,110878,106657,873,11.4,738,9.6,23930,8529,15401,8,22.4,15487,5151,10336,4.8,14.5,8443,7.9,29,0,425,425,2883
2002,41500,6937,7866,107786,106806,1036,13.3,918,11.8,21238,9442,11796,8.8,19.9,19277,7039,12238,6.6,18,1961,1.9,36,0,467,467,2666
2003,41500,6896,7837,109114,108651,895,11.5,765,9.8,18065,6441,11624,5.9,16.6,17139,4136,13003,3.8,15.8,926,0.8,31.6,0,515,524,2549
2004,41500,6895,7847,106151,107170,857,11,752,9.6,15442,5580,9862,5.2,14.4,17479,7767,9712,7.2,16.3,-2037,-1.9,28.8,0,484,484,2464
2005,41500,6954,7936,106376,105940,925,11.7,759,9.6,15814,6729,9085,6.4,14.9,14941,4847,10094,4.6,14.1,873,0.8,28.2,0,518,518,2788
2006,41500,6967,7994,106680,106062,942,11.8,819,10.3,15844,6207,9637,5.9,14.9,14607,5291,9316,5,13.8,1237,1.1,27.6,0,576,576,3694
2007,41500,7017,8010,107996,106984,888,11.1,842,10.5,18153,7041,11112,6.6,17,16129,6051,10078,5.7,15.1,2024,1.9,30.2,0,534,537,2911
2008,41500,6873,7876,107264,107021,748,9.5,779,9.8,14561,5959,8602,5.6,13.6,14074,4835,9239,4.5,13.2,487,0.4,26.4,0,538,541,3250
2009,41500,6667,7650,99981,103084,626,8.1,775,10,11096,4087,7009,4,10.8,17302,3487,13815,3.4,16.8,-6206,-6,21.6,0,513,513,2304
2010,41500,6529,7499,95751,97568,625,8.3,714,9.5,9769,3685,6084,3.8,10,13403,4056,9347,4.2,13.7,-3634,-3.7,20,0,460,460,1892
2011,41500,6438,7427,96244,95765,651,8.7,666,8.9,11606,3772,7834,3.9,12.1,10648,3314,7334,3.5,11.1,958,1,22.2,0,451,452,2418
2012,41500,6478,7450,98735,97620,706,9.5,696,9.4,14036,4316,9720,4.4,14.4,11806,3839,7967,3.9,12.1,2230,2.3,24.2,0,397,399,1766
2013,41500,6500,7456,100198,100432,645,8.7,667,9,12252,4438,7814,4.4,12.2,12720,5220,7500,5.2,12.7,-468,-0.5,24.4,0,391,391,1741
2014,41500,6578,7529,102969,101272,756,10.1,622,8.3,14041,4881,9160,4.8,13.9,10646,4024,6622,4,10.5,3395,3.4,21,0,418,418,2128
1977,41540,1718,1861,24590,23882,313,17.2,230,12.6,4963,1952,3011,8.2,20.8,3546,1108,2438,4.6,14.8,1417,6,29.6,0,160,160,782
1978,41540,1741,1893,24938,24757,281,15,251,13.4,3995,1381,2614,5.6,16.1,3633,1627,2006,6.6,14.7,362,1.4,29.4,0,177,177,764
1979,41540,1753,1912,26028,25492,269,14.1,234,12.3,4271,1510,2761,5.9,16.8,3198,1449,1749,5.7,12.5,1073,4.3,25,0,172,173,990
1980,41540,1740,1908,26072,26049,233,12.2,237,12.4,4452,2113,2339,8.1,17.1,4406,1377,3029,5.3,16.9,46,0.2,33.8,0,168,168,708
1981,41540,1632,1786,25850,25763,196,10.6,293,15.9,5091,2167,2924,8.4,19.8,4916,2724,2192,10.6,19.1,175,0.7,38.2,0,171,171,760
1982,41540,1647,1814,26196,26066,251,13.9,196,10.9,4110,1722,2388,6.6,15.8,3850,1443,2407,5.5,14.8,260,1,29.6,0,127,127,856
1983,41540,1681,1832,27305,26641,199,10.9,194,10.6,4645,1417,3228,5.3,17.4,3317,1155,2162,4.3,12.5,1328,4.9,25,0,130,130,662
1984,41540,1706,1853,28950,28140,225,12.2,206,11.2,4821,1469,3352,5.2,17.1,3200,1473,1727,5.2,11.4,1621,5.7,22.8,0,122,122,575
1985,41540,1845,1992,30894,30035,274,14.2,152,7.9,5932,1780,4152,5.9,19.8,4214,1388,2826,4.6,14,1718,5.8,28,0,68,68,476
1986,41540,1918,2074,31852,31355,269,13.2,176,8.7,5748,2142,3606,6.8,18.3,4754,1354,3400,4.3,15.2,994,3.1,30.4,0,120,121,880
1987,41540,1933,2129,33088,32431,280,13.3,216,10.3,6486,2786,3700,8.6,20,5172,1711,3461,5.3,15.9,1314,4.1,31.8,0,145,145,1038
1988,41540,1957,2162,33140,33134,261,12.2,226,10.5,5354,2126,3228,6.4,16.2,5342,2205,3137,6.7,16.1,12,0.1,32.2,0,151,151,1157
1989,41540,1997,2215,35307,34226,277,12.7,227,10.4,6520,2303,4217,6.7,19,4357,1507,2850,4.4,12.7,2163,6.3,25.4,0,153,156,826
1990,41540,2062,2290,35724,35474,296,13.1,212,9.4,5393,1925,3468,5.4,15.2,4892,1354,3538,3.8,13.8,501,1.4,27.6,0,143,143,809
1991,41540,2125,2385,35722,35718,325,13.9,223,9.5,5875,3002,2873,8.4,16.4,5867,2233,3634,6.3,16.4,8,0,32.8,0,138,138,990
1992,41540,2120,2372,34163,34943,246,10.3,254,10.7,5072,1861,3211,5.3,14.5,6631,2121,4510,6.1,19,-1559,-4.5,29,0,149,151,786
1993,41540,2140,2386,35113,34621,267,11.2,248,10.4,5121,1655,3466,4.8,14.8,4137,1563,2574,4.5,11.9,984,2.9,23.8,0,175,175,1029
1994,41540,2175,2415,35065,35094,265,11,235,9.8,5851,2190,3661,6.2,16.7,5908,2501,3407,7.1,16.8,-57,-0.1,33.4,0,151,152,945
1995,41540,2216,2455,36136,35572,303,12.4,248,10.2,5259,1723,3536,4.8,14.8,4131,1451,2680,4.1,11.6,1128,3.2,23.2,0,180,180,1062
1996,41540,2234,2468,36089,36131,279,11.3,258,10.5,5139,2092,3047,5.8,14.2,5222,1708,3514,4.7,14.5,-83,-0.3,28.4,0,173,173,935
1997,41540,2228,2484,39067,37546,311,12.6,278,11.2,7471,2705,4766,7.2,19.9,4428,1613,2815,4.3,11.8,3043,8.1,23.6,0,183,183,873
1998,41540,2255,2532,38182,38631,277,11,231,9.2,5433,1887,3546,4.9,14.1,6330,2890,3440,7.5,16.4,-897,-2.3,28.2,0,150,150,857
1999,41540,2271,2552,39378,38767,272,10.7,241,9.5,6012,2491,3521,6.4,15.5,4790,1643,3147,4.2,12.4,1222,3.1,24.8,0,132,132,628
2000,41540,2295,2586,41052,40213,281,10.9,246,9.6,6570,2527,4043,6.3,16.3,4891,1600,3291,4,12.2,1679,4.1,24.4,0,140,140,562
2001,41540,2315,2603,40890,41032,251,9.7,263,10.1,5353,1570,3783,3.8,13,5637,2115,3522,5.2,13.7,-284,-0.7,26,0,151,151,877
2002,41540,2340,2617,41733,41312,319,12.2,299,11.5,7605,3248,4357,7.9,18.4,6763,2188,4575,5.3,16.4,842,2,32.8,0,155,155,952
2003,41540,2371,2665,42374,41756,282,10.7,201,7.6,6179,2635,3544,6.3,14.8,4943,1155,3788,2.8,11.8,1236,3,23.6,0,134,134,709
2004,41540,2414,2721,43732,42909,275,10.2,205,7.6,5736,2350,3386,5.5,13.4,4090,1136,2954,2.6,9.5,1646,3.9,19,0,144,145,709
2005,41540,2474,2799,44774,44246,310,11.3,218,7.9,7372,3045,4327,6.9,16.7,6316,2405,3911,5.4,14.3,1056,2.4,28.6,0,141,141,1630
2006,41540,2500,2863,45655,45035,330,11.7,245,8.7,6434,2117,4317,4.7,14.3,5193,1766,3427,3.9,11.5,1241,2.8,23,0,153,153,1329
2007,41540,2488,2845,44655,44983,266,9.3,278,9.8,5549,1564,3985,3.5,12.3,6205,1554,4651,3.5,13.8,-656,-1.5,24.6,0,151,152,815
2008,41540,2440,2796,44300,44386,238,8.5,260,9.2,5107,1896,3211,4.3,11.5,5279,1393,3886,3.1,11.9,-172,-0.4,23,0,176,176,816
2009,41540,2325,2679,41626,42882,170,6.2,263,9.6,3799,1095,2704,2.6,8.9,6310,1844,4466,4.3,14.7,-2511,-5.8,17.8,0,171,171,896
2010,41540,2290,2631,39654,40603,183,6.9,231,8.7,3579,1354,2225,3.3,8.8,5477,1824,3653,4.5,13.5,-1898,-4.7,17.6,0,140,140,697
2011,41540,2255,2603,40350,39957,203,7.8,206,7.9,3910,947,2963,2.4,9.8,3124,874,2250,2.2,7.8,786,2,15.6,0,144,144,642
2012,41540,2262,2634,40692,40563,240,9.2,217,8.3,5156,2144,3012,5.3,12.7,4897,1548,3349,3.8,12.1,259,0.6,24.2,0,126,126,791
2013,41540,2276,2647,40534,40563,222,8.5,194,7.4,4223,1201,3022,3,10.4,4280,1417,2863,3.5,10.6,-57,-0.2,20.8,0,112,112,743
2014,41540,2271,2641,40518,40474,215,8.2,206,7.8,3994,1288,2706,3.2,9.9,3906,1146,2760,2.8,9.7,88,0.2,19.4,0,128,128,743
1977,41620,11302,12866,212398,205416,2542,20.5,1640,13.2,50058,22060,27998,10.7,24.4,36094,15328,20766,7.5,17.6,13964,6.8,35.2,0,1072,1088,8786
1978,41620,11078,12714,223695,217652,2136,16.7,2144,16.8,49240,18922,30318,8.7,22.6,37153,17162,19991,7.9,17.1,12087,5.5,34.2,0,1160,1163,7933
1979,41620,12323,14064,243617,233809,2329,17.4,1049,7.8,52593,20750,31843,8.9,22.5,32976,10140,22836,4.3,14.1,19617,8.4,28.2,0,23,27,534
1980,41620,12319,14110,248081,245381,2152,15.3,1988,14.1,47597,18940,28657,7.7,19.4,42197,16970,25227,6.9,17.2,5400,2.2,34.4,0,1392,1398,8904
1981,41620,12024,13918,243222,245131,2195,15.7,2250,16.1,44425,19316,25109,7.9,18.1,48243,19667,28576,8,19.7,-3818,-1.6,36.2,0,1405,1413,10454
1982,41620,12408,14584,247124,245116,2550,17.9,1754,12.3,47209,21314,25895,8.7,19.3,43192,13548,29644,5.5,17.6,4017,1.7,35.2,0,965,965,6383
1983,41620,12689,14880,246785,245872,2013,13.7,1868,12.7,47862,22133,25729,9,19.5,46036,15182,30854,6.2,18.7,1826,0.8,37.4,0,1165,1167,7816
1984,41620,13284,15548,267124,257016,2440,16,1773,11.7,55931,20546,35385,8,21.8,35715,13146,22569,5.1,13.9,20216,7.9,27.8,0,1124,1124,6496
1985,41620,13575,15833,276795,271974,2348,15,2065,13.2,51440,19871,31569,7.3,18.9,41797,16056,25741,5.9,15.4,9643,3.5,30.8,0,1308,1315,9000
1986,41620,13743,16085,288132,285537,2432,15.2,2126,13.3,54963,24873,30090,8.7,19.2,49774,17630,32144,6.2,17.4,5189,1.8,34.8,0,1377,1383,9378
1987,41620,14032,16532,296589,294575,2784,17,2262,13.9,60860,24694,36166,8.4,20.7,56832,25016,31816,8.5,19.3,4028,1.4,38.6,0,1382,1398,10973
1988,41620,13967,16623,291809,289600,2504,15.1,2292,13.8,60013,26655,33358,9.2,20.7,55597,24452,31145,8.4,19.2,4416,1.5,38.4,0,1541,1541,11521
1989,41620,13953,16704,308939,301377,2256,13.5,2174,13,63330,21970,41360,7.3,21,48206,21420,26786,7.1,16,15124,5,32,0,1391,1421,11449.5
1990,41620,14206,17013,325542,316620,2252,13.4,1786,10.6,61086,21556,39530,6.8,19.3,43242,15277,27965,4.8,13.7,17844,5.6,27.4,0,1191,1193,9281
1991,41620,14794,17771,346639,336538,2528,14.5,1808,10.4,71554,25277,46277,7.5,21.3,51352,18359,32993,5.5,15.3,20202,6,30.6,0,1120,1127,11099
1992,41620,15274,18285,354236,350414,2630,14.6,2070,11.5,66087,20965,45122,6,18.9,58444,24545,33899,7,16.7,7643,2.2,33.4,0,1291,1303,15706
1993,41620,15914,18876,372566,363064,2557,13.8,1902,10.2,64621,20240,44381,5.6,17.8,45616,18352,27264,5.1,12.6,19005,5.2,25.2,0,1218,1222,9450
1994,41620,16581,19705,394662,383377,2884,15,2006,10.4,70759,24434,46325,6.4,18.5,48188,18650,29538,4.9,12.6,22571,5.9,25.2,0,1380,1386,10153
1995,41620,17189,20465,417417,405640,2952,14.7,2096,10.4,77598,29369,48229,7.2,19.1,54044,19842,34202,4.9,13.3,23554,5.8,26.6,0,1422,1427,11520
1996,41620,18006,21342,433454,424880,3163,15.1,2225,10.6,73627,29157,44470,6.9,17.3,56479,20106,36373,4.7,13.3,17148,4,26.6,0,1482,1482,10937
1997,41620,18735,22279,462784,449460,3477,15.9,2559,11.7,94163,38557,55606,8.6,21,67514,26853,40661,6,15,26649,6,30,0,1567,1567,11473
1998,41620,19064,22714,461906,462045,3179,14.1,2646,11.8,82099,29200,52899,6.3,17.8,82377,25003,57374,5.4,17.8,-278,0,35.6,0,1690,1690,11669
1999,41620,19385,23509,485952,480948,3485,15.1,2664,11.5,84754,35780,48974,7.4,17.6,74746,31279,43467,6.5,15.5,10008,2.1,31,0,1758,1758,16168
2000,41620,19546,24003,501823,493824,3307,13.9,2822,11.9,89820,33851,55969,6.9,18.2,73821,27516,46305,5.6,14.9,15999,3.3,29.8,0,1738,1738,13819
2001,41620,19847,24263,502725,503250,3409,14.1,3319,13.7,90200,36152,54048,7.2,17.9,91250,38787,52463,7.7,18.1,-1050,-0.2,35.8,0,1714,1715,10867
2002,41620,20273,24782,502929,504455,3832,15.6,3273,13.4,93408,41938,51470,8.3,18.5,96460,31079,65381,6.2,19.1,-3052,-0.6,37,0,1627,1627,12205
2003,41620,20710,25098,490510,492027,3746,15.1,2958,11.9,84822,37822,47000,7.7,17.2,87855,31398,56457,6.4,17.9,-3033,-0.7,34.4,0,1819,1820,17728
2004,41620,21181,25597,502746,492385,3578,14.2,2775,11,86402,32670,53732,6.6,17.5,65679,23859,41820,4.8,13.3,20723,4.2,26.6,0,1736,1737,10862
2005,41620,22050,26534,520162,509731,3959,15.2,2761,10.6,93910,36265,57645,7.1,18.4,73048,28923,44125,5.7,14.3,20862,4.1,28.6,0,1718,1725,13910
2006,41620,22849,27528,548634,532867,4102,15.2,2803,10.4,94920,33176,61744,6.2,17.8,63385,23732,39653,4.5,11.9,31535,5.9,23.8,0,1840,1844,14153
2007,41620,23904,28691,574780,560095,4191,14.9,2961,10.6,110989,35584,75405,6.4,19.8,81618,26160,55458,4.7,14.6,29371,5.2,29.2,0,1792,1799,11918
2008,41620,24047,28853,582557,576544,3538,12.3,3146,11,94088,26891,67197,4.7,16.3,82062,26494,55568,4.6,14.2,12026,2.1,28.4,0,2124,2124,14146
2009,41620,22874,27784,552036,565602,3032,10.7,3780,13.4,70237,24303,45934,4.3,12.4,97369,30279,67090,5.4,17.2,-27132,-4.8,24.8,0,2515,2518,15957
2010,41620,22586,27476,540321,545375,3103,11.3,3219,11.7,68250,25109,43141,4.6,12.5,78357,21402,56955,3.9,14.4,-10107,-1.9,25,0,2046,2053,11596
2011,41620,22637,27705,544869,541385,3221,11.7,2782,10.1,73179,24354,48825,4.5,13.5,66212,19338,46874,3.6,12.2,6967,1.3,24.4,0,1797,1803,12582
2012,41620,23067,28206,561004,552417,3336,12,2851,10.2,85850,29858,55992,5.4,15.5,68677,24087,44590,4.4,12.4,17173,3.1,24.8,0,1666,1674,14063
2013,41620,23648,28845,578742,569577,3225,11.3,2634,9.3,88773,31241,57532,5.5,15.6,70442,28477,41965,5,12.4,18331,3.2,24.8,0,1556,1566,17827
2014,41620,24040,29255,593444,584626,3234,11.2,2629,9.1,85990,28741,57249,4.9,14.7,68354,17928,50426,3.1,11.7,17636,3,23.4,0,1744,1746,10690
1977,41660,1731,1866,23212,22674,308,16.9,222,12.2,4592,2232,2360,9.8,20.3,3515,1495,2020,6.6,15.5,1077,4.8,31,0,151,152,1063
1978,41660,1652,1790,24312,23713,274,15,325,17.8,5220,1586,3634,6.7,22,4021,2469,1552,10.4,17,1199,5,34,0,179,179,1396
1979,41660,1812,1959,26365,25211,305,16.3,146,7.8,5720,2652,3068,10.5,22.7,3411,1003,2408,4,13.5,2309,9.2,27,0,4,4,41
1980,41660,1882,2047,26606,26441,331,16.5,229,11.4,5418,2392,3026,9,20.5,5088,1500,3588,5.7,19.2,330,1.3,38.4,0,161,162,1006
1981,41660,1901,2059,40289,33436,309,15.1,287,14,18146,2537,15609,7.6,54.3,4440,1938,2502,5.8,13.3,13706,41,26.6,0,176,179,990
1982,41660,1958,2154,43700,41978,376,17.8,253,12,8051,3047,5004,7.3,19.2,4607,2037,2570,4.9,11,3444,8.2,22,0,151,151,1249
1983,41660,2060,2253,32111,37908,313,14.2,243,11,4690,2211,2479,5.8,12.4,16284,2107,14177,5.6,43,-11594,-30.6,24.8,0,152,152,1073
1984,41660,2110,2320,32867,32486,360,15.8,291,12.7,5550,2275,3275,7,17.1,4788,2378,2410,7.3,14.7,762,2.4,29.4,0,203,205,1301
1985,41660,2123,2335,33625,33279,317,13.6,305,13.1,5970,3084,2886,9.3,17.9,5278,2135,3143,6.4,15.9,692,2,31.8,0,199,202,1411
1986,41660,2143,2347,33719,33624,324,13.8,291,12.4,5983,2383,3600,7.1,17.8,5792,1792,4000,5.3,17.2,191,0.6,34.4,0,208,208,1023
1987,41660,2077,2278,30925,32638,276,11.9,322,13.9,4875,2202,2673,6.7,14.9,8301,3607,4694,11.1,25.4,-3426,-10.5,29.8,0,204,205,2435
1988,41660,2061,2277,34502,32692,271,11.9,259,11.4,8311,2093,6218,6.4,25.4,4690,1856,2834,5.7,14.3,3621,11.1,28.6,0,178,178,762
1989,41660,1998,2208,30338,32416,225,10,294,13.1,4301,1762,2539,5.4,13.3,8457,5312,3145,16.4,26.1,-4156,-12.8,26.6,0,195,195,1262
1990,41660,1955,2165,29650,29981,219,10,255,11.7,3770,1228,2542,4.1,12.6,4432,1882,2550,6.3,14.8,-662,-2.2,25.2,0,177,179,946
1991,41660,2009,2254,29828,29730,282,12.8,191,8.6,5457,2707,2750,9.1,18.4,5261,1223,4038,4.1,17.7,196,0.7,35.4,0,112,114,601
1992,41660,2016,2274,30658,30245,265,11.7,248,10.9,5862,2823,3039,9.3,19.4,5036,2125,2911,7,16.7,826,2.7,33.4,0,153,153,818
1993,41660,2040,2276,30520,30581,236,10.4,227,10,4912,1935,2977,6.3,16.1,5033,2305,2728,7.5,16.5,-121,-0.4,32.2,0,137,137,582
1994,41660,2084,2319,31542,30912,259,11.3,214,9.3,4925,1361,3564,4.4,15.9,3664,1197,2467,3.9,11.9,1261,4,23.8,0,147,147,639
1995,41660,2106,2357,33170,32649,271,11.6,217,9.3,5639,2656,2983,8.1,17.3,4597,1347,3250,4.1,14.1,1042,3.2,28.2,0,166,166,901
1996,41660,2138,2392,32885,33004,277,11.7,237,10,5524,2650,2874,8,16.7,5762,3031,2731,9.2,17.5,-238,-0.8,33.4,0,154,154,1289
1997,41660,2098,2364,33945,33337,245,10.3,266,11.2,5814,1506,4308,4.5,17.4,4597,2072,2525,6.2,13.8,1217,3.6,27.6,0,169,169,883
1998,41660,2111,2382,33906,33926,271,11.4,244,10.3,5406,2393,3013,7.1,15.9,5445,1674,3771,4.9,16,-39,-0.1,31.8,0,147,147,758
1999,41660,2091,2378,34106,33955,248,10.4,257,10.8,5775,2128,3647,6.3,17,5473,2083,3390,6.1,16.1,302,0.9,32.2,0,168,168,953
2000,41660,2108,2407,34246,34259,297,12.4,279,11.7,4838,1986,2852,5.8,14.1,4865,1845,3020,5.4,14.2,-27,-0.1,28.2,0,156,156,706
2001,41660,2078,2392,36124,35282,208,8.6,247,10.3,5681,2400,3281,6.8,16.1,3996,1450,2546,4.1,11.3,1685,4.8,22.6,0,152,152,708
2002,41660,2097,2417,35756,35917,262,10.9,231,9.6,5386,1765,3621,4.9,15,5707,1912,3795,5.3,15.9,-321,-0.9,30,0,113,113,805
2003,41660,2091,2412,34969,35017,222,9.2,187,7.8,4664,1574,3090,4.5,13.3,4760,1202,3558,3.4,13.6,-96,-0.3,26.6,0,135,135,931
2004,41660,2117,2427,37222,36247,227,9.4,200,8.3,6155,2440,3715,6.7,17,4204,1106,3098,3.1,11.6,1951,5.4,23.2,0,133,133,631
2005,41660,2126,2443,36170,36601,219,9,179,7.4,4766,1677,3089,4.6,13,5628,1094,4534,3,15.4,-862,-2.4,26,0,130,131,806
2006,41660,2102,2425,37102,36498,232,9.6,225,9.3,5453,2202,3251,6,14.9,4245,1737,2508,4.8,11.6,1208,3.3,23.2,0,146,146,1106
2007,41660,2151,2499,37476,37204,270,11,198,8.1,5421,2176,3245,5.8,14.6,4877,1286,3591,3.5,13.1,544,1.5,26.2,0,125,125,531
2008,41660,2165,2494,38003,37615,242,9.7,223,9,6044,2579,3465,6.9,16.1,5268,1538,3730,4.1,14,776,2.1,28,0,141,141,897
2009,41660,2135,2479,36121,36929,217,8.7,207,8.3,4360,1558,2802,4.2,11.8,5975,1920,4055,5.2,16.2,-1615,-4.4,23.6,0,153,153,990
2010,41660,2121,2478,36109,35945,194,7.8,177,7.2,4586,1822,2764,5.1,12.8,4258,1187,3071,3.3,11.8,328,1,23.6,0,126,127,786
2011,41660,2125,2476,36695,36327,170,6.9,163,6.6,4271,1181,3090,3.3,11.8,3534,829,2705,2.3,9.7,737,2.1,19.4,0,117,117,694
2012,41660,2166,2503,37379,37057,201,8.1,183,7.4,5116,1467,3649,4,13.8,4472,1602,2870,4.3,12.1,644,1.7,24.2,0,109,109,856
2013,41660,2195,2560,39668,38482,219,8.7,159,6.3,5576,1788,3788,4.6,14.5,3204,904,2300,2.3,8.3,2372,6.2,16.6,0,105,105,668
2014,41660,2261,2629,40631,40132,280,10.8,201,7.8,5249,2295,2954,5.7,13.1,4251,1394,2857,3.5,10.6,998,2.5,21.2,0,139,139,1021
1977,41700,15881,18882,274333,265379,3445,18.8,2230,12.2,61915,30823,31092,11.6,23.3,44006,18269,25737,6.9,16.6,17909,6.7,33.2,0,1509,1525,10114
1978,41700,15224,18188,297717,284861,2698,14.6,3080,16.6,67115,22507,44608,7.9,23.6,41404,21213,20191,7.4,14.5,25711,9.1,29,0,1700,1711,9974
1979,41700,16819,20027,318766,309053,3151,16.5,1529,8,66763,24623,42140,8,21.6,47337,13478,33859,4.4,15.3,19426,6.3,30.6,0,14,15,1214
1980,41700,12805,16058,299539,302860,819,4.5,2946,16.3,48316,11405,36911,3.8,16,54958,22552,32406,7.4,18.1,-6642,-2.1,32,0,2234,2245,14042
1981,41700,17275,20537,343627,329969,3801,20.8,1919,10.5,71732,36118,35614,10.9,21.7,44416,17500,26916,5.3,13.5,27316,8.2,27,0,924,934,6468
1982,41700,18157,21997,365354,354576,3871,18.2,2216,10.4,80788,37084,43704,10.5,22.8,59231,19476,39755,5.5,16.7,21557,6.1,33.4,0,1271,1271,9377
1983,41700,19113,22955,364205,361649,3461,15.4,2663,11.8,71007,30748,40259,8.5,19.6,65894,22116,43778,6.1,18.2,5113,1.4,36.4,0,1726,1809,12263
1984,41700,19922,23852,378834,371778,3752,16,2846,12.2,78342,32108,46234,8.6,21.1,64230,22155,42075,6,17.3,14112,3.8,34.6,0,1794,1801,11557
1985,41700,20948,25034,408684,394920,4055,16.6,2842,11.6,85809,32383,53426,8.2,21.7,58280,24061,34219,6.1,14.8,27529,6.9,29.6,0,1793,1801,12423
1986,41700,21721,25982,410116,409056,4139,16.2,3082,12.1,81203,36501,44702,8.9,19.9,79082,25506,53576,6.2,19.3,2121,0.6,38.6,0,2057,2071,13499
1987,41700,21756,26495,413616,415805,4361,16.6,3705,14.1,81889,36766,45123,8.8,19.7,86266,34959,51307,8.4,20.7,-4377,-1,39.4,0,2428,2439,15699
1988,41700,21071,25941,411490,412683,3525,13.4,3895,14.9,78484,34706,43778,8.4,19,80869,34522,46347,8.4,19.6,-2385,-0.6,38,0,2701,2701,16355
1989,41700,20815,25728,426251,419184,3243,12.6,3455,13.4,82492,31773,50719,7.6,19.7,68358,27930,40428,6.7,16.3,14134,3.4,32.6,0,2264,2293,14890
1990,41700,20970,25972,436638,431234,3423,13.2,3006,11.6,82450,31233,51217,7.2,19.1,71642,28859,42783,6.7,16.6,10808,2.5,33.2,0,2001,2011,16882
1991,41700,21582,26717,445006,440889,3649,13.9,2912,11.1,86012,38225,47787,8.7,19.5,77777,27314,50463,6.2,17.6,8235,1.9,35.2,0,1797,1817,15972
1992,41700,22190,27490,464642,454956,3874,14.3,3014,11.1,91799,38782,53017,8.5,20.2,72427,26191,46236,5.8,15.9,19372,4.3,31.8,0,1883,1951,15051
1993,41700,22785,28096,490539,477979,3589,12.9,2926,10.5,95659,30737,64922,6.4,20,70539,27917,42622,5.8,14.8,25120,5.2,29.6,0,1868,1877,11939
1994,41700,23585,28957,501444,496390,3827,13.4,2855,10,81581,30247,51334,6.1,16.4,71472,22115,49357,4.5,14.4,10109,2,28.8,0,1910,1915,12254
1995,41700,24054,29561,526526,513386,3896,13.3,3167,10.8,99264,36405,62859,7.1,19.3,72984,26114,46870,5.1,14.2,26280,5.1,28.4,0,2139,2156,13477
1996,41700,24514,30105,546714,536341,3826,12.8,3175,10.6,99555,45195,54360,8.4,18.6,78808,26876,51932,5,14.7,20747,3.9,29.4,0,2124,2124,14129
1997,41700,24956,30795,575717,561941,4229,13.9,3551,11.6,118803,46145,72658,8.2,21.1,91250,34369,56881,6.1,16.2,27553,4.9,32.4,0,2200,2200,19681
1998,41700,25044,31164,584372,579638,3986,12.9,3534,11.4,106085,44046,62039,7.6,18.3,96617,37234,59383,6.4,16.7,9468,1.6,33.4,0,2288,2288,19173
1999,41700,25169,31688,605785,595999,4054,12.9,3514,11.2,107465,41327,66138,6.9,18,87893,32062,55831,5.4,14.7,19572,3.3,29.4,0,2266,2266,15861
2000,41700,25120,31830,625773,616834,3793,11.9,3674,11.6,108804,37592,71212,6.1,17.6,90928,36064,54864,5.8,14.7,17876,2.9,29.4,0,2152,2152,16223
2001,41700,25388,32396,640674,634221,3933,12.2,3648,11.3,105176,40435,64741,6.4,16.6,92271,33932,58339,5.4,14.5,12905,2.1,29,0,2034,2042,12681
2002,41700,25955,33009,639308,638863,4477,13.7,3846,11.8,110610,53046,57564,8.3,17.3,109720,37474,72246,5.9,17.2,890,0.1,34.4,0,1906,1912,11121
2003,41700,26297,33362,643566,633833,4263,12.9,3173,9.6,120361,50352,70009,7.9,19,100895,31652,69243,5,15.9,19466,3.1,31.8,0,2129,2145,16942
2004,41700,26617,33687,657189,647532,4067,12.2,3313,9.9,115425,48318,67107,7.5,17.8,96110,36349,59761,5.6,14.8,19315,3,29.6,0,2165,2180,17120
2005,41700,27224,34794,670553,662690,4469,13.1,3024,8.9,111051,43718,67333,6.6,16.8,95325,28857,66468,4.4,14.4,15726,2.4,28.8,0,2112,2131,18479
2006,41700,27685,35831,706150,686800,4709,13.4,3354,9.5,127121,51942,75179,7.6,18.5,88422,25501,62921,3.7,12.9,38699,5.6,25.8,0,2270,2270,15134
2007,41700,28238,36531,740067,721722,4574,12.7,3718,10.3,148982,56823,92159,7.9,20.6,112293,34037,78256,4.7,15.6,36689,5,31.2,0,2263,2278,14222
2008,41700,28495,36987,773514,754992,4161,11.4,3328,9.1,140346,61150,79196,8.1,18.6,103301,28469,74832,3.8,13.7,37045,4.9,27.4,0,2381,2384,15991
2009,41700,27994,36704,738657,753417,3658,10,3611,9.8,99674,39437,60237,5.2,13.2,129193,29909,99284,4,17.1,-29519,-3.9,26.4,0,2514,2530,14889
2010,41700,27951,36706,739530,737810,3572,9.8,3334,9.1,105313,40484,64829,5.5,14.3,101873,30334,71539,4.1,13.8,3440,0.5,27.6,0,2157,2163,14652
2011,41700,27900,36842,754274,744858,3796,10.3,3391,9.2,114694,43255,71439,5.8,15.4,95862,26637,69225,3.6,12.9,18832,2.5,25.8,0,2296,2311,17768
2012,41700,28471,37717,779225,766168,4290,11.5,3418,9.2,122319,43404,78915,5.7,16,96205,31074,65131,4.1,12.6,26114,3.4,25.2,0,2047,2075,14543
2013,41700,28884,38352,803153,789796,3976,10.5,3330,8.8,116256,35692,80564,4.5,14.7,89543,33470,56073,4.2,11.3,26713,3.4,22.6,0,2119,2121,16133
2014,41700,29426,39051,816773,807835,4246,11,3234,8.4,113466,35877,77589,4.4,14,95591,32074,63517,4,11.8,17875,2.2,23.6,0,2196,2214,15774
1977,41740,25653,29952,403250,384392,7031,24.6,4267,14.9,106142,51619,54523,13.4,27.6,68425,31332,37093,8.2,17.8,37717,9.8,35.6,0,2814,2833,18865
1978,41740,27328,31917,457211,430107,6767,21.9,4779,15.4,120791,48347,72444,11.2,28.1,66582,32284,34298,7.5,15.5,54209,12.6,31,0,3105,3128,17644
1979,41740,29283,34280,513793,484816,7194,21.7,4584,13.9,128979,50419,78560,10.4,26.6,71025,29746,41279,6.1,14.6,57954,12,29.2,0,3289,3297,17701
1980,41740,30473,35683,535603,524228,6429,18.4,4797,13.7,114146,46239,67907,8.8,21.8,91395,33172,58223,6.3,17.4,22751,4.4,34.8,0,3389,3399,19209
1981,41740,30270,35434,545031,537833,6191,17.4,6036,17,119161,51837,67324,9.6,22.2,104764,42717,62047,7.9,19.5,14397,2.7,39,0,3634,3650,21695
1982,41740,31276,37453,545689,544712,7237,19.8,4769,13.1,108880,51720,57160,9.5,20,106925,32295,74630,5.9,19.6,1955,0.4,39.2,0,2725,2728,16104
1983,41740,32454,38631,548849,545487,5852,15.4,4886,12.8,113429,47626,65803,8.7,20.8,106705,40307,66398,7.4,19.6,6724,1.2,39.2,0,3063,3070,20853
1984,41740,34384,40700,606514,578327,6990,17.6,4905,12.4,140871,50457,90414,8.7,24.4,84497,33232,51265,5.7,14.6,56374,9.8,29.2,0,3088,3102,17319
1985,41740,36233,42654,649910,629309,7189,17.2,5235,12.6,144493,54415,90078,8.6,23,103291,42929,60362,6.8,16.4,41202,6.6,32.8,0,3240,3262,20711
1986,41740,38076,44859,695704,671131,7836,17.9,5446,12.4,160497,71566,88931,10.7,23.9,111351,45157,66194,6.7,16.6,49146,7.3,33.2,0,3469,3472,23177
1987,41740,40045,47479,739490,724932,9003,19.5,6018,13,175535,77466,98069,10.7,24.2,146418,60373,86045,8.3,20.2,29117,4,40.4,0,3834,3868,31448
1988,41740,41035,48952,771249,751799,7931,16.5,6213,12.9,179688,73392,106296,9.8,23.9,140790,54397,86393,7.2,18.7,38898,5.2,37.4,0,4142,4142,26761
1989,41740,42127,50454,828993,803420,7891,15.9,6421,12.9,183064,67676,115388,8.4,22.8,131919,52314,79605,6.5,16.4,51145,6.4,32.8,0,4216,4245,31100
1990,41740,43830,52442,867860,847333,8215,16,5846,11.4,175782,66105,109677,7.8,20.7,134727,49724,85003,5.9,15.9,41055,4.8,31.8,0,3980,3984,26949
1991,41740,44711,53666,836528,852976,8125,15.3,6888,13,160199,70726,89473,8.3,18.8,193095,69402,123693,8.1,22.6,-32896,-3.8,37.6,0,4239,4282,40926
1992,41740,44227,53550,811757,822714,7698,14.3,7409,13.8,148195,57268,90927,7,18,170109,57682,112427,7,20.7,-21914,-2.7,36,0,4794,4871,34111
1993,41740,43711,52610,806266,806774,6530,12.3,7093,13.4,145780,49823,95957,6.2,18.1,146795,55757,91038,6.9,18.2,-1015,-0.1,36.2,0,4657,4721,28925
1994,41740,43851,52628,802619,803482,6968,13.2,6699,12.7,145054,53730,91324,6.7,18.1,146779,58818,87961,7.3,18.3,-1725,-0.2,36.2,0,4291,4341,28426
1995,41740,44174,52907,831408,819305,7031,13.3,6460,12.2,149731,54455,95276,6.6,18.3,125525,48848,76677,6,15.3,24206,3,30.6,0,4259,4334,24803
1996,41740,44914,53743,852553,842080,7304,13.7,6245,11.7,155919,60778,95141,7.2,18.5,134973,50631,84342,6,16,20946,2.5,32,0,4140,4141,24416
1997,41740,45825,54736,885944,870151,7839,14.4,6878,12.7,178089,60382,117707,6.9,20.5,146503,62435,84068,7.2,16.8,31586,3.7,33.6,0,4065,4065,27506
1998,41740,46932,56070,940115,912396,7784,14.1,6266,11.3,194062,72522,121540,7.9,21.3,138623,52413,86210,5.7,15.2,55439,6.1,30.4,0,4081,4081,25965
1999,41740,48090,57671,990685,966437,7958,14,6297,11.1,195309,83410,111899,8.6,20.2,146813,55391,91422,5.7,15.2,48496,5,30.4,0,4050,4050,26155
2000,41740,48741,58595,1031585,1010762,7718,13.3,6790,11.7,192342,71971,120371,7.1,19,150697,63150,87547,6.2,14.9,41645,4.1,29.8,0,4149,4149,29685
2001,41740,50075,60499,1067501,1051449,8554,14.3,7218,12.1,200821,80918,119903,7.7,19.1,168718,63604,105114,6,16,32103,3.1,32,0,4410,4414,28719
2002,41740,51262,62150,1089227,1082487,9520,15.5,7805,12.7,213955,89717,124238,8.3,19.8,200475,71385,129090,6.6,18.5,13480,1.3,37,0,4365,4372,30033
2003,41740,52256,63372,1130058,1104304,8972,14.4,6608,10.6,208184,74058,134126,6.7,18.9,156675,55794,100881,5.1,14.2,51509,4.7,28.4,0,4630,4656,32696
2004,41740,53209,64394,1144039,1132045,8623,13.5,6766,10.6,197766,65827,131939,5.8,17.5,173778,70732,103046,6.2,15.4,23988,2.1,30.8,0,4649,4679,34862
2005,41740,54737,66421,1156432,1146766,9506,14.6,6835,10.5,189472,74024,115448,6.5,16.5,170140,60653,109487,5.3,14.8,19332,1.7,29.6,0,4839,4855,34667
2006,41740,56188,68539,1200915,1173862,9880,14.7,7124,10.6,209067,79261,129806,6.8,17.8,154960,50200,104760,4.3,13.2,54107,4.6,26.4,0,5082,5091,33338
2007,41740,56857,69097,1197654,1196283,9136,13.3,8152,11.9,199363,75412,123951,6.3,16.7,196621,64172,132449,5.4,16.4,2742,0.3,32.8,0,5136,5190,29876
2008,41740,56683,69001,1186466,1188008,8407,12.2,7757,11.3,178500,62594,115906,5.3,15,181583,57894,123689,4.9,15.3,-3083,-0.3,30,0,5471,5473,35236
2009,41740,55145,67212,1112046,1144857,7372,10.9,8353,12.3,133155,48785,84370,4.3,11.6,198778,56733,142045,5,17.4,-65623,-5.8,23.2,0,5707,5737,34298
2010,41740,54130,66147,1093749,1099867,7062,10.6,7470,11.2,143760,55620,88140,5.1,13.1,155996,48116,107880,4.4,14.2,-12236,-1.1,26.2,0,4929,4943,28918
2011,41740,54484,66655,1117980,1103025,7745,11.7,6781,10.2,157844,52782,105062,4.8,14.3,127933,41415,86518,3.8,11.6,29911,2.7,23.2,0,4497,4508,26345
2012,41740,55331,67520,1138176,1126002,7852,11.7,6993,10.4,170179,55557,114622,4.9,15.1,145832,54470,91362,4.8,13,24347,2.1,26,0,4267,4307,23850
2013,41740,56153,68406,1172341,1154103,7535,11.1,6714,9.9,177978,64479,113499,5.6,15.4,141502,46216,95286,4,12.3,36476,3.1,24.6,0,4308,4322,28120
2014,41740,57299,69627,1189708,1177259,8546,12.4,6851,10,174222,54940,119282,4.7,14.8,149324,57248,92076,4.9,12.7,24898,2.1,25.4,0,4718,4731,27901
1977,41780,1382,1496,26887,26427,236,16.3,144,9.9,4207,1838,2369,7,15.9,3286,1215,2071,4.6,12.4,921,3.5,24.8,0,95,95,612
1978,41780,1396,1519,28290,27588,181,12,158,10.5,4269,1100,3169,4,15.5,2864,1090,1774,4,10.4,1405,5.1,20.8,0,97,97,352
1979,41780,1427,1562,30558,29387,176,11.4,123,8,4467,1176,3291,4,15.2,2124,663,1461,2.3,7.2,2343,8,14.4,0,80,80,351
1980,41780,1447,1575,28810,29675,166,10.6,149,9.5,2913,939,1974,3.2,9.8,4643,1032,3611,3.5,15.6,-1730,-5.8,19.6,0,91,91,443
1981,41780,1387,1511,26113,27031,123,8,165,10.7,2366,718,1648,2.7,8.8,4202,1202,3000,4.4,15.5,-1836,-6.7,17.6,0,95,96,346
1982,41780,1399,1526,25680,25880,170,11.2,131,8.6,3843,1298,2545,5,14.8,4243,827,3416,3.2,16.4,-400,-1.6,29.6,0,64,64,281
1983,41780,1407,1531,24157,24935,123,8,149,9.8,2774,686,2088,2.8,11.1,4330,924,3406,3.7,17.4,-1556,-6.3,22.2,0,83,83,470
1984,41780,1438,1562,25332,24741,190,12.3,158,10.2,3930,1273,2657,5.1,15.9,2748,1488,1260,6,11.1,1182,4.8,22.2,0,99,99,577
1985,41780,1445,1571,25369,25331,171,10.9,159,10.2,3181,1011,2170,4,12.6,3105,1191,1914,4.7,12.3,76,0.3,24.6,0,97,98,502
1986,41780,1496,1619,25682,25524,183,11.5,129,8.1,3894,1511,2383,5.9,15.3,3577,1303,2274,5.1,14,317,1.3,28,0,81,81,541
1987,41780,1513,1644,27506,26591,206,12.6,175,10.7,5240,1923,3317,7.2,19.7,3409,1294,2115,4.9,12.8,1831,6.9,25.6,0,98,98,415
1988,41780,1539,1670,27179,27332,193,11.6,161,9.7,3915,1739,2176,6.4,14.3,4220,1673,2547,6.1,15.4,-305,-1.1,28.6,0,94,94,412
1989,41780,1568,1700,27950,27565,181,10.7,149,8.8,3794,1275,2519,4.6,13.8,3024,1411,1613,5.1,11,770,2.8,22,0,92,92,536
1990,41780,1601,1752,28273,28078,204,11.8,142,8.2,3685,1472,2213,5.2,13.1,3295,998,2297,3.6,11.7,390,1.4,23.4,0,101,101,567
1991,41780,1652,1814,29090,28748,200,11.2,139,7.8,4116,1401,2715,4.9,14.3,3432,919,2513,3.2,11.9,684,2.4,23.8,0,82,82,410
1992,41780,1664,1834,28851,28962,190,10.4,162,8.9,4093,1543,2550,5.3,14.1,4314,1385,2929,4.8,14.9,-221,-0.8,28.2,0,109,109,471
1993,41780,1695,1863,28909,28894,171,9.3,144,7.8,3724,1225,2499,4.2,12.9,3693,877,2816,3,12.8,31,0.1,25.6,0,83,83,467
1994,41780,1722,1886,29587,29246,206,11,180,9.6,4289,1405,2884,4.8,14.7,3607,1443,2164,4.9,12.3,682,2.4,24.6,0,105,105,526
1995,41780,1736,1900,30993,30284,177,9.4,161,8.5,4553,1391,3162,4.6,15,3134,1143,1991,3.8,10.3,1419,4.7,20.6,0,99,99,707
1996,41780,1737,1895,31285,31118,155,8.2,159,8.4,4092,1568,2524,5,13.1,3758,946,2812,3,12.1,334,1,24.2,0,100,100,669
1997,41780,1725,1874,31338,31311,177,9.4,194,10.3,4236,1837,2399,5.9,13.5,4181,1601,2580,5.1,13.4,55,0.1,26.8,0,97,97,443
1998,41780,1702,1846,31596,31447,157,8.4,183,9.8,4233,1664,2569,5.3,13.5,3934,1744,2190,5.5,12.5,299,1,25,0,102,102,831
1999,41780,1736,1886,31184,31402,166,8.9,133,7.1,3488,1197,2291,3.8,11.1,3924,788,3136,2.5,12.5,-436,-1.4,22.2,0,93,93,360
2000,41780,1715,1860,32623,31905,149,8,171,9.1,4979,1553,3426,4.9,15.6,3542,1555,1987,4.9,11.1,1437,4.5,22.2,0,107,107,710
2001,41780,1726,1889,31993,32450,175,9.3,159,8.5,4172,2105,2067,6.5,12.9,5085,934,4151,2.9,15.7,-913,-2.8,25.8,0,104,104,509
2002,41780,1674,1842,29292,30645,152,8.2,198,10.6,4646,1652,2994,5.4,15.2,7351,1658,5693,5.4,24,-2705,-8.8,30.4,0,88,88,492
2003,41780,1659,1830,30285,29649,167,9.1,154,8.4,5101,1108,3993,3.7,17.2,3829,1089,2740,3.7,12.9,1272,4.3,25.8,0,109,109,564
2004,41780,1627,1796,30409,30243,140,7.8,156,8.6,3816,772,3044,2.6,12.6,3483,906,2577,3,11.5,333,1.1,23,0,97,97,314
2005,41780,1649,1816,30591,30477,167,9.3,135,7.5,4559,1716,2843,5.6,15,4330,1005,3325,3.3,14.2,229,0.8,28.4,0,90,90,821
2006,41780,1618,1790,31918,31219,143,8,159,8.8,5208,1096,4112,3.5,16.7,3809,1451,2358,4.6,12.2,1399,4.5,24.4,0,106,106,573
2007,41780,1619,1808,31882,31865,164,9.1,137,7.6,3867,1403,2464,4.4,12.1,3832,733,3099,2.3,12,35,0.1,24,0,85,86,477
2008,41780,1600,1781,30990,31330,135,7.6,147,8.2,3062,1013,2049,3.2,9.8,3742,1001,2741,3.2,11.9,-680,-2.1,19.6,0,101,101,690
2009,41780,1515,1692,28988,29923,99,5.7,166,9.6,2425,664,1761,2.2,8.1,4294,810,3484,2.7,14.4,-1869,-6.3,16.2,0,101,101,528
2010,41780,1495,1682,27895,28411,131,7.8,135,8,2972,950,2022,3.3,10.5,4004,807,3197,2.8,14.1,-1032,-3.6,21,0,86,86,555
2011,41780,1511,1694,28626,28189,131,7.8,110,6.5,3505,954,2551,3.4,12.4,2631,668,1963,2.4,9.3,874,3.1,18.6,0,67,67,344
2012,41780,1514,1701,29616,29146,121,7.1,116,6.8,3847,641,3206,2.2,13.2,2906,885,2021,3,10,941,3.2,20,0,65,65,424
2013,41780,1490,1672,30087,29794,98,5.8,126,7.5,3688,641,3047,2.2,12.4,3102,608,2494,2,10.4,586,2,20.8,0,73,73,333
2014,41780,1462,1629,30626,30157,89,5.4,117,7.1,3090,389,2701,1.3,10.2,2151,514,1637,1.7,7.1,939,3.1,14.2,0,74,74,326
1977,41860,59005,69565,1135108,1084446,12883,19,9324,13.7,280791,105905,174886,9.8,25.9,179468,77305,102163,7.1,16.5,101323,9.4,33,0,5864,5905,39516
1978,41860,60539,71147,1155529,1144937,11601,16.5,10010,14.2,240139,85545,154594,7.5,21,218955,86149,132806,7.5,19.1,21184,1.9,38.2,0,5944,5983,39953
1979,41860,63605,74560,1240890,1198095,12871,17.7,8992,12.3,268775,104002,164773,8.7,22.4,183185,68408,114777,5.7,15.3,85590,7.1,30.6,0,5933,5946,33559
1980,41860,65372,76630,1277746,1258691,11529,15.3,9204,12.2,239918,90812,149106,7.2,19.1,201808,72687,129121,5.8,16,38110,3.1,32,0,6222,6251,36700
1981,41860,65079,75963,1286025,1279128,11052,14.5,11187,14.7,253432,98837,154595,7.7,19.8,239638,96183,143455,7.5,18.7,13794,1.1,37.4,0,6205,6246,41148
1982,41860,66749,79019,1394646,1339192,12940,16.7,9089,11.7,335771,167863,167908,12.5,25.1,224862,69633,155229,5.2,16.8,110909,8.3,33.6,0,4939,4943,31276
1983,41860,68802,80936,1287300,1334903,10510,13.1,9076,11.3,244795,93463,151332,7,18.3,340000,89188,250812,6.7,25.5,-95205,-7.2,36.6,0,5585,5605,32163
1984,41860,71374,83802,1376363,1333328,12038,14.6,9156,11.1,290179,104744,185435,7.9,21.8,204108,70910,133198,5.3,15.3,86071,6.5,30.6,0,5579,5594,31029
1985,41860,73701,86230,1441132,1419146,12287,14.5,9777,11.5,301771,115516,186255,8.1,21.3,257799,92262,165537,6.5,18.2,43972,3.1,36.4,0,5876,5894,39905
1986,41860,76568,90110,1463596,1450897,14257,16.2,10067,11.4,304399,133647,170752,9.2,21,279000,91609,187391,6.3,19.2,25399,1.8,38.4,0,6261,6278,42735
1987,41860,78658,92839,1524069,1505156,14648,16,11468,12.5,311539,125457,186082,8.3,20.7,273715,109553,164162,7.3,18.2,37824,2.5,36.4,0,7044,7142,51957
1988,41860,79587,94057,1542022,1523228,12865,13.8,11327,12.1,320638,124503,196135,8.2,21,283050,102851,180199,6.8,18.6,37588,2.4,37.2,0,7201,7201,41651
1989,41860,74150,89771,1526350,1534656,12836,14,17079,18.6,321170,116869,204301,7.6,20.9,337781,159129,178652,10.4,22,-16611,-1.1,41.8,0,7154,7213,54649
1990,41860,81607,97883,1630264,1577288,18343,19.6,9690,10.3,362311,167154,195157,10.6,23,256360,98050,158310,6.2,16.3,105951,6.7,32.6,0,6322,6334,57348
1991,41860,83100,100311,1621194,1625425,13465,13.6,11001,11.1,288855,118119,170736,7.3,17.8,297317,94905,202412,5.8,18.3,-8462,-0.5,35.6,0,6644,6719,50123
1992,41860,82909,100304,1581623,1601033,12594,12.5,11967,11.9,274455,96203,178252,6,17.1,313276,102382,210894,6.4,19.6,-38821,-2.5,34.2,0,7308,7405,52775
1993,41860,82607,98846,1588069,1584181,11176,11.2,12191,12.2,293230,100797,192433,6.4,18.5,285455,111027,174428,7,18,7775,0.5,36,0,7236,7328,42496
1994,41860,83193,99477,1592458,1589087,12318,12.4,11296,11.4,267475,101191,166284,6.4,16.8,260733,87115,173618,5.5,16.4,6742,0.4,32.8,0,7055,7099,44946
1995,41860,83527,100106,1627605,1608807,12121,12.2,10866,10.9,269496,93735,175761,5.8,16.8,231899,76012,155887,4.7,14.4,37597,2.4,28.8,0,7030,7059,41565
1996,41860,84760,101296,1682094,1655692,12252,12.2,10744,10.7,299297,101430,197867,6.1,18.1,246492,84428,162064,5.1,14.9,52805,3.2,29.8,0,6784,6787,39234
1997,41860,86223,102420,1754992,1719319,13633,13.4,12536,12.3,360965,122921,238044,7.1,21,289619,123503,166116,7.2,16.8,71346,4.2,33.6,0,7043,7043,54693
1998,41860,86997,103858,1830188,1791813,13238,12.8,11476,11.1,351673,127820,223853,7.1,19.6,274924,101707,173217,5.7,15.3,76749,4.3,30.6,0,7260,7260,46096
1999,41860,87728,104263,1872606,1854417,12897,12.4,12372,11.9,354971,126889,228082,6.8,19.1,318593,132112,186481,7.1,17.2,36378,1.9,34.4,0,7041,7041,46011
2000,41860,88728,105814,1999019,1933630,13016,12.4,11580,11,433938,157981,275957,8.2,22.4,303159,108536,194623,5.6,15.7,130779,6.7,31.4,0,6938,6938,42382
2001,41860,88868,106902,2051318,2028314,12931,12.1,12717,11.9,398885,142057,256828,7,19.7,352879,118866,234013,5.9,17.4,46006,2.3,34.8,0,7564,7568,50943
2002,41860,87639,105788,1889989,1958988,13601,12.8,14422,13.6,336412,143125,193287,7.3,17.2,474411,159895,314516,8.2,24.2,-137999,-7,34.4,0,7772,7794,62159
2003,41860,87357,105272,1862638,1857781,12494,11.9,10946,10.4,312157,107954,204203,5.8,16.8,302443,95180,207263,5.1,16.3,9714,0.5,32.6,0,7339,7410,54012
2004,41860,86977,104622,1849401,1847898,12011,11.5,11309,10.8,294839,95661,199178,5.2,16,291833,97516,194317,5.3,15.8,3006,0.2,31.6,0,7287,7298,49691
2005,41860,88010,106379,1863553,1847239,13139,12.5,10293,9.8,289294,107254,182040,5.8,15.7,256665,83113,173552,4.5,13.9,32629,1.8,27.8,0,7089,7097,50391
2006,41860,88813,107753,1902966,1876231,13247,12.4,10952,10.3,309110,109165,199945,5.8,16.5,255639,82856,172783,4.4,13.6,53471,2.9,27.2,0,7345,7371,51868
2007,41860,89909,108951,1941153,1916911,13202,12.2,11694,10.8,341284,114305,226979,6,17.8,292801,108231,184570,5.6,15.3,48483,2.5,30.6,0,7041,7084,46304
2008,41860,89883,109231,2009373,1969021,11979,11,10574,9.7,347501,142100,205401,7.2,17.6,266798,72166,194632,3.7,13.5,80703,4.1,27,0,7329,7340,45723
2009,41860,87798,107054,1860662,1924688,10295,9.5,11241,10.4,214824,83538,131286,4.3,11.2,342876,87986,254890,4.6,17.8,-128052,-6.6,22.4,0,7522,7533,41757
2010,41860,86613,105646,1782946,1801463,10119,9.5,10595,10,222128,74791,147337,4.2,12.3,259162,79030,180132,4.4,14.4,-37034,-2.1,24.6,0,6930,6948,40841
2011,41860,86731,106032,1774724,1768129,10976,10.4,10072,9.5,241085,76628,164457,4.3,13.6,227895,84728,143167,4.8,12.9,13190,0.7,25.8,0,6538,6556,42897
2012,41860,88230,107500,1840404,1806285,11707,11,10290,9.7,284326,82135,202191,4.5,15.7,216088,74353,141735,4.1,12,68238,3.7,24,0,6169,6212,33924
2013,41860,89309,108726,1912133,1872331,11374,10.6,10094,9.4,285165,86098,199067,4.6,15.2,205560,70888,134672,3.8,11,79605,4.2,22,0,6328,6371,40012
2014,41860,90897,110675,1987020,1944586,12508,11.4,9889,9,300519,90573,209946,4.7,15.5,215651,69665,145986,3.6,11.1,84868,4.4,22.2,0,6780,6802,39367
1977,41940,20187,23500,446816,423831,5168,22.9,3184,14.1,103841,45138,58703,10.6,24.5,57871,26375,31496,6.2,13.7,45970,10.8,27.4,0,2048,2058,13623
1978,41940,20873,24281,492179,469817,4482,18.8,3689,15.4,108125,35307,72818,7.5,23,63400,28755,34645,6.1,13.5,44725,9.5,27,0,2304,2316,13333
1979,41940,22269,25829,554212,522438,5042,20.1,3291,13.1,127501,44583,82918,8.5,24.4,63953,28241,35712,5.4,12.2,63548,12.2,24.4,0,2266,2271,13795
1980,41940,23373,27043,616141,584618,4850,18.4,3507,13.3,145209,41991,103218,7.2,24.8,82163,34778,47385,5.9,14.1,63046,10.7,28.2,0,2371,2379,17100
1981,41940,23364,26937,613554,611379,4390,16.3,4252,15.8,111666,44088,67578,7.2,18.3,107315,41736,65579,6.8,17.6,4351,0.7,35.2,0,2423,2430,17079
1982,41940,24226,28358,637959,625937,5152,18.6,3496,12.6,134571,69353,65218,11.1,21.5,110527,33126,77401,5.3,17.7,24044,3.8,35.4,0,1954,1956,13326
1983,41940,25016,29058,654130,645976,3982,13.9,3442,12,125888,42202,83686,6.5,19.5,109580,36366,73214,5.6,17,16308,2.5,34,0,2085,2091,14969
1984,41940,25990,30089,715578,684254,4433,15,3428,11.6,155913,43923,111990,6.4,22.8,93267,36750,56517,5.4,13.6,62646,9.2,27.2,0,2242,2245,14218
1985,41940,26913,30960,728020,721981,4424,14.5,3546,11.6,140535,44182,96353,6.1,19.5,128457,48141,80316,6.7,17.8,12078,1.7,35.6,0,2149,2155,17757
1986,41940,27558,31635,712565,719757,4796,15.3,3989,12.7,123781,47023,76758,6.5,17.2,138165,49884,88281,6.9,19.2,-14384,-2,34.4,0,2459,2460,21613
1987,41940,28250,32536,741664,736079,5281,16.4,4246,13.2,130564,47782,82782,6.5,17.7,119395,52660,66735,7.2,16.2,11169,1.5,32.4,0,2613,2646,19882
1988,41940,28848,33385,771003,755142,5055,15.3,4062,12.3,147777,46668,101109,6.2,19.6,116055,43996,72059,5.8,15.4,31722,4.2,30.8,0,2623,2623,16896
1989,41940,27254,31962,764308,769036,4669,14.3,6087,18.6,134651,44124,90527,5.7,17.5,144107,71430,72677,9.3,18.7,-9456,-1.2,35,0,2658,2666,21216.5
1990,41940,29961,34886,808576,786222,6554,19.6,3426,10.3,150633,65264,85369,8.3,19.2,105925,33964,71961,4.3,13.5,44708,5.7,27,0,2324,2332,16994
1991,41940,30452,35580,796855,800525,4679,13.3,4001,11.4,131936,44290,87646,5.5,16.5,139275,47373,91902,5.9,17.4,-7339,-0.9,33,0,2423,2442,19318
1992,41940,30523,35677,772379,783953,4693,13.2,4352,12.2,128714,50043,78671,6.4,16.4,151861,46275,105586,5.9,19.4,-23147,-3,32.8,0,2752,2783,22255
1993,41940,30750,35696,767180,769317,4314,12.1,4116,11.5,120925,32119,88806,4.2,15.7,125199,37695,87504,4.9,16.3,-4274,-0.6,31.4,0,2615,2630,15032
1994,41940,30922,35833,762040,764893,4581,12.8,4216,11.8,116090,40895,75195,5.3,15.2,121795,41253,80542,5.4,15.9,-5705,-0.7,30.4,0,2659,2674,17054
1995,41940,31507,36553,801572,781386,4909,13.6,4016,11.1,142656,47208,95448,6,18.3,102283,39639,62644,5.1,13.1,40373,5.2,26.2,0,2616,2620,15353
1996,41940,32389,37429,847305,826533,5037,13.6,4041,10.9,155848,45131,110717,5.5,18.9,114304,45604,68700,5.5,13.8,41544,5.1,27.6,0,2606,2607,20780
1997,41940,33443,38634,890352,869097,5604,14.7,4441,11.7,179910,54037,125873,6.2,20.7,137400,49543,87857,5.7,15.8,42510,4.9,31.6,0,2604,2604,18874
1998,41940,34186,39645,930123,908836,5382,13.8,4262,10.9,174703,52473,122230,5.8,19.2,132130,51763,80367,5.7,14.5,42573,4.7,29,0,2793,2793,20585
1999,41940,34628,40258,927043,928357,5172,12.9,4491,11.2,158697,58867,99830,6.3,17.1,161325,52751,108574,5.7,17.4,-2628,-0.3,34.2,0,2827,2827,20371
2000,41940,35055,40848,983725,954989,5453,13.4,4849,12,215833,79572,136261,8.3,22.6,158360,66206,92154,6.9,16.6,57473,6,33.2,0,2893,2893,20535
2001,41940,35362,41566,1044432,1020014,5645,13.7,5264,12.8,221928,72907,149021,7.1,21.8,173093,58987,114106,5.8,17,48835,4.8,34,0,3239,3240,25637
2002,41940,34422,40603,918540,975277,5398,13.2,6206,15.1,170440,72096,98344,7.4,17.5,283914,101046,182868,10.4,29.1,-113474,-11.6,35,0,3481,3488,34189
2003,41940,34102,40169,877505,890567,5116,12.7,4637,11.6,151184,63150,88034,7.1,17,177309,50337,126972,5.7,19.9,-26125,-2.9,34,0,3151,3230,27462
2004,41940,33978,39893,870123,869512,4880,12.2,4550,11.4,140882,50191,90691,5.8,16.2,139661,45971,93690,5.3,16.1,1221,0.1,32.2,0,2976,2978,22585
2005,41940,34467,40635,875596,869398,5337,13.3,4175,10.4,127518,40175,87343,4.6,14.7,115122,39938,75184,4.6,13.2,12396,1.5,26.4,0,2902,2908,23877
2006,41940,34907,41358,913204,891740,5405,13.2,4325,10.6,156427,48527,107900,5.4,17.5,113499,42768,70731,4.8,12.7,42928,4.8,25.4,0,2992,2997,21209
2007,41940,35385,41956,942000,925491,5353,12.9,4566,11,154737,45761,108976,4.9,16.7,121721,43244,78477,4.7,13.2,33016,3.5,26.4,0,2857,2879,16932
2008,41940,35303,41967,945482,940715,4738,11.3,4296,10.3,144273,42691,101582,4.5,15.3,134739,39384,95355,4.2,14.3,9534,1,28.6,0,3029,3033,24041
2009,41940,34292,40866,875126,907292,4094,9.9,4709,11.4,107099,37855,69244,4.2,11.8,171430,44334,127096,4.9,18.9,-64331,-7.1,23.6,0,3138,3141,19895
2010,41940,33794,40353,871625,869663,4078,10.1,4202,10.4,126213,45250,80963,5.2,14.5,122291,34917,87374,4,14.1,3922,0.4,28.2,0,2835,2837,18273
2011,41940,34098,40787,889391,877539,4527,11.2,3870,9.6,129835,37169,92666,4.2,14.8,106131,40426,65705,4.6,12.1,23704,2.7,24.2,0,2579,2586,17074
2012,41940,34905,41583,915640,900632,4847,11.8,4038,9.8,135387,41745,93642,4.6,15,105371,31147,74224,3.5,11.7,30016,3.3,23.4,0,2426,2431,16947
2013,41940,35509,42288,965157,938372,4738,11.3,4043,9.7,168415,60044,108371,6.4,17.9,114846,34642,80204,3.7,12.2,53569,5.7,24.4,0,2572,2579,16957
2014,41940,36012,42841,1000421,981000,4854,11.4,4049,9.5,163264,47316,115948,4.8,16.6,124423,43239,81184,4.4,12.7,38841,3.9,25.4,0,2821,2825,27754
1977,42020,2833,3033,26626,25098,686,23.7,406,14,7685,3794,3891,15.1,30.6,4628,2355,2273,9.4,18.4,3057,12.2,36.8,0,277,278,1514
1978,42020,3021,3229,30390,28442,688,22,478,15.3,8868,3476,5392,12.2,31.2,4971,2462,2509,8.7,17.5,3897,13.7,35,0,310,310,1440
1979,42020,3181,3402,33526,31880,717,21.6,511,15.4,9164,3799,5365,11.9,28.7,5872,2709,3163,8.5,18.4,3292,10.3,36.8,0,394,394,1956
1980,42020,3296,3526,33759,33609,677,19.6,518,15,8585,4177,4408,12.4,25.5,8284,3679,4605,10.9,24.6,301,0.9,49.2,0,393,396,2665
1981,42020,3257,3474,35725,34656,604,17.3,609,17.4,9579,4183,5396,12.1,27.6,7441,3296,4145,9.5,21.5,2138,6.1,43,0,387,389,1868
1982,42020,3341,3643,41904,38747,707,19.8,478,13.4,12992,9199,3793,23.7,33.5,6678,2303,4375,5.9,17.2,6314,16.3,34.4,0,284,284,1168
1983,42020,3480,3768,37044,39166,583,15.7,480,13,7817,3737,4080,9.5,20,12060,2537,9523,6.5,30.8,-4243,-10.8,40,0,331,333,1590
1984,42020,3714,4018,41976,39591,684,17.6,437,11.2,10082,4145,5937,10.5,25.5,5312,2556,2756,6.5,13.4,4770,12.1,26.8,0,318,318,1661
1985,42020,4028,4336,50701,46322,743,17.8,442,10.6,15654,4530,11124,9.8,33.8,6896,2673,4223,5.8,14.9,8758,18.9,29.8,0,274,277,1485
1986,42020,4288,4604,47910,49212,827,18.5,531,11.9,10305,5011,5294,10.2,20.9,12909,3111,9798,6.3,26.2,-2604,-5.3,41.8,0,328,328,1723
1987,42020,4495,4824,52941,51306,875,18.5,614,13,12100,5642,6458,11,23.6,8830,3867,4963,7.5,17.2,3270,6.4,34.4,0,391,392,2096
1988,42020,4615,4978,53725,52976,830,16.9,623,12.7,11111,4815,6296,9.1,21,9612,4393,5219,8.3,18.1,1499,2.9,36.2,0,454,454,3012
1989,42020,4740,5117,57457,55662,778,15.4,633,12.5,11988,5161,6827,9.3,21.5,8398,3302,5096,5.9,15.1,3590,6.4,30.2,0,425,426,2042
1990,42020,4979,5375,60853,59154,872,16.6,550,10.5,12673,5269,7404,8.9,21.4,9275,3742,5533,6.3,15.7,3398,5.7,31.4,0,415,415,2976
1991,42020,5046,5493,59929,60420,771,14.2,658,12.1,11233,5522,5711,9.1,18.6,12214,4465,7749,7.4,20.2,-981,-1.6,37.2,0,420,422,2784
1992,42020,4938,5410,59328,59373,693,12.7,724,13.3,11337,4150,7187,7,19.1,11427,3541,7886,6,19.2,-90,-0.1,38.2,0,485,491,2047
1993,42020,4846,5288,57216,58084,580,10.8,663,12.4,9238,3143,6095,5.4,15.9,10973,4310,6663,7.4,18.9,-1735,-3,31.8,0,452,459,3190
1994,42020,4823,5266,57477,57320,656,12.4,635,12,9495,4014,5481,7,16.6,9181,3557,5624,6.2,16,314,0.6,32,0,427,427,1832
1995,42020,4923,5395,59045,58228,733,13.8,578,10.8,11080,4990,6090,8.6,19,9446,3749,5697,6.4,16.2,1634,2.8,32.4,0,402,402,2355
1996,42020,4972,5442,60428,59703,666,12.3,600,11.1,10507,4010,6497,6.7,17.6,9056,3718,5338,6.2,15.2,1451,2.4,30.4,0,400,400,2199
1997,42020,5092,5579,64935,62621,763,13.8,624,11.3,14623,5149,9474,8.2,23.4,9995,4415,5580,7.1,16,4628,7.4,32,0,383,383,2294
1998,42020,5212,5723,68657,66682,742,13.1,570,10.1,12930,5245,7685,7.9,19.4,8979,4057,4922,6.1,13.5,3951,5.9,27,0,373,373,2706
1999,42020,5352,5884,72196,70330,787,13.6,605,10.4,14532,6454,8078,9.2,20.7,10800,4680,6120,6.7,15.4,3732,5.3,30.8,0,376,376,2480
2000,42020,5547,6105,73068,72697,771,12.9,569,9.5,12984,5903,7081,8.1,17.9,12241,4139,8102,5.7,16.8,743,1.1,33.6,0,381,381,2214
2001,42020,5734,6346,78036,75987,817,13.1,663,10.6,14617,6173,8444,8.1,19.2,10518,3972,6546,5.2,13.8,4099,5.4,27.6,0,413,413,2162
2002,42020,5898,6578,82108,79969,928,14.4,676,10.5,15484,6767,8717,8.5,19.4,11206,3780,7426,4.7,14,4278,5.4,28,0,432,432,2323
2003,42020,5993,6679,84558,82197,889,13.5,629,9.5,16238,7893,8345,9.6,19.8,11515,4666,6849,5.7,14,4723,5.8,28,0,466,467,3238
2004,42020,6054,6724,85653,84923,785,11.7,666,9.9,12717,4717,8000,5.6,15,11256,3816,7440,4.5,13.3,1461,1.7,26.6,0,456,456,2712
2005,42020,6233,6943,84293,83644,938,13.7,677,9.9,14271,6323,7948,7.6,17.1,12973,4437,8536,5.3,15.5,1298,1.6,31,0,509,515,2967
2006,42020,6366,7135,87690,85942,950,13.5,715,10.2,15266,6885,8381,8,17.8,11769,4929,6840,5.7,13.7,3497,4.1,27.4,0,522,522,3548
2007,42020,6525,7297,88643,87994,985,13.7,790,11,16351,6940,9411,7.9,18.6,15052,6269,8783,7.1,17.1,1299,1.5,34.2,0,525,531,3565
2008,42020,6505,7321,87464,87645,849,11.7,763,10.5,12954,5347,7607,6.1,14.8,13316,4612,8704,5.3,15.2,-362,-0.4,29.6,0,586,586,3373
2009,42020,6310,7093,82592,84756,688,9.6,839,11.7,10068,3521,6547,4.2,11.9,14396,3724,10672,4.4,17,-4328,-5.1,23.8,0,579,579,2443
2010,42020,6117,6899,80053,81105,600,8.6,726,10.4,9500,3385,6115,4.2,11.7,11603,4328,7275,5.3,14.3,-2103,-2.6,23.4,0,505,505,2487
2011,42020,6080,6892,81315,80572,643,9.3,622,9,10419,3655,6764,4.5,12.9,8932,3035,5897,3.8,11.1,1487,1.8,22.2,0,426,426,2087
2012,42020,6121,6937,83617,82461,706,10.2,685,9.9,12086,4473,7613,5.4,14.7,9773,3734,6039,4.5,11.9,2313,2.8,23.8,0,412,413,1927
2013,42020,6155,6957,86587,84827,648,9.4,618,8.9,12753,4919,7834,5.8,15,9233,3682,5551,4.3,10.9,3520,4.1,21.8,0,395,395,2388
2014,42020,6229,7037,88887,87644,716,10.3,611,8.7,13337,4524,8813,5.2,15.2,10851,4278,6573,4.9,12.4,2486,2.8,24.8,0,423,424,2194
1977,42060,5831,6547,84911,87672,1373,21.2,1215,18.8,22777,11642,11135,13.3,26,28299,21597,6702,24.6,32.3,-5522,-6.3,52,0,920,923,18678
1978,42060,6075,6813,107943,96391,1222,18.3,949,14.2,37727,19642,18085,20.4,39.1,14622,7772,6850,8.1,15.2,23105,23.9,30.4,0,593,595,3870
1979,42060,6432,7147,104577,106164,1351,19.4,966,13.8,31403,14491,16912,13.6,29.6,34577,22135,12442,20.8,32.6,-3174,-3,59.2,0,688,690,15698
1980,42060,6510,7241,97325,100926,1133,15.8,1004,14,18665,6982,11683,6.9,18.5,25866,13193,12673,13.1,25.6,-7201,-7.1,37,0,742,745,11334
1981,42060,6455,7148,110188,103640,1073,14.9,1121,15.6,31405,9108,22297,8.8,30.3,18309,8999,9310,8.7,17.7,13096,12.6,35.4,0,646,646,3779
1982,42060,6678,7477,116885,113417,1307,17.9,913,12.5,27065,14915,12150,13.2,23.9,20129,8905,11224,7.9,17.7,6936,6.2,35.4,0,510,511,4118
1983,42060,6839,7650,106099,111375,993,13.1,849,11.2,23009,9402,13607,8.4,20.7,33561,6056,27505,5.4,30.1,-10552,-9.4,41.4,0,557,559,3531
1984,42060,7076,7918,113599,109802,1146,14.7,867,11.1,24130,9173,14957,8.4,22,16536,6654,9882,6.1,15.1,7594,6.9,30.2,0,577,577,3984
1985,42060,7426,8257,122556,121795,1210,15,873,10.8,23599,8208,15391,6.7,19.4,22076,9866,12210,8.1,18.1,1523,1.3,36.2,0,524,524,3530
1986,42060,7701,8548,128057,125152,1281,15.3,943,11.2,24991,10751,14240,8.6,20,19181,7821,11360,6.2,15.3,5810,4.7,30.6,0,624,624,5261
1987,42060,7857,8733,127850,127641,1344,15.5,1118,12.9,31915,9630,22285,7.5,25,31497,17104,14393,13.4,24.7,418,0.3,49.4,0,675,680,4486
1988,42060,7969,8879,119433,118704,1237,14.1,1038,11.8,22973,8448,14525,7.1,19.4,21514,7963,13551,6.7,18.1,1459,1.3,36.2,0,677,677,4357
1989,42060,8032,8979,123607,121830,1170,13.1,1062,11.9,22776,8914,13862,7.3,18.7,19221,7696,11525,6.3,15.8,3555,2.9,31.6,0,700,703,4581
1990,42060,8188,9156,126827,124960,1203,13.3,928,10.2,21802,7535,14267,6,17.4,18068,6513,11555,5.2,14.5,3734,2.9,29,0,644,648,4181
1991,42060,8273,9326,124177,125695,1150,12.4,967,10.5,20957,9742,11215,7.8,16.7,23992,5788,18204,4.6,19.1,-3035,-2.4,33.4,0,610,612,3364
1992,42060,8215,9269,120215,122054,1103,11.9,1103,11.9,21018,7260,13758,5.9,17.2,24696,7855,16841,6.4,20.2,-3678,-3,34.4,0,678,698,4675
1993,42060,8093,9093,117648,119007,959,10.4,1086,11.8,19089,7563,11526,6.4,16,21806,7603,14203,6.4,18.3,-2717,-2.3,32,0,699,705,3758
1994,42060,8090,9079,115559,116439,1060,11.7,1013,11.2,19070,7916,11154,6.8,16.4,20829,7809,13020,6.7,17.9,-1759,-1.5,32.8,0,672,675,3438
1995,42060,8102,9116,117268,116347,1032,11.3,955,10.5,18981,6647,12334,5.7,16.3,17139,6423,10716,5.5,14.7,1842,1.6,29.4,0,644,646,3184
1996,42060,8172,9190,118471,117886,1020,11.1,923,10.1,20825,7813,13012,6.6,17.7,19654,7080,12574,6,16.7,1171,1,33.4,0,599,599,4218
1997,42060,8225,9238,120717,119821,1090,11.8,1027,11.1,22415,7270,15145,6.1,18.7,20622,7601,13021,6.3,17.2,1793,1.5,34.4,0,630,630,3645
1998,42060,8295,9326,126683,123571,1093,11.8,953,10.3,22325,7642,14683,6.2,18.1,16101,6086,10015,4.9,13,6224,5.1,26,0,608,608,3600
1999,42060,8360,9407,136514,131848,1034,11,952,10.2,28399,14404,13995,10.9,21.5,19066,7339,11727,5.6,14.5,9333,7,29,0,614,614,3794
2000,42060,8401,9468,137414,136691,1077,11.4,1017,10.8,24141,10048,14093,7.4,17.7,22695,8878,13817,6.5,16.6,1446,1.1,33.2,0,634,634,4035
2001,42060,8612,9726,136944,137552,1178,12.2,1044,10.8,23241,10003,13238,7.3,16.9,24456,11239,13217,8.2,17.8,-1215,-0.9,33.8,0,616,616,4002
2002,42060,8706,9841,140404,138507,1294,13.2,1154,11.8,28310,12125,16185,8.8,20.4,24516,10087,14429,7.3,17.7,3794,2.7,35.4,0,642,642,5111
2003,42060,8707,9854,142510,140736,1145,11.7,940,9.6,24187,8221,15966,5.8,17.2,20638,7068,13570,5,14.7,3549,2.5,29.4,0,669,681,4919
2004,42060,8719,9884,143630,142582,1090,11.1,944,9.6,22892,9287,13605,6.5,16.1,20795,9464,11331,6.6,14.6,2097,1.5,29.2,0,670,670,7098
2005,42060,8871,10055,142121,142458,1166,11.7,915,9.2,20497,9230,11267,6.5,14.4,21171,7592,13579,5.3,14.9,-674,-0.5,28.8,0,653,656,3602
2006,42060,8986,10244,145031,143378,1166,11.5,919,9.1,23744,9552,14192,6.7,16.6,20438,9178,11260,6.4,14.3,3306,2.3,28.6,0,660,660,6471
2007,42060,9133,10336,147587,146184,1121,10.9,981,9.5,26124,8346,17778,5.7,17.9,23318,9371,13947,6.4,16,2806,1.9,32,0,592,600,3848
2008,42060,9099,10330,146319,146285,998,9.7,904,8.8,19744,6589,13155,4.5,13.5,19675,6475,13200,4.4,13.4,69,0.1,26.8,0,642,642,4663
2009,42060,8906,10108,138984,142134,825,8.1,947,9.3,14974,5332,9642,3.8,10.5,21273,6031,15242,4.2,15,-6299,-4.5,21,0,653,653,3902
2010,42060,8797,10031,136417,137262,888,8.8,881,8.8,16710,7859,8851,5.7,12.2,18400,4654,13746,3.4,13.4,-1690,-1.2,24.4,0,606,606,2969
2011,42060,8778,10018,137010,136421,913,9.1,883,8.8,17055,5778,11277,4.2,12.5,15876,5375,10501,3.9,11.6,1179,0.9,23.2,0,575,575,3131
2012,42060,8796,10049,138838,137084,924,9.2,895,8.9,18860,5384,13476,3.9,13.8,15351,5627,9724,4.1,11.2,3509,2.6,22.4,0,531,536,2717
2013,42060,8801,10057,145834,142460,893,8.9,906,9,20767,6613,14154,4.6,14.6,14019,4698,9321,3.3,9.8,6748,4.8,19.6,0,580,580,2933
2014,42060,8883,10150,148173,146731,975,9.7,841,8.3,19788,6876,12912,4.7,13.5,16903,6418,10485,4.4,11.5,2885,2,23,0,575,576,3828
1977,42100,3257,3502,36791,34807,805,23.9,527,15.6,10103,4929,5174,14.2,29,6134,3207,2927,9.2,17.6,3969,11.4,35.2,0,356,358,1775
1978,42100,3470,3743,42178,39494,810,22.4,568,15.7,11976,4285,7691,10.8,30.3,6608,3363,3245,8.5,16.7,5368,13.6,33.4,0,367,369,2129
1979,42100,3621,3908,45692,43816,787,20.6,579,15.1,11840,5357,6483,12.2,27,8087,3458,4629,7.9,18.5,3753,8.5,37,0,401,401,2269
1980,42100,3844,4135,46123,45903,794,19.7,548,13.6,10111,4579,5532,10,22,9671,3354,6317,7.3,21.1,440,0.9,42.2,0,379,380,1842
1981,42100,3822,4089,46109,45949,712,17.3,716,17.4,9904,4163,5741,9.1,21.6,9583,4806,4777,10.5,20.9,321,0.7,41.8,0,420,421,1996
1982,42100,3962,4277,62541,54390,806,19.3,546,13,25143,4846,20297,8.9,46.2,8841,2736,6105,5,16.3,16302,29.9,32.6,0,337,337,1752
1983,42100,4018,4338,48462,55403,600,13.9,554,12.9,10277,3771,6506,6.8,18.5,24159,3154,21005,5.7,43.6,-13882,-25.1,37,0,368,368,1881
1984,42100,4228,4563,55388,51948,777,17.5,560,12.6,13658,4754,8904,9.2,26.3,6778,2837,3941,5.5,13,6880,13.3,26,0,386,386,1913
1985,42100,4540,4889,55933,55571,834,17.6,514,10.9,12034,4620,7414,8.3,21.7,11310,3697,7613,6.7,20.4,724,1.3,40.8,0,334,334,1985
1986,42100,4710,5059,58885,57339,871,17.5,667,13.4,13820,6170,7650,10.8,24.1,10727,4301,6426,7.5,18.7,3093,5.4,37.4,0,439,439,2614
1987,42100,4898,5273,59931,59524,943,18.2,693,13.4,13467,6320,7147,10.6,22.6,12653,4772,7881,8,21.3,814,1.3,42.6,0,463,467,2771
1988,42100,5018,5429,66952,63341,847,15.8,653,12.2,17624,5401,12223,8.5,27.8,10401,4218,6183,6.7,16.4,7223,11.4,32.8,0,432,432,2445
1989,42100,4805,5242,67197,66962,833,15.6,1013,19,14486,5664,8822,8.5,21.6,14016,8279,5737,12.4,20.9,470,0.7,41.8,0,434,434,2521
1990,42100,5319,5784,72739,69859,1176,21.3,601,10.9,17659,8721,8938,12.5,25.3,11898,4867,7031,7,17,5761,8.3,34,0,443,444,3170
1991,42100,5440,5928,70063,71368,810,13.8,663,11.3,12070,3925,8145,5.5,16.9,14680,3589,11091,5,20.6,-2610,-3.7,33.8,0,440,443,2321
1992,42100,5350,5853,69325,69588,757,12.8,782,13.3,12480,4588,7892,6.6,17.9,13007,4643,8364,6.7,18.7,-527,-0.8,35.8,0,528,533,2577
1993,42100,5223,5702,69737,69443,634,11,715,12.4,11687,3428,8259,4.9,16.8,11099,4204,6895,6.1,16,588,0.8,32,0,497,503,2354
1994,42100,5170,5637,69094,69265,682,12,686,12.1,11320,4270,7050,6.2,16.3,11661,4044,7617,5.8,16.8,-341,-0.5,32.6,0,461,461,2291
1995,42100,5207,5672,69084,69031,731,12.9,661,11.7,11600,5122,6478,7.4,16.8,11493,3781,7712,5.5,16.6,107,0.2,33.2,0,473,474,2540
1996,42100,5270,5742,69740,69366,696,12.2,592,10.4,11008,3318,7690,4.8,15.9,10260,4052,6208,5.8,14.8,748,1.1,29.6,0,404,404,1930
1997,42100,5326,5818,71241,70406,733,12.7,649,11.2,13016,4708,8308,6.7,18.5,11345,3782,7563,5.4,16.1,1671,2.4,32.2,0,391,391,2056
1998,42100,5450,5951,73502,72445,709,12,586,10,12767,4502,8265,6.2,17.6,10652,3719,6933,5.1,14.7,2115,2.9,29.4,0,391,391,2228
1999,42100,5516,6018,75842,74924,681,11.4,609,10.2,12771,5215,7556,7,17,10934,3808,7126,5.1,14.6,1837,2.4,29.2,0,413,413,2021
2000,42100,5633,6169,78619,76977,741,12.2,589,9.7,14017,5188,8829,6.7,18.2,10732,4406,6326,5.7,13.9,3285,4.3,27.8,0,398,398,2874
2001,42100,5753,6299,80777,80041,746,11.9,687,11,12802,4600,8202,5.7,16,11329,3969,7360,5,14.2,1473,1.8,28.4,0,411,411,2026
2002,42100,5708,6255,78219,79346,808,12.9,824,13.2,13379,4881,8498,6.2,16.9,15633,5359,10274,6.8,19.7,-2254,-2.8,33.8,0,469,469,2609
2003,42100,5640,6203,75762,76588,727,11.7,662,10.7,12797,5296,7501,6.9,16.7,14449,4084,10365,5.3,18.9,-1652,-2.2,33.4,0,481,487,2446
2004,42100,5587,6139,75253,75383,648,10.5,641,10.4,11075,4219,6856,5.6,14.7,11335,4206,7129,5.6,15,-260,-0.3,29.4,0,426,426,2484
2005,42100,5696,6252,75539,75179,758,12.3,600,9.7,11585,4360,7225,5.8,15.4,10865,3787,7078,5,14.5,720,0.9,29,0,385,385,2449
2006,42100,5693,6287,77276,76427,738,11.8,653,10.4,12471,5141,7330,6.7,16.3,10772,3741,7031,4.9,14.1,1699,2.2,28.2,0,454,454,2825
2007,42100,5752,6341,75744,76492,701,11.1,654,10.4,11124,3476,7648,4.5,14.5,12619,4042,8577,5.3,16.5,-1495,-2,29,0,418,420,2508
2008,42100,5782,6377,74252,74734,673,10.6,583,9.2,9907,3169,6738,4.2,13.3,10870,3322,7548,4.4,14.5,-963,-1.2,26.6,0,402,405,1978
2009,42100,5605,6201,72027,72925,566,9,681,10.8,8252,3376,4876,4.6,11.3,10048,2674,7374,3.7,13.8,-1796,-2.5,22.6,0,483,483,1935
2010,42100,5421,6018,68326,69698,494,8.1,610,10,7507,2642,4865,3.8,10.8,10251,3111,7140,4.5,14.7,-2744,-3.9,21.6,0,397,398,1922
2011,42100,5385,5975,68103,68071,581,9.7,584,9.8,8182,2908,5274,4.3,12,8118,2900,5218,4.3,11.9,64,0.1,23.8,0,382,382,1687
2012,42100,5431,6026,68245,68156,596,9.9,557,9.3,9188,2957,6231,4.3,13.5,9009,3189,5820,4.7,13.2,179,0.3,26.4,0,328,331,1513
2013,42100,5463,6049,70557,69333,564,9.4,567,9.4,10008,3073,6935,4.4,14.4,7560,2358,5202,3.4,10.9,2448,3.5,21.8,0,349,349,1496
2014,42100,5469,6052,72480,71395,617,10.2,593,9.8,9233,2840,6393,4,12.9,7063,2775,4288,3.9,9.9,2170,3,19.8,0,403,403,1519
1977,42140,1638,1732,15652,14685,361,21.8,207,12.5,4740,2508,2232,17.1,32.3,2806,1131,1675,7.7,19.1,1934,13.2,38.2,0,141,141,624
1978,42140,1605,1699,16443,16015,296,17.3,306,17.8,4236,1572,2664,9.8,26.5,3380,1893,1487,11.8,21.1,856,5.4,42.2,0,174,174,771
1979,42140,1820,1919,18281,17389,364,20.1,159,8.8,4923,2460,2463,14.1,28.3,3138,1405,1733,8.1,18,1785,10.3,36,0,9,10,352
1980,42140,1894,1994,18323,18271,358,18.3,256,13.1,4402,2358,2044,12.9,24.1,4297,1966,2331,10.8,23.5,105,0.6,47,0,177,177,845
1981,42140,1887,1981,18041,18030,320,16.1,304,15.3,4000,1836,2164,10.2,22.2,3978,1510,2468,8.4,22.1,22,0.1,44.2,0,202,202,888
1982,42140,1976,2089,19309,18700,370,18.2,241,11.8,4392,1976,2416,10.6,23.5,3173,1124,2049,6,17,1219,6.5,34,0,138,138,706
1983,42140,2108,2225,20807,20101,350,16.2,252,11.7,4722,2015,2707,10,23.5,3309,1298,2011,6.5,16.5,1413,7,33,0,173,174,824
1984,42140,2216,2340,22961,21868,389,17.1,264,11.6,5823,2411,3412,11,26.6,3636,1447,2189,6.6,16.6,2187,10,33.2,0,178,178,989
1985,42140,2302,2430,24165,23611,386,16.2,289,12.1,5676,2187,3489,9.3,24,4568,1996,2572,8.5,19.3,1108,4.7,38.6,0,186,186,1004
1986,42140,2375,2521,25878,24975,459,18.6,342,13.8,7236,3570,3666,14.3,29,5430,2030,3400,8.1,21.7,1806,7.3,43.4,0,224,224,1411
1987,42140,2410,2566,26434,26029,420,16.5,365,14.3,6612,3099,3513,11.9,25.4,5801,2580,3221,9.9,22.3,811,3.1,44.6,0,238,241,1704
1988,42140,2433,2621,27016,26636,416,16.1,316,12.2,5875,2218,3657,8.3,22.1,5115,2090,3025,7.8,19.2,760,2.9,38.4,0,217,217,1250
1989,42140,2512,2723,28759,27911,442,16.5,344,12.9,7041,3257,3784,11.7,25.2,5345,2162,3183,7.7,19.2,1696,6,38.4,0,224,224,1383
1990,42140,2709,2920,30932,29824,469,16.6,253,9,6629,2698,3931,9,22.2,4412,1354,3058,4.5,14.8,2217,7.4,29.6,0,164,166,799
1991,42140,2925,3145,33917,32626,527,17.4,304,10,7965,3872,4093,11.9,24.4,5383,2196,3187,6.7,16.5,2582,7.9,33,0,198,198,1378
1992,42140,3020,3248,33321,33313,490,15.3,356,11.1,6862,2838,4024,8.5,20.6,6846,2517,4329,7.6,20.6,16,0,41.2,0,231,232,1395
1993,42140,3127,3344,36097,34735,476,14.4,379,11.5,7969,2415,5554,7,22.9,5244,2298,2946,6.6,15.1,2725,7.8,30.2,0,242,242,1095
1994,42140,3342,3574,38717,37367,631,18.2,376,10.9,8354,3814,4540,10.2,22.4,5653,2309,3344,6.2,15.1,2701,7.3,30.2,0,262,262,1486
1995,42140,3427,3671,39985,39267,573,15.8,438,12.1,7755,3401,4354,8.7,19.7,6319,2305,4014,5.9,16.1,1436,3.6,32.2,0,322,322,1322
1996,42140,3464,3729,41360,40745,507,13.7,435,11.8,8026,3355,4671,8.2,19.7,6796,2569,4227,6.3,16.7,1230,3,33.4,0,303,303,1569
1997,42140,3502,3767,41533,41482,521,13.9,487,13,7880,3122,4758,7.5,19,7777,2578,5199,6.2,18.7,103,0.3,37.4,0,326,326,1405
1998,42140,3593,3868,44825,43150,544,14.3,435,11.4,10031,5635,4396,13.1,23.2,6681,2627,4054,6.1,15.5,3350,7.7,31,0,283,283,1800
1999,42140,3662,3948,45620,45266,527,13.5,452,11.6,7708,2641,5067,5.8,17,7000,2734,4266,6,15.5,708,1.5,31,0,312,312,1579
2000,42140,3717,4037,44607,45073,548,13.7,467,11.7,8060,3644,4416,8.1,17.9,8991,5067,3924,11.2,19.9,-931,-2,35.8,0,308,308,3857
2001,42140,3800,4135,44799,44892,545,13.3,481,11.8,7298,2901,4397,6.5,16.3,7484,2856,4628,6.4,16.7,-186,-0.4,32.6,0,276,276,1508
2002,42140,3858,4180,46298,45589,587,14.1,535,12.9,8506,3799,4707,8.3,18.7,7087,2640,4447,5.8,15.5,1419,3.2,31,0,278,278,1084
2003,42140,3961,4297,48308,47059,562,13.3,371,8.8,8683,3013,5670,6.4,18.5,6184,1856,4328,3.9,13.1,2499,5.4,26.2,0,245,245,1048
2004,42140,3993,4321,48590,48302,504,11.7,424,9.9,7272,2574,4698,5.3,15.1,6696,2310,4386,4.8,13.9,576,1.2,27.8,0,267,267,1355
2005,42140,4091,4454,48923,48647,577,13.2,414,9.4,7437,3364,4073,6.9,15.3,6884,2573,4311,5.3,14.2,553,1.1,28.4,0,274,274,1411
2006,42140,4099,4447,49391,48793,519,11.7,482,10.9,7816,3101,4715,6.4,16,6620,2562,4058,5.3,13.6,1196,2.4,27.2,0,320,320,1729
2007,42140,4149,4502,49783,49383,534,11.9,469,10.5,8056,3161,4895,6.4,16.3,7256,2328,4928,4.7,14.7,800,1.6,29.4,0,282,282,1417
2008,42140,4129,4474,49645,49475,455,10.2,444,9.9,8294,3322,4972,6.7,16.8,7954,2832,5122,5.7,16.1,340,0.7,32.2,0,287,287,1894
2009,42140,3914,4270,45847,47524,368,8.4,511,11.7,5725,2297,3428,4.8,12,9078,2140,6938,4.5,19.1,-3353,-7.1,24,0,346,346,1386
2010,42140,3786,4145,43791,44816,384,9.1,490,11.7,5171,1984,3187,4.4,11.5,7221,2301,4920,5.1,16.1,-2050,-4.6,23,0,318,318,1710
2011,42140,3752,4127,44760,44129,431,10.5,417,10.1,6176,2527,3649,5.7,14,4913,1664,3249,3.8,11.1,1263,2.9,22.2,0,265,265,1047
2012,42140,3761,4123,43772,44221,409,9.9,421,10.2,5775,2558,3217,5.8,13.1,6672,2329,4343,5.3,15.1,-897,-2,26.2,0,240,246,1290
2013,42140,3766,4125,44321,43815,377,9.2,381,9.3,6113,2260,3853,5.2,14,5101,1863,3238,4.3,11.6,1012,2.4,23.2,0,230,230,1241
2014,42140,3760,4106,44720,44192,387,9.4,377,9.2,5834,2285,3549,5.2,13.2,4777,1572,3205,3.6,10.8,1057,2.4,21.6,0,267,267,1010
1977,42220,5482,5879,57404,54106,1286,22.9,743,13.2,15096,7150,7946,13.2,27.9,8499,3758,4741,6.9,15.7,6597,12.2,31.4,0,490,490,2310
1978,42220,5772,6169,64962,61168,1251,20.8,947,15.7,18917,7259,11658,11.9,30.9,11328,5602,5726,9.2,18.5,7589,12.4,37,0,549,550,2372
1979,42220,6196,6608,72534,68626,1368,21.4,860,13.5,19477,8721,10756,12.7,28.4,11661,5142,6519,7.5,17,7816,11.4,34,0,597,599,3046
1980,42220,6500,6928,74993,73622,1264,18.7,892,13.2,16127,7119,9008,9.7,21.9,13384,5199,8185,7.1,18.2,2743,3.7,36.4,0,611,611,2984
1981,42220,6400,6808,74354,74360,1113,16.2,1118,16.3,15244,7496,7748,10.1,20.5,15256,6666,8590,9,20.5,-12,0,41,0,674,676,2899
1982,42220,6574,7101,88889,81325,1337,19.2,908,13,29150,20365,8785,25,35.8,14021,5454,8567,6.7,17.2,15129,18.6,34.4,0,488,489,3002
1983,42220,6853,7394,77038,83125,1141,15.7,922,12.7,14591,6386,8205,7.7,17.6,26764,5539,21225,6.7,32.2,-12173,-14.6,35.2,0,584,585,3023
1984,42220,7431,7986,89844,83589,1452,18.9,866,11.3,25749,11865,13884,14.2,30.8,13239,7746,5493,9.3,15.8,12510,15,31.6,0,538,538,2576
1985,42220,7939,8514,93135,91878,1459,17.7,947,11.5,20564,9579,10985,10.4,22.4,18050,5994,12056,6.5,19.6,2514,2.8,39.2,0,603,605,3507
1986,42220,8340,8945,98278,95562,1511,17.3,1003,11.5,21267,9473,11794,9.9,22.3,15834,6159,9675,6.4,16.6,5433,5.7,33.2,0,645,645,3628
1987,42220,8730,9413,109009,104780,1656,18,1137,12.4,25439,10542,14897,10.1,24.3,16980,7509,9471,7.2,16.2,8459,8.1,32.4,0,762,767,4787
1988,42220,8873,9602,114075,111236,1421,15,1161,12.2,22787,8539,14248,7.7,20.5,17109,6614,10495,5.9,15.4,5678,5.1,30.8,0,790,790,3581
1989,42220,8627,9412,117248,116675,1520,16,1691,17.8,24190,10166,14024,8.7,20.7,23044,11669,11375,10,19.8,1146,0.9,39.6,0,813,816,4632
1990,42220,9640,10429,130526,123723,2024,20.4,928,9.4,31183,13895,17288,11.2,25.2,17576,5938,11638,4.8,14.2,13607,11,28.4,0,597,603,3233
1991,42220,9912,10760,125797,127907,1586,15,1204,11.4,21737,9092,12645,7.1,17,25957,8929,17028,7,20.3,-4220,-3.3,34,0,757,757,5507
1992,42220,9765,10636,124385,124957,1393,13,1387,13,21350,8313,13037,6.7,17.1,22493,7371,15122,5.9,18,-1143,-0.9,34.2,0,912,920,4261
1993,42220,9728,10600,126539,125188,1279,12,1245,11.7,22924,8881,14043,7.1,18.3,20222,8194,12028,6.5,16.2,2702,2.1,32.4,0,788,795,4227
1994,42220,9733,10625,128696,127429,1365,12.9,1239,11.7,25474,12639,12835,9.9,20,22939,10237,12702,8,18,2535,2,36,0,855,856,4075
1995,42220,9784,10727,129503,129057,1340,12.6,1158,10.9,20943,7670,13273,5.9,16.2,20050,6302,13748,4.9,15.5,893,0.7,31,0,815,818,3921
1996,42220,9924,10883,135879,132520,1361,12.6,1156,10.7,24615,8173,16442,6.2,18.6,17897,6361,11536,4.8,13.5,6718,5.1,27,0,776,776,3410
1997,42220,10079,11103,142130,139025,1447,13.1,1211,11,27623,9515,18108,6.8,19.9,21412,7682,13730,5.5,15.4,6211,4.5,30.8,0,732,732,4165
1998,42220,10243,11296,150722,146592,1399,12.5,1174,10.5,30156,12450,17706,8.5,20.6,21896,8932,12964,6.1,14.9,8260,5.7,29.8,0,783,783,4802
1999,42220,10451,11547,156964,154048,1453,12.7,1207,10.6,28487,10967,17520,7.1,18.5,22655,9825,12830,6.4,14.7,5832,3.8,29.4,0,796,796,4884
2000,42220,10571,11682,160759,158892,1329,11.4,1213,10.4,28440,9368,19072,5.9,17.9,24705,9041,15664,5.7,15.5,3735,2.4,31,0,772,772,4019
2001,42220,10775,11941,170593,166203,1451,12.2,1357,11.4,31380,11467,19913,6.9,18.9,22600,8055,14545,4.8,13.6,8780,5.3,27.2,0,802,802,4289
2002,42220,10876,12043,164619,167514,1609,13.4,1471,12.3,28776,13216,15560,7.9,17.2,34566,10702,23864,6.4,20.6,-5790,-3.4,34.4,0,840,840,4591
2003,42220,10853,12051,159731,160024,1515,12.6,1264,10.5,26586,11399,15187,7.1,16.6,27172,8454,18718,5.3,17,-586,-0.4,33.2,0,857,871,4606
2004,42220,10896,12121,165859,162285,1399,11.6,1204,10,29792,13831,15961,8.5,18.4,22644,8177,14467,5,14,7148,4.4,28,0,806,806,4127
2005,42220,11077,12370,166719,165994,1483,12.1,1153,9.4,25689,8981,16708,5.4,15.5,24238,8231,16007,5,14.6,1451,0.9,29.2,0,823,823,4254
2006,42220,11112,12450,170463,168376,1480,11.9,1296,10.5,26943,8771,18172,5.2,16,22769,7338,15431,4.4,13.5,4174,2.5,27,0,900,902,4630
2007,42220,11247,12595,170250,170052,1457,11.6,1252,10,25725,8775,16950,5.2,15.1,25328,7767,17561,4.6,14.9,397,0.2,29.8,0,805,812,4246
2008,42220,11108,12504,166961,168152,1271,10.2,1251,10,22340,7754,14586,4.6,13.3,24722,7644,17078,4.5,14.7,-2382,-1.4,26.6,0,902,902,5183
2009,42220,10599,11969,153175,159270,1045,8.6,1404,11.5,16124,6327,9797,4,10.1,28313,6843,21470,4.3,17.8,-12189,-7.7,20.2,0,973,975,4377
2010,42220,10321,11663,147877,150260,1008,8.5,1214,10.3,17660,5928,11732,3.9,11.8,22425,8070,14355,5.4,14.9,-4765,-3.1,23.6,0,777,777,3988
2011,42220,10281,11646,152741,150117,1133,9.7,1089,9.4,23288,7969,15319,5.3,15.5,18039,6001,12038,4,12,5249,3.5,24,0,723,724,3918
2012,42220,10412,11803,151131,151783,1211,10.3,1066,9.1,19585,6432,13153,4.2,12.9,20889,7662,13227,5,13.8,-1304,-0.9,25.8,0,670,672,3753
2013,42220,10451,11822,154954,153054,1077,9.1,1100,9.3,20918,6209,14709,4.1,13.7,17117,6164,10953,4,11.2,3801,2.5,22.4,0,695,697,3206
2014,42220,10574,11983,161600,157623,1317,11.1,1088,9.2,24535,10207,14328,6.5,15.6,16580,6171,10409,3.9,10.5,7955,5.1,21,0,767,767,3887
1977,42340,3935,4368,63170,65116,737,17.2,544,12.7,13026,5198,7828,8,20,16917,4812,12105,7.4,26,-3891,-6,40,0,389,389,3144
1978,42340,4003,4445,68754,65948,662,15,581,13.2,14926,4438,10488,6.7,22.6,9313,3749,5564,5.7,14.1,5613,8.5,28.2,0,420,421,1928
1979,42340,4083,4542,69924,69274,637,14.2,511,11.4,12047,4105,7942,5.9,17.4,10747,4005,6742,5.8,15.5,1300,1.9,31,0,382,382,2118
1980,42340,4058,4490,78393,74093,552,12.2,589,13,19846,3745,16101,5.1,26.8,11246,4498,6748,6.1,15.2,8600,11.6,30.4,0,396,403,2244
1981,42340,4051,4514,69608,73755,663,14.7,607,13.5,12188,5147,7041,7,16.5,20481,12756,7725,17.3,27.8,-8293,-11.3,33,0,389,391,1726
1982,42340,4088,4612,72282,70831,738,16.2,589,12.9,14182,5653,8529,8,20,11280,3534,7746,5,15.9,2902,4.1,31.8,0,341,341,1736
1983,42340,4221,4758,73582,72852,629,13.4,526,11.2,13961,5988,7973,8.2,19.2,12500,3882,8618,5.3,17.2,1461,2,34.4,0,370,371,1983
1984,42340,4379,4954,74395,73037,733,15.1,533,11,13790,5002,8788,6.8,18.9,11074,4851,6223,6.6,15.2,2716,3.7,30.4,0,332,332,2496
1985,42340,4533,5133,79330,77018,709,14.1,529,10.5,14118,5216,8902,6.8,18.3,9494,3512,5982,4.6,12.3,4624,6,24.6,0,347,348,1883
1986,42340,4671,5289,84889,82073,756,14.5,579,11.1,17598,7691,9907,9.4,21.4,11965,4637,7328,5.6,14.6,5633,6.8,29.2,0,371,371,1972
1987,42340,4750,5455,87952,86734,847,15.7,671,12.5,17669,7565,10104,8.7,20.4,15233,5289,9944,6.1,17.6,2436,2.8,35.2,0,432,432,2381
1988,42340,4776,5540,95268,91426,776,14.1,662,12,22132,11984,10148,13.1,24.2,14448,4670,9778,5.1,15.8,7684,8.4,31.6,0,430,430,2404
1989,42340,4836,5621,97260,96283,735,13.2,654,11.7,15307,5717,9590,5.9,15.9,13352,4448,8904,4.6,13.9,1955,2,27.8,0,434,434,2602
1990,42340,4856,5633,97668,97355,662,11.8,616,10.9,14439,4968,9471,5.1,14.8,13814,4705,9109,4.8,14.2,625,0.6,28.4,0,390,400,2320
1991,42340,4964,5806,92143,94833,747,13.1,578,10.1,15170,6388,8782,6.7,16,20550,9564,10986,10.1,21.7,-5380,-5.7,32,0,355,360,2731
1992,42340,5068,5919,96496,94357,733,12.5,613,10.4,18627,7205,11422,7.6,19.7,14349,5143,9206,5.5,15.2,4278,4.5,30.4,0,373,377,2483
1993,42340,5128,5967,97586,97041,656,11,599,10.1,15453,5022,10431,5.2,15.9,14363,4204,10159,4.3,14.8,1090,1.1,29.6,0,393,393,2013
1994,42340,5215,6058,99257,98389,714,11.9,601,10,15923,5380,10543,5.5,16.2,14186,4562,9624,4.6,14.4,1737,1.8,28.8,0,399,399,2805
1995,42340,5292,6140,102957,100987,732,12,623,10.2,16806,6259,10547,6.2,16.6,12865,4248,8617,4.2,12.7,3941,3.9,25.4,0,431,432,2513
1996,42340,5473,6334,104605,103822,841,13.5,642,10.3,16415,6609,9806,6.4,15.8,14849,6872,7977,6.6,14.3,1566,1.5,28.6,0,410,411,2637
1997,42340,5556,6470,107018,105853,834,13,705,11,18326,6548,11778,6.2,17.3,15995,4996,10999,4.7,15.1,2331,2.2,30.2,0,454,454,2520
1998,42340,5600,6548,108687,107556,834,12.8,735,11.3,17645,6857,10788,6.4,16.4,15383,5994,9389,5.6,14.3,2262,2.1,28.6,0,465,465,3073
1999,42340,5665,6625,110983,109915,807,12.2,720,10.9,18918,6531,12387,5.9,17.2,16782,6741,10041,6.1,15.3,2136,1.9,30.6,0,471,471,2816
2000,42340,5688,6665,115345,114181,829,12.5,788,11.9,19442,8341,11101,7.3,17,17114,7471,9643,6.5,15,2328,2,30,0,452,452,3145
2001,42340,5738,6782,119621,117936,877,13,815,12.1,20734,8984,11750,7.6,17.6,17363,6514,10849,5.5,14.7,3371,2.9,29.4,0,454,454,2984
2002,42340,5839,6885,122055,120747,924,13.5,813,11.9,21708,10069,11639,8.3,18,19092,6502,12590,5.4,15.8,2616,2.2,31.6,0,428,429,2463
2003,42340,5872,6873,124537,122483,812,11.9,659,9.7,19669,6853,12816,5.6,16.1,15561,5068,10493,4.1,12.7,4108,3.4,25.4,0,424,424,2160
2004,42340,5954,6964,127953,125255,801,11.6,623,9,22523,6921,15602,5.5,18,17127,5134,11993,4.1,13.7,5396,4.3,27.4,0,427,427,2620
2005,42340,6214,7275,127807,127255,951,13.4,614,8.6,20716,9031,11685,7.1,16.3,19612,7693,11919,6,15.4,1104,0.9,30.8,0,414,414,5087
2006,42340,6401,7502,136508,132723,975,13.2,687,9.3,23568,9714,13854,7.3,17.8,15998,5930,10068,4.5,12.1,7570,5.7,24.2,0,459,459,3227
2007,42340,6651,7822,140206,138181,1068,14,746,9.7,24966,10352,14614,7.5,18.1,20915,7383,13532,5.3,15.1,4051,3,30.2,0,494,496,4632
2008,42340,6585,7788,140621,140085,870,11.2,807,10.4,21117,8268,12849,5.9,15.1,20045,6457,13588,4.6,14.3,1072,0.8,28.6,0,575,575,3984
2009,42340,6372,7591,130697,134165,714,9.3,807,10.5,18782,6444,12338,4.8,14,25717,8589,17128,6.4,19.2,-6935,-5.2,28,0,592,593,5890
2010,42340,6292,7513,128056,129217,685,9.1,744,9.9,15588,6004,9584,4.6,12.1,17910,3975,13935,3.1,13.9,-2322,-1.8,24.2,0,476,477,2577
2011,42340,6259,7500,131756,129685,717,9.6,670,9,19537,8397,11140,6.5,15.1,15395,5775,9620,4.5,11.9,4142,3.2,23.8,0,451,453,2834
2012,42340,6316,7568,132700,132184,761,10.1,693,9.2,19677,7617,12060,5.8,14.9,18645,4260,14385,3.2,14.1,1032,0.8,28.2,0,427,428,2022
2013,42340,6435,7685,135626,133823,759,10,627,8.3,17149,5122,12027,3.8,12.8,13543,4676,8867,3.5,10.1,3606,2.7,20.2,0,400,400,2595
2014,42340,6548,7857,143003,138654,868,11.2,642,8.3,22281,8207,14074,5.9,16.1,13583,3874,9709,2.8,9.8,8698,6.3,19.6,0,455,457,2429
1977,42540,9333,10400,182591,177107,1297,12.5,1178,11.4,36731,11162,25569,6.3,20.7,25762,11563,14199,6.5,14.5,10969,6.2,29,0,724,726,5727
1978,42540,9486,10562,179498,181074,1296,12.4,1124,10.7,31574,10878,20696,6,17.4,34726,11133,23593,6.1,19.2,-3152,-1.8,34.8,0,773,776,6292
1979,42540,9415,10577,181378,180320,1161,11,1090,10.3,27644,9115,18529,5.1,15.3,25528,9388,16140,5.2,14.2,2116,1.1,28.4,0,760,760,3864
1980,42540,9247,10421,178138,179696,1040,9.9,1143,10.9,23229,7728,15501,4.3,12.9,26346,7966,18380,4.4,14.7,-3117,-1.8,25.8,0,809,812,4052
1981,42540,8830,9906,172173,174282,901,8.9,1316,13,23362,9734,13628,5.6,13.4,27581,12877,14704,7.4,15.8,-4219,-2.4,26.8,0,759,763,5382
1982,42540,8701,9903,172499,172431,1117,11.3,984,9.9,23132,9747,13385,5.7,13.4,22996,7196,15800,4.2,13.3,136,0.1,26.6,0,563,564,3347
1983,42540,8937,10126,172434,172675,978,9.8,891,8.9,23217,8627,14590,5,13.4,23698,7165,16533,4.1,13.7,-481,-0.3,26.8,0,574,574,4004
1984,42540,9064,10286,181364,176776,1101,10.8,934,9.2,28821,8610,20211,4.9,16.3,19645,7135,12510,4,11.1,9176,5.2,22.2,0,580,582,4042
1985,42540,9230,10478,182493,182133,1134,10.9,950,9.1,25601,8971,16630,4.9,14.1,24880,8830,16050,4.8,13.7,721,0.4,27.4,0,641,645,5697
1986,42540,9454,10778,190662,186455,1264,11.9,926,8.7,32574,11811,20763,6.3,17.5,24159,9148,15011,4.9,13,8415,4.5,26,0,602,604,4871
1987,42540,9734,11209,197846,195950,1492,13.5,1059,9.6,33117,13833,19284,7.1,16.9,29324,11284,18040,5.8,15,3793,1.9,30,0,705,711,5805
1988,42540,9987,11530,204157,200779,1404,12.4,1042,9.2,31975,11209,20766,5.6,15.9,25218,9589,15629,4.8,12.6,6757,3.3,25.2,0,702,702,4645
1989,42540,10214,11843,210688,207664,1345,11.5,1044,8.9,32775,12326,20449,5.9,15.8,26726,10084,16642,4.9,12.9,6049,2.9,25.8,0,735,737,5139
1990,42540,10411,12073,213351,215773,1262,10.6,964,8.1,28597,9181,19416,4.3,13.3,33441,8149,25292,3.8,15.5,-4844,-2.2,26.6,0,679,680,4839
1991,42540,10521,12252,211169,212163,1241,10.2,1047,8.6,27566,11980,15586,5.6,13,29554,9258,20296,4.4,13.9,-1988,-0.9,26,0,679,681,5317
1992,42540,10337,12120,209437,209729,1149,9.4,1215,10,30405,11217,19188,5.3,14.5,30989,10406,20583,5,14.8,-584,-0.3,29,0,806,817,6727
1993,42540,10230,12029,208653,208893,978,8.1,1019,8.4,27677,8219,19458,3.9,13.2,28157,10118,18039,4.8,13.5,-480,-0.3,26.4,0,721,727,4679
1994,42540,10182,12037,209686,209230,1074,8.9,1024,8.5,28941,9399,19542,4.5,13.8,28028,9146,18882,4.4,13.4,913,0.4,26.8,0,713,717,5049
1995,42540,10298,12151,213599,210881,1220,10.1,1079,8.9,32234,12542,19692,5.9,15.3,26797,10552,16245,5,12.7,5437,2.6,25.4,0,667,670,4184
1996,42540,10291,12155,214062,214246,1086,8.9,1076,8.9,26279,9291,16988,4.3,12.3,26647,8139,18508,3.8,12.4,-368,-0.1,24.6,0,689,689,3514
1997,42540,10403,12342,221081,217580,1265,10.3,1089,8.9,34856,12908,21948,5.9,16,27854,9388,18466,4.3,12.8,7002,3.2,25.6,0,688,688,4288
1998,42540,10449,12411,221956,221435,1134,9.2,1052,8.5,30931,10091,20840,4.6,14,29888,11163,18725,5,13.5,1043,0.5,27,0,706,706,4270
1999,42540,10352,12368,220676,221312,1022,8.2,1050,8.5,27907,9837,18070,4.4,12.6,29178,9980,19198,4.5,13.2,-1271,-0.6,25.2,0,671,671,5901
2000,42540,10291,12392,226819,223656,1081,8.7,1054,8.5,33204,11998,21206,5.4,14.8,26877,11397,15480,5.1,12,6327,2.8,24,0,671,671,4217
2001,42540,10334,12456,230860,229176,1132,9.1,1169,9.4,35400,17450,17950,7.6,15.4,32032,11007,21025,4.8,14,3368,1.4,28,0,660,660,4799
2002,42540,10217,12309,225080,227826,1184,9.6,1313,10.6,33720,14602,19118,6.4,14.8,39212,15443,23769,6.8,17.2,-5492,-2.4,29.6,0,645,646,5192
2003,42540,10190,12302,222047,222344,1080,8.8,908,7.4,28561,11394,17167,5.1,12.8,29154,10357,18797,4.7,13.1,-593,-0.3,25.6,0,594,594,4382
2004,42540,10263,12421,227921,224430,1148,9.3,929,7.5,31958,9050,22908,4,14.2,24975,7599,17376,3.4,11.1,6983,3.1,22.2,0,602,604,4019
2005,42540,10377,12636,229293,228331,1213,9.7,948,7.6,27807,10945,16862,4.8,12.2,25882,6921,18961,3,11.3,1925,0.9,22.6,0,641,641,3908
2006,42540,10260,12577,233941,231562,1176,9.3,1147,9.1,31840,11984,19856,5.2,13.8,27082,11946,15136,5.2,11.7,4758,2.1,23.4,0,770,780,7714
2007,42540,10309,12642,233373,233476,1110,8.8,1028,8.2,30511,9943,20568,4.3,13.1,30716,11735,18981,5,13.2,-205,-0.1,26.2,0,615,618,4667
2008,42540,10175,12559,235738,233823,980,7.8,943,7.5,30605,8260,22345,3.5,13.1,26775,8045,18730,3.4,11.5,3830,1.6,23,0,660,660,5602
2009,42540,9922,12257,229007,231780,836,6.8,1031,8.3,25945,8822,17123,3.8,11.2,31491,8046,23445,3.5,13.6,-5546,-2.4,22.4,0,648,654,3870
2010,42540,9835,12140,225197,226799,890,7.3,955,7.8,23905,8022,15883,3.5,10.5,27109,7509,19600,3.3,12,-3204,-1.5,21,0,608,608,4114
2011,42540,9703,12046,225500,224619,925,7.7,934,7.7,26168,8264,17904,3.7,11.6,24406,6244,18162,2.8,10.9,1762,0.7,21.8,0,621,622,3495
2012,42540,9807,12159,232596,228379,1019,8.4,912,7.5,32019,9827,22192,4.3,14,23584,6884,16700,3,10.3,8435,3.7,20.6,0,564,569,3578
2013,42540,9786,12171,237335,234950,864,7.1,848,7,29178,8933,20245,3.8,12.4,24407,7152,17255,3,10.4,4771,2,20.8,0,555,555,4867
2014,42540,9692,12093,239604,237883,922,7.6,898,7.4,27913,7770,20143,3.3,11.7,24470,6045,18425,2.5,10.3,3443,1.4,20.6,0,612,617,4156
1977,42660,34809,40592,603401,574891,8000,20.4,5220,13.3,142660,62993,79667,11,24.8,85640,35877,49763,6.2,14.9,57020,9.9,29.8,0,3352,3369,20698
1978,42660,36720,42754,719008,661087,7854,18.8,5668,13.6,208516,60307,148209,9.1,31.5,92674,42416,50258,6.4,14,115842,17.5,28,0,3541,3553,22841
1979,42660,38809,44976,711492,714522,8109,18.5,5534,12.6,169765,56078,113687,7.8,23.8,175825,65289,110536,9.1,24.6,-6060,-0.8,47.6,0,3787,3801,20399
1980,42660,39635,46081,747841,728934,7407,16.3,5968,13.1,155666,55254,100412,7.6,21.4,117854,43046,74808,5.9,16.2,37812,5.2,32.4,0,4164,4179,24285
1981,42660,39238,45684,742485,742960,7027,15.3,6935,15.1,141458,61808,79650,8.3,19,142408,51393,91015,6.9,19.2,-950,-0.2,38,0,4142,4158,22967
1982,42660,40193,47580,736823,739659,8203,17.6,5712,12.2,132338,63117,69221,8.5,17.9,138009,42213,95796,5.7,18.7,-5671,-0.8,35.8,0,3140,3155,18919
1983,42660,42104,49584,752877,743082,7123,14.7,5579,11.5,153702,77385,76317,10.4,20.7,134112,38939,95173,5.2,18,19590,2.7,36,0,3537,3565,20226
1984,42660,44596,52313,793674,772574,8403,16.5,5735,11.3,161029,60638,100391,7.8,20.8,118828,40311,78517,5.2,15.4,42201,5.4,30.8,0,3777,3780,20530
1985,42660,45820,53706,823577,809866,8068,15.2,6674,12.6,156566,56805,99761,7,19.3,129143,52096,77047,6.4,15.9,27423,3.4,31.8,0,4274,4287,24428
1986,42660,47620,55698,875134,849509,8995,16.4,6757,12.4,186996,71519,115477,8.4,22,135746,56839,78907,6.7,16,51250,6,32,0,4304,4336,27901
1987,42660,49251,58171,902762,880081,10000,17.5,7251,12.7,190809,79156,111653,9,21.7,145446,59950,85496,6.8,16.5,45363,5.2,33,0,4620,4662,31976
1988,42660,50113,59547,949784,922335,9095,15.5,7351,12.5,203337,72381,130956,7.8,22,148440,57507,90933,6.2,16.1,54897,5.9,32.2,0,4758,4759,27880
1989,42660,43121,52793,975682,962962,7523,13.4,14179,25.2,227364,74734,152630,7.8,23.6,201925,119996,81929,12.5,21,25439,2.6,42,0,4662,4686,32059
1990,42660,53465,63630,1092730,1034043,16396,28.2,5273,9.1,282355,144375,137980,14,27.3,164981,84241,80740,8.1,16,117374,11.3,32,0,3327,3341,46477
1991,42660,55387,66308,1102822,1101955,9732,15,7025,10.8,200194,74277,125917,6.7,18.2,198462,71507,126955,6.5,18,1732,0.2,36,0,4357,4397,30274
1992,42660,56941,68333,1126218,1112494,10219,15.2,7739,11.5,225862,74148,151714,6.7,20.3,198414,75154,123260,6.8,17.8,27448,2.5,35.6,0,4872,4914,31774
1993,42660,58471,69611,1148079,1147139,9296,13.5,7713,11.2,186598,66370,120228,5.8,16.3,184718,63560,121158,5.5,16.1,1880,0.2,32.2,0,4939,4981,30084
1994,42660,59770,71095,1152181,1149420,9698,13.8,7857,11.2,184775,67214,117561,5.8,16.1,179253,53587,125666,4.7,15.6,5522,0.5,31.2,0,5150,5164,27323
1995,42660,60911,72402,1184752,1168734,9992,13.9,8283,11.5,198771,74632,124139,6.4,17,166735,60738,105997,5.2,14.3,32036,2.7,28.6,0,5543,5582,33948
1996,42660,62099,73959,1207452,1196380,10377,14.2,8635,11.8,195463,73979,121484,6.2,16.3,173319,59393,113926,5,14.5,22144,1.8,29,0,5659,5661,32376
1997,42660,63280,75599,1245068,1227275,11084,14.8,9467,12.6,250327,87721,162606,7.1,20.4,214740,105161,109579,8.6,17.5,35587,2.9,35,0,5709,5709,36567
1998,42660,64379,77120,1303335,1273670,10469,13.7,8750,11.5,237170,82568,154602,6.5,18.6,177840,66665,111175,5.2,14,59330,4.6,28,0,5692,5692,32560
1999,42660,64847,77988,1352955,1329237,10253,13.2,9213,11.9,242203,96722,145481,7.3,18.2,194767,76364,118403,5.7,14.7,47436,3.5,29.4,0,5815,5815,38151
2000,42660,65063,78561,1414692,1385782,10006,12.8,9486,12.1,266488,98107,168381,7.1,19.2,208669,77479,131190,5.6,15.1,57819,4.1,30.2,0,5746,5759,32635
2001,42660,65421,79635,1426595,1422590,10142,12.8,9674,12.2,246755,92968,153787,6.5,17.3,238746,84750,153996,6,16.8,8009,0.5,33.6,0,5654,5658,42867
2002,42660,65068,79421,1370649,1395193,10775,13.6,10772,13.6,242827,120707,122120,8.7,17.4,291915,91748,200167,6.6,20.9,-49088,-3.5,34.8,0,5843,5862,39926
2003,42660,65790,80100,1368255,1360298,10436,13.1,8212,10.3,222821,78527,144294,5.8,16.4,206907,68425,138482,5,15.2,15914,1.2,30.4,0,5397,5412,30371
2004,42660,66953,81533,1401866,1381891,10387,12.9,8140,10.1,224342,83824,140518,6.1,16.2,184391,57168,127223,4.1,13.3,39951,2.9,26.6,0,5360,5367,31519
2005,42660,68980,84076,1435305,1414573,11428,13.8,8148,9.9,233158,85864,147294,6.1,16.5,191694,65813,125881,4.7,13.6,41464,2.9,27.2,0,5398,5402,33637
2006,42660,70365,86021,1486614,1457436,11692,13.8,8950,10.5,253706,89038,164668,6.1,17.4,195350,65722,129628,4.5,13.4,58356,4,26.8,0,5980,5984,39882
2007,42660,72379,88546,1551736,1517232,11851,13.6,9180,10.5,273899,89886,184013,5.9,18.1,204891,75863,129028,5,13.5,69008,4.6,27,0,5677,5700,33415
2008,42660,72849,89432,1566208,1554856,10715,12.1,9025,10.2,222301,69351,152950,4.5,14.3,199596,64784,134812,4.2,12.8,22705,1.5,25.6,0,6317,6318,40939
2009,42660,69762,86486,1482698,1519821,8665,9.9,10684,12.2,206806,62719,144087,4.1,13.6,281053,70793,210260,4.7,18.5,-74247,-4.9,27.2,0,7121,7134,37956
2010,42660,68743,85379,1423324,1449818,8651,10.1,9127,10.7,168264,68319,99945,4.7,11.6,221252,57758,163494,4,15.3,-52988,-3.7,23.2,0,5886,5909,30950
2011,42660,67901,84634,1410011,1413507,8921,10.5,8970,10.6,205867,62150,143717,4.4,14.6,212858,82185,130673,5.8,15.1,-6991,-0.5,29.2,0,5811,5820,31632
2012,42660,68814,85546,1437769,1421800,9591,11.3,8694,10.2,203759,65000,138759,4.6,14.3,171821,51683,120138,3.6,12.1,31938,2.2,24.2,0,5100,5134,26430
2013,42660,70139,86815,1487167,1460697,9370,10.9,8064,9.4,206307,65091,141216,4.5,14.1,153368,56763,96605,3.9,10.5,52939,3.6,21,0,5124,5138,26431
2014,42660,71311,88177,1543501,1511726,9661,11.1,7754,8.9,213717,64510,149207,4.3,14.1,150167,48373,101794,3.2,9.9,63550,4.2,19.8,0,5292,5330,28587
1977,42680,1145,1210,13887,13375,243,20.6,167,14.2,3355,1491,1864,11.1,25.1,2330,1436,894,10.7,17.4,1025,7.7,34.8,0,127,127,1039
1978,42680,1217,1285,15524,14708,241,19.3,166,13.3,4038,1764,2274,12,27.5,2406,1205,1201,8.2,16.4,1632,11.1,32.8,0,117,117,824
1979,42680,1275,1346,17099,16288,244,18.6,170,12.9,3886,1529,2357,9.4,23.9,2263,927,1336,5.7,13.9,1623,10,27.8,0,132,132,628
1980,42680,1401,1482,17548,17343,295,20.9,156,11,3980,2350,1630,13.6,22.9,3569,926,2643,5.3,20.6,411,2.3,41.2,0,115,116,590
1981,42680,1467,1560,18416,17912,295,19.4,200,13.2,4035,2102,1933,11.7,22.5,3027,927,2100,5.2,16.9,1008,5.6,33.8,0,137,137,629
1982,42680,1579,1688,18321,18381,338,20.8,205,12.6,3494,1668,1826,9.1,19,3613,1346,2267,7.3,19.7,-119,-0.7,38,0,116,116,818
1983,42680,1627,1737,20239,20633,283,16.5,237,13.8,3526,1666,1860,8.1,17.1,4314,1705,2609,8.3,20.9,-788,-3.8,34.2,0,136,136,848
1984,42680,1714,1826,21651,20901,327,18.4,236,13.2,4640,2207,2433,10.6,22.2,3140,1207,1933,5.8,15,1500,7.2,30,0,162,162,772
1985,42680,1838,1961,22928,22325,363,19.2,233,12.3,5380,2174,3206,9.7,24.1,4173,1928,2245,8.6,18.7,1207,5.4,37.4,0,154,154,966
1986,42680,1952,2083,25301,24082,370,18.3,241,11.9,6874,3504,3370,14.6,28.5,4435,1331,3104,5.5,18.4,2439,10.1,36.8,0,155,155,979
1987,42680,2033,2186,25130,25196,415,19.4,295,13.8,6362,3253,3109,12.9,25.3,6494,2052,4442,8.1,25.8,-132,-0.5,50.6,0,205,205,1315
1988,42680,2158,2307,26599,25859,383,17.1,255,11.4,5460,2231,3229,8.6,21.1,3979,1341,2638,5.2,15.4,1481,5.7,30.8,0,180,180,864
1989,42680,2248,2406,28273,27464,379,16.1,279,11.8,6351,1895,4456,6.9,23.1,4733,1917,2816,7,17.2,1618,5.9,34.4,0,197,197,1011
1990,42680,2364,2525,28527,28344,393,15.9,252,10.2,5321,2122,3199,7.5,18.8,4955,1555,3400,5.5,17.5,366,1.3,35,0,191,191,994
1991,42680,2391,2564,28085,28219,323,12.7,277,10.9,5007,2144,2863,7.6,17.7,5275,1414,3861,5,18.7,-268,-1,35.4,0,188,188,840
1992,42680,2440,2618,27676,27892,369,14.2,298,11.5,4570,1891,2679,6.8,16.4,5001,1808,3193,6.5,17.9,-431,-1.5,32.8,0,207,207,1129
1993,42680,2492,2654,27932,27780,347,13.2,300,11.4,4605,1713,2892,6.2,16.6,4300,1670,2630,6,15.5,305,1.1,31,0,220,221,1130
1994,42680,2544,2711,29189,28479,352,13.1,280,10.4,5085,1972,3113,6.9,17.9,3665,1238,2427,4.3,12.9,1420,5,25.8,0,199,200,715
1995,42680,2675,2859,31144,30240,436,15.7,292,10.5,6051,2904,3147,9.6,20,4242,1929,2313,6.4,14,1809,6,28,0,223,223,1082
1996,42680,2718,2908,32161,31685,377,13.1,321,11.1,6164,3218,2946,10.2,19.5,5211,2071,3140,6.5,16.4,953,3.1,32.8,0,224,224,1431
1997,42680,2795,3013,35292,33711,467,15.8,359,12.1,8584,3709,4875,11,25.5,5421,2518,2903,7.5,16.1,3163,9.4,32.2,0,254,254,1519
1998,42680,2778,3024,37112,36071,373,12.4,348,11.5,6886,2648,4238,7.3,19.1,4804,2000,2804,5.5,13.3,2082,5.8,26.6,0,245,245,1100
1999,42680,2801,3058,37422,37247,393,12.9,355,11.7,5969,2257,3712,6.1,16,5618,2565,3053,6.9,15.1,351,0.9,30.2,0,243,243,1275
2000,42680,2756,3015,38508,37984,358,11.8,407,13.4,6505,2198,4307,5.8,17.1,5457,2662,2795,7,14.4,1048,2.7,28.8,0,276,276,1454
2001,42680,2753,3011,39810,39214,388,12.9,410,13.6,7162,2301,4861,5.9,18.3,5969,3045,2924,7.8,15.2,1193,3.1,30.4,0,247,247,1293
2002,42680,2840,3088,39226,39450,448,14.7,371,12.2,8018,4620,3398,11.7,20.3,8466,4833,3633,12.3,21.5,-448,-1.2,40.6,0,205,205,1206
2003,42680,2939,3191,39291,38886,457,14.6,312,10,7704,3230,4474,8.3,19.8,6894,2675,4219,6.9,17.7,810,2.1,35.4,0,223,223,1516
2004,42680,3079,3333,41097,40127,521,16,342,10.5,7549,3178,4371,7.9,18.8,5608,2293,3315,5.7,14,1941,4.8,28,0,253,254,1647
2005,42680,3179,3437,41136,40615,512,15.2,358,10.6,6752,3170,3582,7.8,16.6,5710,1714,3996,4.2,14.1,1042,2.5,28.2,0,252,252,1393
2006,42680,3284,3553,42996,42001,523,15,370,10.6,7810,3169,4641,7.5,18.6,5820,2426,3394,5.8,13.9,1990,4.7,27.8,0,267,267,1609
2007,42680,3318,3602,45344,44039,482,13.5,404,11.3,9516,6090,3426,13.8,21.6,6906,2282,4624,5.2,15.7,2610,5.9,31.4,0,269,269,1349
2008,42680,3262,3563,43722,44376,431,12.1,442,12.4,5465,2342,3123,5.3,12.3,6773,1944,4829,4.4,15.3,-1308,-3,24.6,0,344,344,1453
2009,42680,3121,3415,39885,41674,322,9.3,434,12.5,4393,2047,2346,4.9,10.5,7971,2056,5915,4.9,19.1,-3578,-8.6,21,0,299,304,1390
2010,42680,3102,3369,37934,38769,334,9.9,351,10.4,4392,1899,2493,4.9,11.3,6061,1400,4661,3.6,15.6,-1669,-4.3,22.6,0,232,232,909
2011,42680,3080,3352,38646,38207,358,10.7,349,10.4,5258,2429,2829,6.4,13.8,4380,1372,3008,3.6,11.5,878,2.3,23,0,238,241,898
2012,42680,3169,3451,40079,39364,395,11.6,303,8.9,5781,2523,3258,6.4,14.7,4351,1636,2715,4.2,11.1,1430,3.6,22.2,0,202,203,1153
2013,42680,3200,3483,40060,40099,338,9.8,319,9.2,4626,1459,3167,3.6,11.5,4703,1536,3167,3.8,11.7,-77,-0.2,23,0,211,211,1064
2014,42680,3234,3537,38980,38739,395,11.3,323,9.2,5214,2033,3181,5.2,13.5,4731,2395,2336,6.2,12.2,483,1.3,24.4,0,230,230,1515
1977,43100,1687,1786,34421,33547,201,11.4,148,8.4,4662,1256,3406,3.7,13.9,2913,1056,1857,3.1,8.7,1749,5.2,17.4,0,101,102,484
1978,43100,1762,1862,38258,36340,228,12.5,152,8.3,6021,2139,3882,5.9,16.6,2184,745,1439,2.1,6,3837,10.6,12,0,109,109,428
1979,43100,1787,1901,39267,38690,188,10,142,7.5,4748,1207,3541,3.1,12.3,3594,615,2979,1.6,9.3,1154,3,18.6,0,113,113,502
1980,43100,1773,1889,38650,38955,169,8.9,174,9.2,3633,1365,2268,3.5,9.3,4243,1134,3109,2.9,10.9,-610,-1.6,18.6,0,124,124,705
1981,43100,1719,1834,36898,37490,139,7.5,183,9.8,3472,814,2658,2.2,9.3,4655,1785,2870,4.8,12.4,-1183,-3.1,18.6,0,107,107,784
1982,43100,1717,1862,36253,36555,209,11.3,136,7.4,3684,1668,2016,4.6,10.1,4288,620,3668,1.7,11.7,-604,-1.6,20.2,0,89,89,366
1983,43100,1737,1882,36712,36507,142,7.6,162,8.7,4892,1213,3679,3.3,13.4,4481,1085,3396,3,12.3,411,1.1,24.6,0,103,103,461
1984,43100,1799,1947,37655,37171,205,10.7,140,7.3,4800,1166,3634,3.1,12.9,3832,974,2858,2.6,10.3,968,2.6,20.6,0,91,91,444
1985,43100,1820,1966,38564,38115,185,9.5,164,8.4,4518,1266,3252,3.3,11.9,3619,861,2758,2.3,9.5,899,2.4,19,0,115,116,458
1986,43100,1761,1900,37459,37811,179,9.3,221,11.4,3799,989,2810,2.6,10,4502,1821,2681,4.8,11.9,-703,-1.9,20,0,119,119,694
1987,43100,1868,2027,39847,38786,247,12.6,138,7,5608,2177,3431,5.6,14.5,3486,1170,2316,3,9,2122,5.5,18,0,48,49,497
1988,43100,1846,2025,41925,40886,178,8.8,172,8.5,6429,2316,4113,5.7,15.7,4350,1146,3204,2.8,10.6,2079,5.1,21.2,0,128,128,448
1989,43100,1861,2047,45116,43428,201,9.9,173,8.5,6619,1848,4771,4.3,15.2,3243,1035,2208,2.4,7.5,3376,7.7,15,0,118,118,516
1990,43100,1874,2081,43865,44475,182,8.8,141,6.8,4833,1500,3333,3.4,10.9,6052,1916,4136,4.3,13.6,-1219,-2.7,21.8,0,92,92,563
1991,43100,1912,2145,43969,43778,215,10.2,150,7.1,4911,1922,2989,4.4,11.2,4529,1016,3513,2.3,10.3,382,0.9,20.6,0,97,98,565
1992,43100,1919,2168,44560,44407,211,9.8,181,8.4,4867,1605,3262,3.6,11,4560,1453,3107,3.3,10.3,307,0.7,20.6,0,113,115,762
1993,43100,1938,2181,46205,45369,191,8.8,172,7.9,6527,1842,4685,4.1,14.4,4854,2107,2747,4.6,10.7,1673,3.7,21.4,0,108,112,1018
1994,43100,1961,2218,49549,47870,197,9,160,7.3,6837,2886,3951,6,14.3,3478,1215,2263,2.5,7.3,3359,7,14.6,0,113,113,663
1995,43100,2019,2273,49813,49643,215,9.6,151,6.7,5067,1025,4042,2.1,10.2,4727,778,3949,1.6,9.5,340,0.7,19,0,113,118,482
1996,43100,2049,2296,51111,50488,229,10,199,8.7,6057,2560,3497,5.1,12,4810,1697,3113,3.4,9.5,1247,2.5,19,0,121,121,594
1997,43100,2104,2344,51813,51456,230,9.9,187,8,5260,1739,3521,3.4,10.2,4546,1383,3163,2.7,8.8,714,1.4,17.6,0,110,110,718
1998,43100,2127,2370,52180,51957,202,8.6,163,6.9,5976,2481,3495,4.8,11.5,5530,2111,3419,4.1,10.6,446,0.9,21.2,0,106,106,461
1999,43100,2128,2382,54679,53450,200,8.4,187,7.9,6288,1637,4651,3.1,11.8,3829,1105,2724,2.1,7.2,2459,4.6,14.4,0,127,127,773
2000,43100,2150,2411,57358,56021,208,8.7,179,7.5,7109,3213,3896,5.7,12.7,4434,1205,3229,2.2,7.9,2675,4.8,15.8,0,118,118,702
2001,43100,2157,2428,57626,57581,200,8.2,204,8.4,6308,1959,4349,3.4,11,6217,1653,4564,2.9,10.8,91,0.2,21.6,0,126,126,702
2002,43100,2171,2456,56534,56363,231,9.5,195,8,6546,2545,4001,4.5,11.6,6203,1549,4654,2.7,11,343,0.6,22,0,94,94,666
2003,43100,2164,2450,53646,55081,195,8,170,7,5303,1744,3559,3.2,9.6,8172,1759,6413,3.2,14.8,-2869,-5.2,19.2,0,111,111,765
2004,43100,2218,2501,54217,53643,215,8.7,146,5.9,5270,1603,3667,3,9.8,4122,883,3239,1.6,7.7,1148,2.1,15.4,0,96,96,508
2005,43100,2246,2542,55805,54960,202,8,147,5.8,6588,1496,5092,2.7,12,4897,914,3983,1.7,8.9,1691,3.1,17.8,0,113,113,605
2006,43100,2216,2529,56634,56218,209,8.3,204,8.1,6045,1697,4348,3,10.8,5212,1338,3874,2.4,9.3,833,1.5,18.6,0,121,121,811
2007,43100,2227,2561,56417,56469,239,9.4,202,7.9,6329,2075,4254,3.7,11.2,6433,1189,5244,2.1,11.4,-104,-0.2,22.4,0,125,125,616
2008,43100,2200,2530,56749,56463,173,6.8,185,7.3,6113,1776,4337,3.1,10.8,5541,1417,4124,2.5,9.8,572,1,19.6,0,118,121,597
2009,43100,2180,2505,51745,54202,172,6.8,190,7.6,3510,1244,2266,2.3,6.5,8424,1837,6587,3.4,15.5,-4914,-9,13,0,124,124,699
2010,43100,2140,2464,50691,51207,142,5.7,156,6.3,5176,1571,3605,3.1,10.1,6207,1327,4880,2.6,12.1,-1031,-2,20.2,0,110,110,860
2011,43100,2108,2436,51673,51071,158,6.5,177,7.2,6461,989,5472,1.9,12.7,5256,1329,3927,2.6,10.3,1205,2.4,20.6,0,103,103,426
2012,43100,2124,2458,51321,51494,204,8.3,186,7.6,5505,1675,3830,3.3,10.7,5850,2049,3801,4,11.4,-345,-0.7,21.4,0,109,110,585
2013,43100,2097,2431,51871,51542,156,6.4,176,7.2,4765,1636,3129,3.2,9.2,4107,1207,2900,2.3,8,658,1.2,16,0,104,105,757
2014,43100,2097,2427,53602,52587,162,6.7,152,6.3,5578,988,4590,1.9,10.6,3548,886,2662,1.7,6.7,2030,3.9,13.4,0,108,109,589
1977,43300,1670,1815,25110,24431,325,18.3,254,14.3,4602,2086,2516,8.5,18.8,3243,1311,1932,5.4,13.3,1359,5.5,26.6,0,177,179,811
1978,43300,1600,1741,27092,26069,234,13.2,290,16.3,6125,2853,3272,10.9,23.5,4079,2124,1955,8.1,15.6,2046,7.9,31.2,0,164,166,1228
1979,43300,1733,1863,29937,28546,265,14.7,153,8.5,5893,1750,4143,6.1,20.6,3111,1255,1856,4.4,10.9,2782,9.7,21.8,1,4,5,
1980,43300,1790,1926,39974,34909,296,15.6,219,11.6,14026,2124,11902,6.1,40.2,3896,1225,2671,3.5,11.2,10130,29,22.4,0,170,170,710
1981,43300,1730,1857,30094,34737,258,13.7,295,15.6,4449,1682,2767,4.8,12.8,13734,1962,11772,5.6,39.5,-9285,-26.7,25.6,0,171,172,791
1982,43300,1758,1901,28118,29110,303,16.1,229,12.2,4055,1875,2180,6.4,13.9,6039,1311,4728,4.5,20.7,-1984,-6.8,27.8,0,136,136,584
1983,43300,1809,1950,28007,28014,249,12.9,220,11.4,4834,1260,3574,4.5,17.3,4847,1118,3729,4,17.3,-13,0,34.6,0,146,147,745
1984,43300,1888,2031,29464,28737,307,15.4,223,11.2,5346,2404,2942,8.4,18.6,3892,1485,2407,5.2,13.5,1454,5.1,27,0,150,150,786
1985,43300,1935,2082,31287,30433,290,14.1,242,11.8,5573,2322,3251,7.6,18.3,3865,1760,2105,5.8,12.7,1708,5.6,25.4,0,164,165,737
1986,43300,2014,2163,30871,31078,324,15.3,237,11.2,4779,2358,2421,7.6,15.4,5192,1734,3458,5.6,16.7,-413,-1.3,30.8,0,160,160,1128
1987,43300,1995,2168,29539,30113,341,15.7,327,15.1,4942,2762,2180,9.2,16.4,6089,3147,2942,10.5,20.2,-1147,-3.8,32.8,0,214,216,1058
1988,43300,1893,2078,29947,30033,246,11.6,319,15.1,4460,1969,2491,6.6,14.9,4631,2058,2573,6.9,15.4,-171,-0.5,29.8,0,216,216,887
1989,43300,1833,2023,29926,29938,225,11,273,13.3,3733,1394,2339,4.7,12.5,3757,1515,2242,5.1,12.5,-24,0,25,0,176,177,718
1990,43300,1847,2032,30298,29999,232,11.5,198,9.8,4417,1738,2679,5.8,14.7,3819,1521,2298,5.1,12.7,598,2,25.4,0,130,130,908
1991,43300,1862,2048,30363,30385,215,10.5,200,9.8,3987,1444,2543,4.8,13.1,4030,1276,2754,4.2,13.3,-43,-0.2,26.2,0,120,122,499
1992,43300,1848,2048,29549,29944,252,12.3,251,12.2,3711,1527,2184,5.1,12.4,4501,1666,2835,5.6,15,-790,-2.6,24.8,0,175,176,846
1993,43300,1861,2051,30461,30010,235,11.5,223,10.9,4666,1950,2716,6.5,15.5,3763,1172,2591,3.9,12.5,903,3,25,0,147,148,601
1994,43300,1909,2100,31256,30839,263,12.7,208,10,4531,1410,3121,4.6,14.7,3697,1320,2377,4.3,12,834,2.7,24,0,145,145,966
1995,43300,1961,2151,34614,33838,264,12.4,210,9.9,5505,2037,3468,6,16.3,3954,1271,2683,3.8,11.7,1551,4.6,23.4,0,149,149,709
1996,43300,2011,2199,34621,34604,222,10.2,178,8.2,4900,1570,3330,4.5,14.2,4867,1000,3867,2.9,14.1,33,0.1,28.2,0,121,121,607
1997,43300,2057,2275,38430,36600,308,13.8,237,10.6,8979,5357,3622,14.6,24.5,5319,1935,3384,5.3,14.5,3660,10,29,0,168,168,1135
1998,43300,2077,2296,37282,37800,257,11.2,229,10,5035,1458,3577,3.9,13.3,6070,1304,4766,3.4,16.1,-1035,-2.8,26.6,0,163,163,855
1999,43300,2087,2319,37572,37418,283,12.3,255,11.1,5982,2205,3777,5.9,16,5674,2837,2837,7.6,15.2,308,0.8,30.4,0,185,185,1579
2000,43300,2093,2314,39265,38384,269,11.6,267,11.5,6616,2775,3841,7.2,17.2,4853,2319,2534,6,12.6,1763,4.6,25.2,0,151,151,665
2001,43300,2131,2348,38452,38900,298,12.8,278,11.9,5938,2295,3643,5.9,15.3,6834,2621,4213,6.7,17.6,-896,-2.3,30.6,0,171,171,1007
2002,43300,2111,2340,36194,37226,282,12,295,12.6,5406,2378,3028,6.4,14.5,7469,2179,5290,5.9,20.1,-2063,-5.6,29,0,168,170,663
2003,43300,2138,2377,37127,36540,286,12.2,211,9,5426,2387,3039,6.5,14.8,4252,953,3299,2.6,11.6,1174,3.2,23.2,0,155,155,684
2004,43300,2174,2405,36490,36376,306,12.8,248,10.4,5500,2025,3475,5.6,15.1,5271,2122,3149,5.8,14.5,229,0.6,29,0,168,168,1064
2005,43300,2169,2409,36753,36571,266,11.1,237,9.9,5253,2226,3027,6.1,14.4,4889,1282,3607,3.5,13.4,364,1,26.8,0,183,183,995
2006,43300,2191,2431,38062,37379,271,11.2,233,9.6,6010,2778,3232,7.4,16.1,4643,1647,2996,4.4,12.4,1367,3.7,24.8,0,172,172,1211
2007,43300,2187,2453,36326,37060,270,11.1,239,9.8,5007,2121,2886,5.7,13.5,6474,1501,4973,4.1,17.5,-1467,-4,27,0,173,173,1117
2008,43300,2148,2418,37829,36650,220,9.1,220,9.1,7130,3301,3829,9,19.5,4772,2113,2659,5.8,13,2358,6.5,26,0,167,168,1419
2009,43300,2100,2373,37404,37547,201,8.4,235,9.8,5034,2728,2306,7.3,13.4,5320,1434,3886,3.8,14.2,-286,-0.8,26.8,0,172,172,754
2010,43300,2054,2318,39150,38209,176,7.5,209,8.9,6683,2159,4524,5.7,17.5,4801,1706,3095,4.5,12.6,1882,4.9,25.2,0,155,155,1185
2011,43300,1997,2259,38431,38745,162,7.1,203,8.9,5161,1331,3830,3.4,13.3,5788,1830,3958,4.7,14.9,-627,-1.6,26.6,0,148,152,1127
2012,43300,2040,2308,38532,38302,227,10,182,8,4979,1455,3524,3.8,13,4518,1422,3096,3.7,11.8,461,1.2,23.6,0,121,121,830
2013,43300,2059,2328,39853,39196,192,8.3,174,7.5,5083,1460,3623,3.7,13,3769,1113,2656,2.8,9.6,1314,3.4,19.2,0,125,125,704
2014,43300,2063,2317,39229,39468,198,8.6,187,8.1,5169,1485,3684,3.8,13.1,5646,2544,3102,6.4,14.3,-477,-1.2,26.2,0,138,138,889
1977,43340,5880,6721,98855,96748,1104,16.8,835,12.7,21051,9147,11904,9.5,21.8,16837,6567,10270,6.8,17.4,4214,4.4,34.8,0,551,556,3769
1978,43340,5645,6504,105801,102230,842,12.7,999,15.1,22075,5699,16376,5.6,21.6,14933,6232,8701,6.1,14.6,7142,7,29.2,0,591,592,3340
1979,43340,6096,7002,113952,110008,967,14.3,508,7.5,21047,7371,13676,6.7,19.1,13159,4417,8742,4,12,7888,7.1,24,1,3,4,
1980,43340,6238,7155,117437,115627,954,13.5,780,11,22260,8498,13762,7.3,19.3,18640,5678,12962,4.9,16.1,3620,3.2,32.2,0,549,550,3273
1981,43340,6242,7139,119099,118090,992,13.9,946,13.2,20828,8529,12299,7.2,17.6,18809,6667,12142,5.6,15.9,2019,1.7,31.8,0,577,581,3242
1982,43340,6488,7491,122114,120438,1211,16.5,811,11.1,24395,12286,12109,10.2,20.3,21042,7192,13850,6,17.5,3353,2.8,35,0,459,459,3020
1983,43340,6655,7672,115518,117237,986,13,850,11.2,20554,8474,12080,7.2,17.5,23992,7676,16316,6.5,20.5,-3438,-3,35,0,585,586,3389
1984,43340,6801,7884,121298,119147,1125,14.5,918,11.8,22854,8173,14681,6.9,19.2,18551,6479,12072,5.4,15.6,4303,3.6,31.2,0,597,598,3236
1985,43340,6991,8062,123946,123297,1118,14,915,11.5,19204,7641,11563,6.2,15.6,17905,6839,11066,5.5,14.5,1299,1.1,29,0,603,609,3714
1986,43340,6995,8055,116449,120142,1053,13.1,1027,12.8,19036,8104,10932,6.7,15.8,26421,8663,17758,7.2,22,-7385,-6.2,31.6,0,720,720,4896
1987,43340,6728,7764,112735,116017,968,12.2,1230,15.5,18876,8038,10838,6.9,16.3,25440,12288,13152,10.6,21.9,-6564,-5.6,32.6,0,769,781,5045
1988,43340,6488,7572,114613,113550,928,12.1,1076,14,20674,8383,12291,7.4,18.2,18548,8346,10202,7.4,16.3,2126,1.9,32.6,0,706,706,4498
1989,43340,6266,7400,114903,114832,793,10.6,974,13,19588,8823,10765,7.7,17.1,19446,6573,12873,5.7,16.9,142,0.2,33.8,0,629,633,4127
1990,43340,6182,7326,115613,115061,803,10.9,825,11.2,17501,6261,11240,5.4,15.2,16397,5576,10821,4.8,14.3,1104,0.9,28.6,0,540,540,3297
1991,43340,6244,7407,114329,115076,832,11.3,765,10.4,18510,7646,10864,6.6,16.1,20004,8496,11508,7.4,17.4,-1494,-1.3,32.2,0,451,467,4717
1992,43340,6234,7366,118751,116518,799,10.8,808,10.9,22632,6819,15813,5.9,19.4,18166,6272,11894,5.4,15.6,4466,3.8,31.2,0,471,478,3034
1993,43340,6309,7416,121912,120359,748,10.1,693,9.4,20584,7377,13207,6.1,17.1,17477,4473,13004,3.7,14.5,3107,2.6,29,0,469,469,2440
1994,43340,6381,7539,123768,122840,812,10.9,686,9.2,19391,6418,12973,5.2,15.8,17534,5433,12101,4.4,14.3,1857,1.5,28.6,0,464,464,3343
1995,43340,6460,7612,130924,127280,804,10.6,702,9.3,22909,8039,14870,6.3,18,15620,5717,9903,4.5,12.3,7289,5.7,24.6,0,471,472,2991
1996,43340,6586,7741,134948,132395,833,10.9,666,8.7,20288,6795,13493,5.1,15.3,15182,4706,10476,3.6,11.5,5106,3.8,23,0,459,459,2895
1997,43340,6613,7807,134666,134928,892,11.5,840,10.8,19920,7673,12247,5.7,14.8,20443,6143,14300,4.6,15.2,-523,-0.4,29.6,0,520,520,3199
1998,43340,6632,7810,137099,136053,815,10.4,785,10.1,20824,6382,14442,4.7,15.3,18732,5634,13098,4.1,13.8,2092,1.5,27.6,0,522,522,2885
1999,43340,6552,7781,139288,138692,779,10,787,10.1,19674,6810,12864,4.9,14.2,18481,7791,10690,5.6,13.3,1193,0.9,26.6,0,495,495,3614
2000,43340,6512,7808,139579,139378,812,10.4,796,10.2,21078,6928,14150,5,15.1,20675,7633,13042,5.5,14.8,403,0.3,29.6,0,480,480,3842
2001,43340,6565,7885,144511,143347,773,9.8,762,9.7,24332,8982,15350,6.3,17,22003,5608,16395,3.9,15.3,2329,1.7,30.6,0,417,417,2218
2002,43340,6604,7900,144305,144236,862,10.9,835,10.6,24330,7939,16391,5.5,16.9,24192,7768,16424,5.4,16.8,138,0.1,33.6,0,445,445,3338
2003,43340,6658,7954,147577,144453,821,10.4,614,7.8,22777,7980,14797,5.5,15.8,16529,4519,12010,3.1,11.4,6248,4.4,22.8,0,460,460,3122
2004,43340,6690,7969,146528,146659,752,9.5,662,8.3,21011,6080,14931,4.1,14.3,21273,5880,15393,4,14.5,-262,-0.2,28.6,0,443,444,3070
2005,43340,6739,8061,148548,146845,824,10.3,645,8.1,23203,9811,13392,6.7,15.8,19796,5962,13834,4.1,13.5,3407,2.3,27,0,464,464,4458
2006,43340,6784,8208,155396,151353,901,11.1,675,8.3,26583,9447,17136,6.2,17.6,18497,6700,11797,4.4,12.2,8086,5.4,24.4,0,463,463,3730
2007,43340,6889,8357,156505,155595,873,10.6,713,8.6,22657,6998,15659,4.5,14.6,20837,5715,15122,3.7,13.4,1820,1.2,26.8,0,431,438,3018
2008,43340,6927,8419,154780,154937,800,9.6,631,7.6,20012,7253,12759,4.7,12.9,20325,5219,15106,3.4,13.1,-313,-0.2,25.8,0,474,474,3078
2009,43340,6861,8360,151197,152702,684,8.2,683,8.2,18957,7449,11508,4.9,12.4,21967,5195,16772,3.4,14.4,-3010,-2,24.8,0,462,462,3467
2010,43340,6924,8447,148217,149441,704,8.4,581,6.9,15409,5606,9803,3.8,10.3,17857,3546,14311,2.4,11.9,-2448,-1.6,20.6,0,399,399,2075
2011,43340,6935,8483,153032,150486,742,8.8,658,7.8,20236,6611,13625,4.4,13.4,15143,4421,10722,2.9,10.1,5093,3.3,20.2,0,441,443,2793
2012,43340,6971,8559,152835,152908,742,8.7,679,8,18758,5879,12879,3.8,12.3,18903,4431,14472,2.9,12.4,-145,-0.1,24.6,0,402,404,2147
2013,43340,6934,8530,151304,151374,663,7.8,674,7.9,17673,5115,12558,3.4,11.7,17812,4471,13341,3,11.8,-139,-0.1,23.4,0,442,442,2719
2014,43340,6903,8515,150592,150225,716,8.4,644,7.6,18186,6288,11898,4.2,12.1,17451,4507,12944,3,11.6,735,0.5,23.2,0,445,445,3162
1977,43580,2894,3125,56474,50462,471,15.3,381,12.4,21085,3742,17343,7.4,41.8,9061,2736,6325,5.4,18,12024,23.8,36,0,252,253,1565
1978,43580,2924,3167,47929,52269,415,13.2,375,11.9,10967,4386,6581,8.4,21,19647,2585,17062,4.9,37.6,-8680,-16.6,42,0,278,278,1653
1979,43580,2851,3088,48193,47976,336,10.7,390,12.5,8703,2150,6553,4.5,18.1,8269,3545,4724,7.4,17.2,434,0.9,34.4,0,287,287,1557
1980,43580,2839,3084,47544,47501,371,12,359,11.6,7484,2419,5065,5.1,15.8,7398,2735,4663,5.8,15.6,86,0.2,31.2,0,259,260,1218
1981,43580,2717,2963,48981,47753,350,11.6,442,14.7,9937,3195,6742,6.7,20.8,7480,2899,4581,6.1,15.7,2457,5.1,31.4,0,280,281,1500
1982,43580,2684,2941,44492,46650,375,12.7,341,11.5,5847,2750,3097,5.9,12.5,10163,2507,7656,5.4,21.8,-4316,-9.3,25,0,179,179,956
1983,43580,2713,2950,43646,43844,307,10.4,341,11.6,6572,2570,4002,5.9,15,6967,2121,4846,4.8,15.9,-395,-0.9,30,0,226,226,1131
1984,43580,2780,3028,45395,44519,404,13.5,327,10.9,7540,3925,3615,8.8,16.9,5788,1976,3812,4.4,13,1752,3.9,26,0,222,222,1282
1985,43580,2753,2998,46360,46253,343,11.4,378,12.5,6311,2215,4096,4.8,13.6,6096,2260,3836,4.9,13.2,215,0.4,26.4,0,262,262,1172
1986,43580,2728,2958,46881,46566,286,9.6,308,10.3,7293,2279,5014,4.9,15.7,6663,2305,4358,4.9,14.3,630,1.4,28.6,0,213,213,1226
1987,43580,2752,3000,44927,45369,377,12.6,330,11.1,7969,3121,4848,6.9,17.6,8852,3094,5758,6.8,19.5,-883,-1.9,35.2,0,206,206,1791
1988,43580,2710,2969,49586,46910,298,10,304,10.2,11611,2049,9562,4.4,24.8,6259,2615,3644,5.6,13.3,5352,11.5,26.6,0,196,196,1120
1989,43580,2721,2984,53464,51463,329,11.1,310,10.4,9413,2896,6517,5.6,18.3,5411,2265,3146,4.4,10.5,4002,7.8,21,0,203,203,1205
1990,43580,2757,3031,57109,55249,322,10.7,268,8.9,9985,3960,6025,7.2,18.1,6265,1875,4390,3.4,11.3,3720,6.8,22.6,0,181,181,1263
1991,43580,2811,3127,55864,56508,339,11,250,8.1,7734,2477,5257,4.4,13.7,9022,2848,6174,5,16,-1288,-2.3,27.4,0,164,164,2045
1992,43580,2846,3181,57235,56545,359,11.4,297,9.4,9354,4046,5308,7.2,16.5,7973,3533,4440,6.2,14.1,1381,2.4,28.2,0,199,200,1607
1993,43580,2887,3226,59132,58207,326,10.2,277,8.6,8150,2449,5701,4.2,14,6299,2112,4187,3.6,10.8,1851,3.2,21.6,0,192,192,1304
1994,43580,2933,3295,61841,60513,349,10.7,276,8.5,9822,2652,7170,4.4,16.2,7165,3490,3675,5.8,11.8,2657,4.4,23.6,0,185,186,1059
1995,43580,2972,3353,66625,64240,349,10.5,279,8.4,10962,3309,7653,5.2,17.1,6191,2228,3963,3.5,9.6,4771,7.5,19.2,0,194,194,1640
1996,43580,3043,3448,68375,67565,375,11,272,8,9895,4770,5125,7.1,14.6,8275,2067,6208,3.1,12.2,1620,2.4,24.4,0,193,193,1470
1997,43580,3038,3465,67827,68123,357,10.3,343,9.9,10465,3592,6873,5.3,15.4,11056,4350,6706,6.4,16.2,-591,-0.8,30.8,0,207,207,3119
1998,43580,3062,3499,73079,70422,351,10.1,316,9.1,12591,2419,10172,3.4,17.9,7276,2275,5001,3.2,10.3,5315,7.6,20.6,0,191,191,929
1999,43580,3026,3471,71371,71608,285,8.2,306,8.8,7714,2697,5017,3.8,10.8,8187,2399,5788,3.4,11.4,-473,-0.6,21.6,0,200,200,1346
2000,43580,3031,3476,68546,69930,306,8.8,298,8.6,8491,2986,5505,4.3,12.1,11259,2539,8720,3.6,16.1,-2768,-4,24.2,0,175,175,795
2001,43580,2999,3459,77127,72896,282,8.1,327,9.4,15380,6835,8545,9.4,21.1,6918,2229,4689,3.1,9.5,8462,11.6,19,0,190,190,1071
2002,43580,3018,3478,67864,72294,397,11.5,372,10.7,10837,3357,7480,4.6,15,19696,9707,9989,13.4,27.2,-8859,-12.2,30,0,197,197,1332
2003,43580,2982,3439,64051,65625,307,8.9,284,8.3,7825,2139,5686,3.3,11.9,10972,4977,5995,7.6,16.7,-3147,-4.8,23.8,0,184,184,1132
2004,43580,2977,3442,63031,63251,318,9.3,298,8.7,8484,3200,5284,5.1,13.4,8923,2492,6431,3.9,14.1,-439,-0.7,26.8,0,193,193,1135
2005,43580,2974,3467,63961,63263,324,9.4,269,7.8,8093,2704,5389,4.3,12.8,6696,1573,5123,2.5,10.6,1397,2.2,21.2,0,205,205,1273
2006,43580,2916,3454,67748,65711,321,9.3,290,8.4,11542,3557,7985,5.4,17.6,7467,1700,5767,2.6,11.4,4075,6.2,22.8,0,189,189,938
2007,43580,2955,3475,66648,67169,309,8.9,291,8.4,10259,4546,5713,6.8,15.3,11300,2464,8836,3.7,16.8,-1041,-1.5,30.6,0,176,178,1029
2008,43580,2941,3487,68205,67300,277,8,244,7,8440,2047,6393,3,12.5,6629,1760,4869,2.6,9.8,1811,2.7,19.6,0,161,161,1277
2009,43580,2959,3511,67437,67760,258,7.4,216,6.2,6827,1578,5249,2.3,10.1,7473,1475,5998,2.2,11,-646,-0.9,20.2,0,142,142,995
2010,43580,2901,3459,65641,66283,207,6,232,6.7,5694,1354,4340,2,8.6,6978,1436,5542,2.2,10.5,-1284,-1.9,17.2,0,153,153,1180
2011,43580,2876,3439,65824,65170,250,7.3,242,7,7854,2770,5084,4.3,12.1,6546,1731,4815,2.7,10,1308,2.1,20,0,150,151,924
2012,43580,2921,3459,66089,65726,269,7.8,246,7.1,7004,2259,4745,3.4,10.7,6277,1999,4278,3,9.6,727,1.1,19.2,0,114,114,761
2013,43580,2922,3456,66260,66156,235,6.8,228,6.6,6823,1741,5082,2.6,10.3,6614,1425,5189,2.2,10,209,0.3,20,0,141,141,1043
2014,43580,2908,3453,67586,66637,223,6.5,198,5.8,7554,2463,5091,3.7,11.3,5655,1780,3875,2.7,8.5,1899,2.8,17,0,148,148,1009
1977,43620,3061,3329,70098,56756,571,17.6,397,12.2,32703,3717,28986,6.5,57.6,6019,2732,3287,4.8,10.6,26684,47,21.2,0,246,246,1400
1978,43620,3245,3518,50782,60452,571,16.7,383,11.2,10364,3427,6937,5.7,17.1,29703,2071,27632,3.4,49.1,-19339,-32,34.2,0,265,265,1248
1979,43620,3250,3545,52898,51798,452,12.8,401,11.4,8467,2874,5593,5.5,16.3,6267,2033,4234,3.9,12.1,2200,4.2,24.2,0,276,276,1163
1980,43620,3288,3587,53841,53363,437,12.3,387,10.9,8341,3033,5308,5.7,15.6,7384,2476,4908,4.6,13.8,957,1.8,27.6,0,270,271,1333
1981,43620,3181,3479,51739,52144,397,11.3,447,12.7,6788,2932,3856,5.6,13,7598,2457,5141,4.7,14.6,-810,-1.6,26,0,275,275,1235
1982,43620,3134,3477,51118,51310,443,12.7,383,11,7870,3176,4694,6.2,15.3,8254,2381,5873,4.6,16.1,-384,-0.8,30.6,0,226,227,1168
1983,43620,3213,3551,52641,51831,382,10.9,357,10.2,8500,3415,5085,6.6,16.4,6880,2173,4707,4.2,13.3,1620,3.1,26.6,0,211,211,1244
1984,43620,3307,3653,56450,54518,494,13.7,394,10.9,9731,3351,6380,6.1,17.8,5867,2202,3665,4,10.8,3864,7,21.6,0,233,234,1114
1985,43620,3501,3857,61188,59406,573,15.2,389,10.3,9603,3716,5887,6.3,16.2,6038,2017,4021,3.4,10.2,3565,6,20.4,0,255,256,1216
1986,43620,3573,3934,61223,61181,493,12.7,402,10.3,8804,3658,5146,6,14.4,8720,2943,5777,4.8,14.3,84,0.1,28.6,0,254,254,1793
1987,43620,3618,4012,63184,62471,536,13.5,434,10.9,9133,3416,5717,5.5,14.6,7706,2941,4765,4.7,12.3,1427,2.3,24.6,0,271,272,1601
1988,43620,3614,4031,65122,63483,471,11.8,406,10.1,10237,3865,6372,6.1,16.1,6958,2483,4475,3.9,11,3279,5.1,22,0,263,263,1201
1989,43620,3689,4141,67237,66243,493,12.1,388,9.5,11161,3451,7710,5.2,16.8,9172,3591,5581,5.4,13.8,1989,3,27.6,0,279,279,1618
1990,43620,3809,4272,71514,69262,526,12.5,362,8.6,12746,4692,8054,6.8,18.4,8242,2638,5604,3.8,11.9,4504,6.5,23.8,0,244,244,1590
1991,43620,3978,4502,75720,73588,600,13.7,366,8.3,12304,4556,7748,6.2,16.7,8040,2602,5438,3.5,10.9,4264,5.8,21.8,0,243,243,1578
1992,43620,4047,4611,78572,77137,549,12,434,9.5,12195,3859,8336,5,15.8,9325,3138,6187,4.1,12.1,2870,3.7,24.2,0,276,279,1584
1993,43620,4147,4698,83364,80994,510,11,411,8.8,14059,5862,8197,7.2,17.4,9318,3600,5718,4.4,11.5,4741,5.9,23,0,251,251,1180
1994,43620,4284,4878,84724,83953,598,12.5,396,8.3,11909,4750,7159,5.7,14.2,10367,4447,5920,5.3,12.3,1542,1.9,24.6,0,272,272,2285
1995,43620,4423,5032,86674,85641,563,11.4,379,7.7,10976,3676,7300,4.3,12.8,8909,3622,5287,4.2,10.4,2067,2.4,20.8,0,258,258,1258
1996,43620,4517,5115,90478,88726,552,10.9,473,9.3,13242,4979,8263,5.6,14.9,9738,3749,5989,4.2,11,3504,3.9,22,0,291,291,1649
1997,43620,4569,5185,93592,92071,610,11.8,526,10.2,15880,6325,9555,6.9,17.2,12838,4964,7874,5.4,13.9,3042,3.3,27.8,0,319,319,1549
1998,43620,4632,5254,97714,95609,616,11.8,545,10.4,14819,5364,9455,5.6,15.5,10608,4507,6101,4.7,11.1,4211,4.4,22.2,0,351,351,2187
1999,43620,4763,5410,102739,100192,664,12.5,512,9.6,16802,7384,9418,7.4,16.8,11707,4804,6903,4.8,11.7,5095,5.1,23.4,0,321,321,1902
2000,43620,4827,5513,105822,104328,627,11.5,536,9.8,16142,5057,11085,4.8,15.5,13154,5295,7859,5.1,12.6,2988,2.9,25.2,0,333,333,2414
2001,43620,4888,5651,107853,107372,654,11.7,562,10.1,16068,7180,8888,6.7,15,15105,4608,10497,4.3,14.1,963,0.9,28.2,0,325,326,2172
2002,43620,4995,5792,107255,107463,715,12.5,563,9.8,17114,6481,10633,6,15.9,17530,5721,11809,5.3,16.3,-416,-0.4,31.8,0,316,316,1720
2003,43620,5025,5793,109374,107419,616,10.7,520,9,16522,5730,10792,5.3,15.4,12611,4119,8492,3.8,11.7,3911,3.7,23.4,0,325,325,1995
2004,43620,5176,5965,113066,110787,676,11.5,455,7.8,18282,5609,12673,5.1,16.5,13723,4844,8879,4.4,12.4,4559,4.1,24.8,0,291,291,2337
2005,43620,5307,6120,113870,113263,666,11.1,469,7.8,13557,4625,8932,4.1,12,12342,3876,8466,3.4,10.9,1215,1.1,21.8,0,308,308,1609
2006,43620,5371,6211,118463,115896,700,11.4,547,8.9,15342,5088,10254,4.4,13.2,10207,3630,6577,3.1,8.8,5135,4.4,17.6,0,346,346,2438
2007,43620,5487,6388,122345,120324,711,11.3,517,8.2,17633,5601,12032,4.7,14.7,13591,3968,9623,3.3,11.3,4042,3.4,22.6,0,307,307,1925
2008,43620,5520,6432,126716,124219,608,9.5,520,8.1,17044,5396,11648,4.3,13.7,12050,4839,7211,3.9,9.7,4994,4,19.4,0,374,374,2631
2009,43620,5449,6361,123900,125087,525,8.2,560,8.8,14760,4968,9792,4,11.8,17134,5202,11932,4.2,13.7,-2374,-1.9,23.6,0,369,369,3157
2010,43620,5464,6401,121189,122090,567,8.9,500,7.9,14009,5712,8297,4.7,11.5,15811,4176,11635,3.4,13,-1802,-1.5,23,0,310,310,2720
2011,43620,5444,6412,122028,121515,551,8.6,522,8.2,13203,4512,8691,3.7,10.9,12177,3690,8487,3,10,1026,0.9,20,0,336,344,2348
2012,43620,5508,6528,125548,123795,596,9.2,489,7.6,15879,5993,9886,4.8,12.8,12373,3424,8949,2.8,10,3506,2.8,20,0,296,297,1604
2013,43620,5590,6626,128050,126662,575,8.8,481,7.3,16725,4728,11997,3.7,13.2,13949,5621,8328,4.4,11,2776,2.2,22,0,304,304,2157
2014,43620,5647,6669,131509,129399,577,8.7,478,7.2,15888,4059,11829,3.1,12.3,11667,3234,8433,2.5,9,4221,3.3,18,0,330,332,1725
1977,43780,4677,5220,91501,88963,788,15.3,643,12.5,18041,8816,9225,9.9,20.3,12964,4963,8001,5.6,14.6,5077,5.7,29.2,0,406,411,2839
1978,43780,4789,5329,102170,96823,716,13.6,599,11.4,21711,5847,15864,6,22.4,11016,4545,6471,4.7,11.4,10695,11,22.8,0,398,403,2779
1979,43780,4882,5470,104253,103047,725,13.4,554,10.3,19934,8838,11096,8.6,19.3,17521,5090,12431,4.9,17,2413,2.3,34,0,374,375,2613
1980,43780,4869,5466,100401,102223,619,11.3,599,11,13365,4589,8776,4.5,13.1,17009,4395,12614,4.3,16.6,-3644,-3.5,26.2,0,406,407,2371
1981,43780,4689,5269,92008,95922,505,9.4,660,12.3,11160,5900,5260,6.2,11.6,18987,8395,10592,8.8,19.8,-7827,-8.2,23.2,0,391,392,3333
1982,43780,4706,5356,90636,91270,673,12.7,540,10.2,12671,4948,7723,5.4,13.9,13939,4148,9791,4.5,15.3,-1268,-1.4,27.8,0,324,324,1629
1983,43780,4583,5204,88077,89223,525,9.9,649,12.3,12881,5392,7489,6,14.4,15172,6914,8258,7.7,17,-2291,-2.6,28.8,0,348,348,3817
1984,43780,4989,5645,99325,93879,696,12.8,350,6.5,20042,6372,13670,6.8,21.3,9150,2862,6288,3,9.7,10892,11.6,19.4,0,36,36,299
1985,43780,5086,5784,101660,100625,724,12.7,585,10.2,15811,6193,9618,6.2,15.7,13741,4624,9117,4.6,13.7,2070,2,27.4,0,372,372,2242
1986,43780,5217,5897,103844,102653,720,12.3,587,10.1,16414,5524,10890,5.4,16,14031,4351,9680,4.2,13.7,2383,2.3,27.4,0,374,382,2378
1987,43780,5316,6010,104836,104239,788,13.2,661,11.1,18710,7297,11413,7,17.9,17516,7058,10458,6.8,16.8,1194,1.1,33.6,0,400,403,2732
1988,43780,5354,6090,108939,106755,716,11.8,624,10.3,17561,5458,12103,5.1,16.4,13193,4795,8398,4.5,12.4,4368,4,24.8,0,397,397,2750
1989,43780,5486,6239,112535,110804,675,10.9,544,8.8,17358,6553,10805,5.9,15.7,13896,4320,9576,3.9,12.5,3462,3.2,25,0,351,352,2709
1990,43780,5522,6293,109891,111131,673,10.7,591,9.4,14721,4473,10248,4,13.2,17201,6059,11142,5.5,15.5,-2480,-2.3,26.4,0,404,405,2663
1991,43780,5589,6377,110579,110281,700,11.1,625,9.9,17428,6549,10879,5.9,15.8,16832,5652,11180,5.1,15.3,596,0.5,30.6,0,379,380,2347
1992,43780,5607,6454,114287,112534,738,11.5,644,10,18708,6786,11922,6,16.6,15201,5166,10035,4.6,13.5,3507,3.1,27,0,413,414,2361
1993,43780,5651,6475,117318,115751,622,9.6,581,9,17269,4607,12662,4,14.9,14135,5134,9001,4.4,12.2,3134,2.7,24.4,0,379,379,1969
1994,43780,5799,6610,120687,119004,683,10.4,532,8.1,17485,5693,11792,4.8,14.7,14118,5524,8594,4.6,11.9,3367,2.8,23.8,0,353,354,2400
1995,43780,5834,6660,124891,122952,629,9.5,577,8.7,17346,5715,11631,4.6,14.1,13467,4070,9397,3.3,11,3879,3.1,22,0,394,395,1948
1996,43780,5865,6673,123559,124193,676,10.1,652,9.8,15853,5262,10591,4.2,12.8,17121,5851,11270,4.7,13.8,-1268,-1,25.6,0,393,393,2680
1997,43780,5875,6704,125238,124495,715,10.7,689,10.3,18927,6413,12514,5.2,15.2,17442,6510,10932,5.2,14,1485,1.2,28,0,429,429,2672
1998,43780,5895,6740,127331,126215,636,9.5,601,8.9,16929,5522,11407,4.4,13.4,14697,4854,9843,3.8,11.6,2232,1.8,23.2,0,392,392,2482
1999,43780,5859,6736,131027,129250,623,9.2,623,9.2,18334,6809,11525,5.3,14.2,14780,4567,10213,3.5,11.4,3554,2.8,22.8,0,408,408,1990
2000,43780,5814,6692,132831,131938,607,9,657,9.8,17954,6218,11736,4.7,13.6,16167,6122,10045,4.6,12.3,1787,1.3,24.6,0,379,379,2262
2001,43780,5795,6683,129087,131081,604,9,648,9.7,14775,5330,9445,4.1,11.3,18763,6400,12363,4.9,14.3,-3988,-3,22.6,0,367,367,2904
2002,43780,5673,6540,126940,128528,664,10.1,798,12.1,18592,6813,11779,5.3,14.5,21767,7100,14667,5.5,16.9,-3175,-2.4,29,0,384,384,2401
2003,43780,5659,6547,129415,127305,655,10.1,549,8.4,18911,6229,12682,4.9,14.9,14690,4238,10452,3.3,11.5,4221,3.4,23,0,376,379,2704
2004,43780,5617,6499,127312,127985,574,8.8,546,8.4,15667,5435,10232,4.2,12.2,17012,4021,12991,3.1,13.3,-1345,-1.1,24.4,0,364,364,2177
2005,43780,5622,6504,129288,128287,589,9.1,531,8.2,15192,5763,9429,4.5,11.8,13189,3594,9595,2.8,10.3,2003,1.5,20.6,0,357,357,2015
2006,43780,5600,6598,130956,129755,713,10.9,560,8.6,16653,6329,10324,4.9,12.8,14250,5090,9160,3.9,11,2403,1.8,22,0,382,387,3822
2007,43780,5567,6606,130944,130889,649,9.8,657,10,17939,6566,11373,5,13.7,17828,6186,11642,4.7,13.6,111,0.1,27.2,0,411,415,3126
2008,43780,5451,6499,132246,130875,529,8.1,545,8.4,15960,5001,10959,3.8,12.2,13217,3601,9616,2.8,10.1,2743,2.1,20.2,0,369,369,2214
2009,43780,5261,6259,122489,126651,441,6.9,627,9.9,11927,3865,8062,3.1,9.4,20251,5175,15076,4.1,16,-8324,-6.6,18.8,0,359,359,2484
2010,43780,5154,6147,118378,119940,425,6.9,479,7.7,12277,3456,8821,2.9,10.2,15400,4284,11116,3.6,12.8,-3123,-2.6,20.4,0,296,296,2106
2011,43780,5075,6107,120738,119399,482,7.9,472,7.7,14340,4686,9654,3.9,12,11661,3069,8592,2.6,9.8,2679,2.2,19.6,0,316,316,2382
2012,43780,5082,6101,120745,120437,463,7.6,464,7.6,13056,3763,9293,3.1,10.8,12439,3478,8961,2.9,10.3,617,0.5,20.6,0,250,254,1509
2013,43780,5033,6042,119965,120251,428,7.1,478,7.9,12045,3930,8115,3.3,10,12617,3885,8732,3.2,10.5,-572,-0.5,20,0,299,299,2142
2014,43780,4964,5959,125511,122504,414,6.9,434,7.3,14798,3294,11504,2.7,12.1,8783,3001,5782,2.4,7.2,6015,4.9,14.4,0,283,283,1743
1977,43900,3137,3513,70697,70259,524,15.3,360,10.5,8563,3163,5400,4.5,12.2,7687,1946,5741,2.8,10.9,876,1.3,21.8,0,256,257,1246
1978,43900,3178,3574,74578,72642,498,14.1,434,12.2,12004,4404,7600,6.1,16.5,8131,2451,5680,3.4,11.2,3873,5.3,22.4,0,305,306,1279
1979,43900,3244,3652,83546,78969,508,14.1,412,11.4,19602,3882,15720,4.9,24.8,10447,2925,7522,3.7,13.2,9155,11.6,26.4,0,305,306,1215
1980,43900,3252,3661,76405,79944,436,11.9,405,11.1,11001,3650,7351,4.6,13.8,18079,3106,14973,3.9,22.6,-7078,-8.8,27.6,0,283,283,1124
1981,43900,3163,3575,78537,77326,442,12.2,501,13.9,12820,5828,6992,7.5,16.6,10397,3964,6433,5.1,13.4,2423,3.2,26.8,0,304,305,1076
1982,43900,3194,3647,78438,78455,513,14.2,409,11.3,11989,4931,7058,6.3,15.3,12023,3921,8102,5,15.3,-34,0,30.6,0,251,251,1498
1983,43900,3065,3533,72494,75073,398,11.1,471,13.1,9252,3263,5989,4.3,12.3,14409,3936,10473,5.2,19.2,-5157,-6.9,24.6,0,259,262,1582
1984,43900,3455,3934,78490,76311,536,14.4,213,5.7,12963,3572,9391,4.7,17,8604,3936,4668,5.2,11.3,4359,5.7,22.6,0,6,6,35
1985,43900,3602,4099,83433,81464,509,12.7,357,8.9,12915,4901,8014,6,15.9,8977,3166,5811,3.9,11,3938,4.9,22,0,232,232,1307
1986,43900,3722,4218,84419,83874,518,12.5,380,9.1,12414,4953,7461,5.9,14.8,11323,4379,6944,5.2,13.5,1091,1.3,27,0,233,233,1943
1987,43900,3830,4377,89733,87418,635,14.8,462,10.7,14965,5627,9338,6.4,17.1,10334,4270,6064,4.9,11.8,4631,5.3,23.6,0,277,279,1969
1988,43900,3964,4552,94489,90259,632,14.2,429,9.6,17804,8243,9561,9.1,19.7,9344,3521,5823,3.9,10.4,8460,9.3,20.8,0,269,269,1416
1989,43900,4060,4657,94803,94885,545,11.8,445,9.7,14296,5250,9046,5.5,15.1,14460,5664,8796,6,15.2,-164,-0.1,30.2,0,280,280,3202
1990,43900,4143,4738,99533,97125,559,11.9,449,9.6,15530,4841,10689,5,16,10714,3045,7669,3.1,11,4816,5,22,0,287,287,1854
1991,43900,4178,4836,93571,96474,568,11.9,453,9.5,11175,5014,6161,5.2,11.6,16980,4669,12311,4.8,17.6,-5805,-6,23.2,0,280,284,1892
1992,43900,4202,4822,97813,97131,558,11.5,554,11.5,14802,5544,9258,5.7,15.2,13438,4697,8741,4.8,13.8,1364,1.4,27.6,0,323,330,2400
1993,43900,4250,4868,99515,98670,491,10.1,444,9.2,12432,3358,9074,3.4,12.6,10741,3299,7442,3.3,10.9,1691,1.7,21.8,0,269,269,1179
1994,43900,4372,5002,102963,101177,560,11.4,409,8.3,15690,6671,9019,6.6,15.5,12118,4703,7415,4.6,12,3572,3.5,24,0,255,255,2874
1995,43900,4496,5154,108918,105885,616,12.1,444,8.7,16501,5448,11053,5.1,15.6,10435,3699,6736,3.5,9.9,6066,5.7,19.8,0,271,272,1687
1996,43900,4586,5269,111846,110384,605,11.6,474,9.1,16800,5746,11054,5.2,15.2,13875,4547,9328,4.1,12.6,2925,2.6,25.2,0,318,318,2671
1997,43900,4730,5447,114371,113158,738,13.8,561,10.5,20793,8322,12471,7.4,18.4,18366,7930,10436,7,16.2,2427,2.2,32.4,0,356,356,3304
1998,43900,4790,5522,113801,114052,649,11.8,552,10.1,15462,5701,9761,5,13.6,15963,5340,10623,4.7,14,-501,-0.4,27.2,0,342,342,1944
1999,43900,4928,5666,120244,116952,661,11.8,510,9.1,21705,9215,12490,7.9,18.6,15121,3962,11159,3.4,12.9,6584,5.7,25.8,0,333,333,1974
2000,43900,4952,5722,120900,120574,631,11.1,577,10.1,18486,6237,12249,5.2,15.3,17833,7568,10265,6.3,14.8,653,0.5,29.6,0,362,362,2986
2001,43900,4940,5729,118550,119867,570,9.9,609,10.6,13281,4704,8577,3.9,11.1,15915,5101,10814,4.3,13.3,-2634,-2.2,22.2,0,380,380,2142
2002,43900,4908,5731,116036,117269,654,11.4,662,11.5,17345,7443,9902,6.3,14.8,19811,6061,13750,5.2,16.9,-2466,-2.1,29.6,0,352,352,1791
2003,43900,4983,5807,113260,114298,628,10.9,455,7.9,17039,6654,10385,5.8,14.9,19115,7322,11793,6.4,16.7,-2076,-1.8,29.8,0,329,329,2101
2004,43900,4993,5817,113286,111804,573,9.9,501,8.6,16685,6695,9990,6,14.9,13721,4431,9290,4,12.3,2964,2.6,24.6,0,348,348,2110
2005,43900,5075,5936,114324,113378,643,11,470,8,15647,5026,10621,4.4,13.8,13754,4731,9023,4.2,12.1,1893,1.7,24.2,0,347,347,2415
2006,43900,5105,6026,116551,115171,647,10.8,519,8.7,16098,6366,9732,5.5,14,13337,3742,9595,3.2,11.6,2761,2.4,23.2,0,358,358,2242
2007,43900,5104,6077,116580,116190,664,11,606,10,18733,7264,11469,6.3,16.1,17953,6224,11729,5.4,15.5,780,0.6,31,0,403,404,2887
2008,43900,5085,6068,118382,117113,569,9.4,512,8.5,16638,5346,11292,4.6,14.2,14100,4780,9320,4.1,12,2538,2.2,24,0,349,349,2644
2009,43900,4925,5935,110740,114209,522,8.7,588,9.8,14012,7169,6843,6.3,12.3,20950,6112,14838,5.4,18.3,-6938,-6,24.6,0,398,399,2450
2010,43900,4818,5865,108296,109288,490,8.3,521,8.9,13455,4448,9007,4.1,12.3,15438,3691,11747,3.4,14.1,-1983,-1.8,24.6,0,343,344,1852
2011,43900,4695,5722,111195,109411,396,6.9,495,8.6,14649,2610,12039,2.4,13.4,11083,3536,7547,3.2,10.1,3566,3.3,20.2,0,340,342,2242
2012,43900,4680,5691,114051,112420,413,7.3,441,7.7,14295,3353,10942,3,12.7,11033,2612,8421,2.3,9.8,3262,2.9,19.6,0,271,271,1339
2013,43900,4706,5698,118818,116149,419,7.4,396,7,13969,3672,10297,3.2,12,8631,2535,6096,2.2,7.4,5338,4.6,14.8,0,272,276,1707
2014,43900,4672,5650,121830,120107,392,6.9,403,7.1,13956,4201,9755,3.5,11.6,10509,3106,7403,2.6,8.7,3447,2.9,17.4,0,287,287,2187
1977,44060,5998,6732,88004,85129,1250,19.1,861,13.2,18115,7447,10668,8.7,21.3,12365,5604,6761,6.6,14.5,5750,6.8,29,0,535,538,3388
1978,44060,6150,6959,98404,93138,1202,17.6,961,14,22625,6895,15730,7.4,24.3,12092,5917,6175,6.4,13,10533,11.3,26,0,606,606,3768
1979,44060,6344,7170,105239,101700,1190,16.9,916,13,22406,9048,13358,8.9,22,15328,6219,9109,6.1,15.1,7078,6.9,30.2,0,642,643,3567
1980,44060,6341,7180,104606,104793,1061,14.8,1004,14,21291,7622,13669,7.3,20.3,21665,6495,15170,6.2,20.7,-374,-0.4,40.6,0,686,688,3219
1981,44060,6164,7020,101206,102337,958,13.5,1052,14.8,19254,7162,12092,7,18.8,21517,8341,13176,8.2,21,-2263,-2.2,37.6,0,625,630,3824
1982,44060,6219,7205,98965,100049,1180,16.6,922,13,17710,8817,8893,8.8,17.7,19878,6292,13586,6.3,19.9,-2168,-2.2,35.4,0,521,521,3411
1983,44060,6488,7447,99812,99353,1032,14.1,867,11.8,17605,6559,11046,6.6,17.7,16686,5159,11527,5.2,16.8,919,0.9,33.6,0,548,550,2634
1984,44060,6767,7757,110041,104925,1120,14.7,814,10.7,24278,8675,15603,8.3,23.1,14045,4310,9735,4.1,13.4,10233,9.7,26.8,0,546,548,2517
1985,44060,6876,7874,112806,110884,1109,14.2,971,12.4,21502,7574,13928,6.8,19.4,17657,7077,10580,6.4,15.9,3845,3.5,31.8,0,630,644,5233
1986,44060,6989,8001,116073,114352,1137,14.3,962,12.1,22600,8230,14370,7.2,19.8,19158,6469,12689,5.7,16.8,3442,3,33.6,0,651,651,3773
1987,44060,7017,8079,114627,115232,1178,14.6,1056,13.1,21597,9067,12530,7.9,18.7,22807,8157,14650,7.1,19.8,-1210,-1.1,37.4,0,682,686,4689
1988,44060,6921,7986,116343,114976,1022,12.7,1055,13.1,21787,7036,14751,6.1,18.9,19053,7061,11992,6.1,16.6,2734,2.3,33.2,0,648,648,3171
1989,44060,5893,6949,117341,116788,867,11.6,1895,25.4,25997,6168,19829,5.3,22.3,24893,13957,10936,12,21.3,1104,1,42.6,0,580,581,3614
1990,44060,7168,8274,124458,120898,1949,25.6,588,7.7,28171,15295,12876,12.7,23.3,21052,4921,16131,4.1,17.4,7119,5.9,34.8,0,388,391,2862
1991,44060,7446,8609,130315,127390,1129,13.4,801,9.5,23728,8252,15476,6.5,18.6,17878,6159,11719,4.8,14,5850,4.6,28,0,478,481,3006
1992,44060,7858,9096,135772,133513,1342,15.1,821,9.3,23783,7933,15850,5.9,17.8,19264,5775,13489,4.3,14.4,4519,3.4,28.8,0,513,520,2696
1993,44060,8051,9309,139541,137168,1115,12.1,880,9.6,22397,7070,15327,5.2,16.3,17651,5830,11821,4.3,12.9,4746,3.4,25.8,0,580,585,3339
1994,44060,8426,9723,146353,142850,1341,14.1,902,9.5,24428,8431,15997,5.9,17.1,17421,5451,11970,3.8,12.2,7007,4.9,24.4,0,619,620,2844
1995,44060,8580,9895,150729,148422,1256,12.8,1040,10.6,23671,9012,14659,6.1,15.9,19056,6781,12275,4.6,12.8,4615,3.1,25.6,0,686,688,3705
1996,44060,8695,10017,151978,151362,1252,12.6,1106,11.1,22151,8201,13950,5.4,14.6,20918,7888,13030,5.2,13.8,1233,0.8,27.6,0,699,699,4757
1997,44060,8754,10143,154323,153217,1369,13.6,1215,12,27389,10248,17141,6.7,17.9,25177,10150,15027,6.6,16.4,2212,1.5,32.8,0,736,736,4176
1998,44060,8809,10255,158798,156496,1259,12.3,1127,11,26416,10026,16390,6.4,16.9,21811,7443,14368,4.8,13.9,4605,3,27.8,0,730,730,3715
1999,44060,8815,10318,161642,160383,1217,11.8,1118,10.9,25064,9552,15512,6,15.6,22546,7299,15247,4.6,14.1,2518,1.5,28.2,0,735,735,3597
2000,44060,8721,10242,166634,164046,1098,10.7,1173,11.4,26911,9549,17362,5.8,16.4,21735,7906,13829,4.8,13.2,5176,3.2,26.4,0,699,699,3688
2001,44060,8762,10341,168745,167981,1184,11.5,1179,11.4,24514,9985,14529,5.9,14.6,22986,7306,15680,4.3,13.7,1528,0.9,27.4,0,688,688,3280
2002,44060,8766,10370,164504,166542,1320,12.8,1268,12.3,26087,11303,14784,6.8,15.7,30162,9480,20682,5.7,18.1,-4075,-2.4,31.4,0,616,617,3534
2003,44060,8908,10526,167686,165265,1270,12.2,939,9,25663,9207,16456,5.6,15.5,20821,7095,13726,4.3,12.6,4842,2.9,25.2,0,626,626,3922
2004,44060,9033,10717,169503,167878,1280,12.1,994,9.4,24760,8609,16151,5.1,14.7,21509,6729,14780,4,12.8,3251,1.9,25.6,0,640,640,3560
2005,44060,9296,11033,174426,171622,1364,12.6,943,8.7,25343,9211,16132,5.4,14.8,19734,6833,12901,4,11.5,5609,3.3,23,0,628,628,3512
2006,44060,9494,11299,181689,177727,1360,12.2,1018,9.1,28791,10093,18698,5.7,16.2,20867,7282,13585,4.1,11.7,7924,4.5,23.4,0,681,682,4179
2007,44060,9716,11499,188070,184590,1426,12.5,1157,10.2,30606,9848,20758,5.3,16.6,23646,7955,15691,4.3,12.8,6960,3.8,25.6,0,695,700,3874
2008,44060,9731,11527,188202,187426,1226,10.7,1074,9.4,25430,8829,16601,4.7,13.6,23877,7430,16447,4,12.7,1553,0.9,25.4,0,722,722,4899
2009,44060,9358,11185,177492,182419,1015,9,1248,11,18473,6982,11491,3.8,10.1,28328,7911,20417,4.3,15.5,-9855,-5.4,20.2,0,810,814,4800
2010,44060,9314,11172,172289,174695,1026,9.2,989,8.9,19144,7193,11951,4.1,11,23956,5276,18680,3,13.7,-4812,-2.7,22,0,637,637,3083
2011,44060,9027,10884,168707,170136,918,8.3,1119,10.2,18154,6142,12012,3.6,10.7,21011,5720,15291,3.4,12.3,-2857,-1.6,21.4,0,708,708,3767
2012,44060,8973,10844,170104,169271,1018,9.4,1064,9.8,21413,6997,14416,4.1,12.7,19747,6646,13101,3.9,11.7,1666,1,23.4,0,618,630,3428
2013,44060,9002,10877,172694,170846,977,9,916,8.5,22147,6974,15173,4.1,13,18451,6473,11978,3.8,10.8,3696,2.2,21.6,0,591,594,4161
2014,44060,9087,10972,177234,174640,1090,10,927,8.5,26274,8924,17350,5.1,15,21086,8108,12978,4.6,12.1,5188,2.9,24.2,0,596,597,4851
1977,44100,3587,3898,60925,58973,635,16.7,458,12,13747,5743,8004,9.7,23.3,9842,3953,5889,6.7,16.7,3905,6.6,33.4,0,298,304,2481
1978,44100,3595,3925,63747,62475,504,12.9,476,12.2,11115,3893,7222,6.2,17.8,8571,4029,4542,6.4,13.7,2544,4.1,27.4,0,326,326,1955
1979,44100,3618,3952,65739,64735,504,12.8,456,11.6,11274,4223,7051,6.5,17.4,9266,3573,5693,5.5,14.3,2008,3.1,28.6,0,320,321,1506
1980,44100,3551,3907,61682,63716,428,10.9,454,11.6,8996,3472,5524,5.4,14.1,13063,2825,10238,4.4,20.5,-4067,-6.4,28.2,0,312,312,1784
1981,44100,3418,3757,58960,59157,426,11.2,512,13.4,8074,3212,4862,5.4,13.6,8467,3161,5306,5.3,14.3,-393,-0.7,27.2,0,295,295,1804
1982,44100,3392,3749,56508,57672,448,11.9,421,11.2,7847,3535,4312,6.1,13.6,10174,2895,7279,5,17.6,-2327,-4,27.2,0,255,255,1149
1983,44100,3384,3755,55751,56350,402,10.7,420,11.2,7488,2979,4509,5.3,13.3,8686,3052,5634,5.4,15.4,-1198,-2.1,26.6,0,259,259,1579
1984,44100,3500,3895,57738,56532,507,13.3,370,9.7,8798,3465,5333,6.1,15.6,6385,2108,4277,3.7,11.3,2413,4.3,22.6,0,229,229,937
1985,44100,3607,4011,62441,60971,466,11.8,375,9.5,9318,3900,5418,6.4,15.3,6377,2669,3708,4.4,10.5,2941,4.8,21,0,236,239,1512
1986,44100,3684,4101,65445,63938,466,11.5,368,9.1,10282,3779,6503,5.9,16.1,7267,3310,3957,5.2,11.4,3015,4.7,22.8,0,252,252,1783
1987,44100,3810,4253,67287,66301,567,13.6,396,9.5,10886,3981,6905,6,16.4,8914,3876,5038,5.8,13.4,1972,3,26.8,0,237,237,1579
1988,44100,3763,4205,64529,64899,444,10.5,446,10.6,10912,4772,6140,7.4,16.8,11651,3224,8427,5,18,-739,-1.2,33.6,0,277,277,1690
1989,44100,3811,4280,65262,64989,489,11.5,423,10,10384,4314,6070,6.6,16,9838,4307,5531,6.6,15.1,546,0.9,30.2,0,287,288,1862
1990,44100,3906,4376,69182,67130,469,10.8,337,7.8,11710,4412,7298,6.6,17.4,7606,3066,4540,4.6,11.3,4104,6.1,22.6,0,229,231,1457
1991,44100,3997,4470,73688,71346,475,10.7,386,8.7,13433,3660,9773,5.1,18.8,8748,3120,5628,4.4,12.3,4685,6.5,24.6,0,227,230,1815
1992,44100,4066,4570,73500,73504,547,12.1,434,9.6,11293,4245,7048,5.8,15.4,11300,4474,6826,6.1,15.4,-7,0,30.8,0,288,290,1582
1993,44100,4140,4652,72752,73168,520,11.3,423,9.2,9316,3595,5721,4.9,12.7,10147,3325,6822,4.5,13.9,-831,-1.2,25.4,0,273,275,1459
1994,44100,4244,4778,75686,74205,549,11.6,418,8.9,11275,4627,6648,6.2,15.2,8313,2994,5319,4,11.2,2962,4,22.4,0,283,283,1571
1995,44100,4338,4884,77476,76553,542,11.2,422,8.7,10248,3297,6951,4.3,13.4,8401,2416,5985,3.2,11,1847,2.4,22,0,268,270,1619
1996,44100,4401,4945,78070,77826,536,10.9,464,9.4,9663,2786,6877,3.6,12.4,9174,2986,6188,3.8,11.8,489,0.6,23.6,0,313,313,1629
1997,44100,4418,4997,78308,78168,602,12.1,533,10.7,10978,4724,6254,6,14,10697,3467,7230,4.4,13.7,281,0.3,27.4,0,337,337,1695
1998,44100,4411,5014,81431,80196,536,10.7,507,10.1,12812,5511,7301,6.9,16,10342,3606,6736,4.5,12.9,2470,3.1,25.8,0,334,334,2002
1999,44100,4396,5021,83163,82428,557,11.1,541,10.8,11924,4999,6925,6.1,14.5,10453,3195,7258,3.9,12.7,1471,1.8,25.4,0,343,343,1612
2000,44100,4422,5062,85041,83999,499,9.9,471,9.3,11030,3436,7594,4.1,13.1,8946,2615,6331,3.1,10.7,2084,2.4,21.4,0,301,301,1281
2001,44100,4381,5059,84086,84756,454,9,487,9.6,11250,4169,7081,4.9,13.3,12589,4239,8350,5,14.9,-1339,-1.6,26.6,0,306,306,1989
2002,44100,4348,5013,82750,83309,518,10.3,565,11.2,12638,5224,7414,6.3,15.2,13756,4915,8841,5.9,16.5,-1118,-1.3,30.4,0,260,260,1230
2003,44100,4349,5028,82760,82245,482,9.6,389,7.8,10618,3577,7041,4.3,12.9,9587,2748,6839,3.3,11.7,1031,1.2,23.4,0,256,256,1614
2004,44100,4379,5056,83006,82573,488,9.7,422,8.4,10691,4113,6578,5,12.9,9825,3337,6488,4,11.9,866,1,23.8,0,273,273,2035
2005,44100,4384,5076,82795,82736,474,9.4,411,8.1,9220,3646,5574,4.4,11.1,9101,2762,6339,3.3,11,119,0.1,22,0,258,258,1296
2006,44100,4360,5075,84239,83267,466,9.2,418,8.3,10808,3223,7585,3.9,13,8863,2857,6006,3.4,10.6,1945,2.4,21.2,0,289,289,1382
2007,44100,4338,5055,84935,84418,490,9.7,498,9.9,11061,4201,6860,5,13.1,10026,2828,7198,3.3,11.9,1035,1.2,23.8,0,324,326,1752
2008,44100,4322,5059,83897,83935,448,8.9,401,8,9600,3157,6443,3.8,11.4,9675,3298,6377,3.9,11.5,-75,-0.1,22.8,0,279,279,1603
2009,44100,4211,4932,82416,82991,349,7,429,8.6,8179,2484,5695,3,9.9,9329,2366,6963,2.9,11.2,-1150,-1.3,19.8,0,292,293,1507
2010,44100,4166,4907,83338,82701,356,7.3,366,7.5,9724,3824,5900,4.6,11.8,8449,2040,6409,2.5,10.2,1275,1.6,20.4,0,222,222,1185
2011,44100,4137,4880,84060,83531,366,7.5,362,7.4,8831,1846,6985,2.2,10.6,7773,2098,5675,2.5,9.3,1058,1.3,18.6,0,230,230,1070
2012,44100,4124,4844,84781,84393,368,7.6,399,8.2,11350,2657,8693,3.1,13.4,10574,2897,7677,3.4,12.5,776,0.9,25,0,223,226,992
2013,44100,4032,4766,84069,84242,343,7.2,408,8.5,9571,3225,6346,3.8,11.4,9916,3369,6547,4,11.8,-345,-0.4,22.8,0,236,243,2303
2014,44100,4014,4760,87292,85359,391,8.2,368,7.7,10942,3166,7776,3.7,12.8,7075,2058,5017,2.4,8.3,3867,4.5,16.6,0,237,237,1207
1977,44140,10162,11522,195319,188084,1486,13,1235,10.8,37302,13300,24002,7.1,19.8,22832,11070,11762,5.9,12.1,14470,7.7,24.2,0,767,772,5349
1978,44140,10328,11731,209646,202415,1307,11.2,1104,9.5,38645,13704,24941,6.8,19.1,24182,12480,11702,6.2,11.9,14463,7.2,23.8,0,760,771,4969
1979,44140,10376,11803,217615,213573,1307,11.1,1199,10.2,37044,15780,21264,7.4,17.3,28961,9170,19791,4.3,13.6,8083,3.7,27.2,0,778,780,3922
1980,44140,10451,11954,221662,219573,1327,11.2,1131,9.5,31571,9988,21583,4.5,14.4,27394,9045,18349,4.1,12.5,4177,1.9,25,0,785,788,4145
1981,44140,10161,11612,220373,220171,1220,10.4,1460,12.4,36597,11525,25072,5.2,16.6,36193,15046,21147,6.8,16.4,404,0.2,32.8,0,823,824,4648
1982,44140,10264,11938,221351,220900,1445,12.3,1077,9.1,31196,13160,18036,6,14.1,30293,8097,22196,3.7,13.7,903,0.4,27.4,0,605,605,3190
1983,44140,10450,12145,216663,219051,1233,10.2,1091,9.1,30127,10297,19830,4.7,13.8,34903,9856,25047,4.5,15.9,-4776,-2.1,27.6,0,716,720,4466
1984,44140,10792,12486,227682,224957,1370,11.1,1040,8.4,32423,10295,22128,4.6,14.4,26972,7179,19793,3.2,12,5451,2.4,24,0,672,676,3087
1985,44140,11101,12821,231829,229500,1409,11.1,1077,8.5,34141,10537,23604,4.6,14.9,29482,10537,18945,4.6,12.8,4659,2.1,25.6,0,724,724,4852
1986,44140,11393,13200,237779,234760,1591,12.2,1171,9,35767,13185,22582,5.6,15.2,29728,9932,19796,4.2,12.7,6039,2.5,25.4,0,788,788,4734
1987,44140,11852,13784,250529,244802,1890,14,1261,9.3,44582,16667,27915,6.8,18.2,33127,12331,20796,5,13.5,11455,4.7,27,0,858,863,5726
1988,44140,12086,14075,261322,255706,1715,12.3,1368,9.8,45289,13893,31396,5.4,17.7,34056,12154,21902,4.8,13.3,11233,4.4,26.6,0,917,917,5165
1989,44140,12222,14282,262625,262097,1544,10.9,1374,9.7,39385,11939,27446,4.6,15,38329,11350,26979,4.3,14.6,1056,0.4,29.2,0,946,984,6014
1990,44140,12105,14171,251321,256830,1386,9.7,1399,9.8,29854,10955,18899,4.3,11.6,40872,11406,29466,4.4,15.9,-11018,-4.3,23.2,0,972,983,5775
1991,44140,11747,13835,237125,244024,1289,9.2,1604,11.5,27983,10172,17811,4.2,11.5,41781,12406,29375,5.1,17.1,-13798,-5.6,23,0,986,1002,6068
1992,44140,11519,13628,234404,235953,1292,9.4,1415,10.3,28981,10593,18388,4.5,12.3,32078,11361,20717,4.8,13.6,-3097,-1.3,24.6,0,920,925,7179
1993,44140,11418,13434,229021,231633,1175,8.7,1339,9.9,26838,8222,18616,3.5,11.6,32062,11084,20978,4.8,13.8,-5224,-2.2,23.2,0,841,847,3717
1994,44140,11455,13481,226219,227582,1287,9.6,1217,9,28332,9257,19075,4.1,12.4,31058,10326,20732,4.5,13.6,-2726,-1.2,24.8,0,803,803,4454
1995,44140,11511,13537,235038,230402,1302,9.6,1212,9,35470,11936,23534,5.2,15.4,26197,9563,16634,4.2,11.4,9273,4,22.8,0,755,768,4545
1996,44140,11526,13593,235045,235167,1274,9.4,1190,8.8,28049,10845,17204,4.6,11.9,28293,9864,18429,4.2,12,-244,-0.1,23.8,0,769,769,4319
1997,44140,11635,13783,241496,238432,1367,10,1194,8.7,34353,13136,21217,5.5,14.4,28224,10459,17765,4.4,11.8,6129,2.6,23.6,0,698,698,3865
1998,44140,11645,13783,243346,242323,1268,9.2,1225,8.9,32006,10057,21949,4.2,13.2,29959,11023,18936,4.5,12.4,2047,0.8,24.8,0,804,804,5814
1999,44140,11625,13788,258181,250722,1158,8.4,1165,8.5,49305,25052,24253,10,19.7,34386,8782,25604,3.5,13.7,14919,6,27.4,0,745,745,3728
2000,44140,11626,13791,246008,251921,1205,8.7,1208,8.8,33514,10650,22864,4.2,13.3,45339,12310,33029,4.9,18,-11825,-4.7,26.6,0,696,696,4219
2001,44140,11827,14040,248127,247576,1302,9.3,1260,9,32299,12273,20026,5,13,31197,9852,21345,4,12.6,1102,0.4,25.2,0,703,703,3730
2002,44140,11891,14172,248176,248081,1491,10.6,1337,9.5,36606,14083,22523,5.7,14.8,36415,13663,22752,5.5,14.7,191,0.1,29.4,0,675,675,4931
2003,44140,12347,14621,246162,245902,1916,13.4,1291,9,32106,11915,20191,4.8,13.1,31585,9917,21668,4,12.8,521,0.3,25.6,0,889,889,4398
2004,44140,11874,14159,243236,243963,1362,9.5,1714,11.9,26963,8034,18929,3.3,11.1,28417,9591,18826,3.9,11.6,-1454,-0.5,22.2,0,1356,1357,5571
2005,44140,11765,14081,245060,243727,1318,9.4,1305,9.3,29901,11150,18751,4.6,12.3,27235,7256,19979,3,11.2,2666,1.1,22.4,0,921,921,4361
2006,44140,11773,14109,246922,245189,1385,9.9,1239,8.8,28848,9917,18931,4,11.8,25381,7835,17546,3.2,10.4,3467,1.4,20.8,0,853,854,4734
2007,44140,11748,14134,246471,246434,1324,9.4,1296,9.2,33466,10278,23188,4.2,13.6,33391,9728,23663,3.9,13.5,75,0.1,27,0,794,799,4703
2008,44140,11598,14002,249702,248249,1155,8.2,1154,8.2,26105,7109,18996,2.9,10.5,23199,6396,16803,2.6,9.3,2906,1.2,18.6,0,814,814,4022
2009,44140,11319,13736,247023,248024,1060,7.7,1223,8.8,27689,7778,19911,3.1,11.2,29690,7233,22457,2.9,12,-2001,-0.8,22.4,0,777,777,3888
2010,44140,11135,13542,240268,242865,985,7.2,1090,8,27230,9128,18102,3.8,11.2,32424,6248,26176,2.6,13.4,-5194,-2.2,22.4,0,722,722,3801
2011,44140,10949,13363,239554,238728,986,7.3,1051,7.8,23023,6608,16415,2.8,9.6,21371,5683,15688,2.4,9,1652,0.6,18,0,655,656,3202
2012,44140,11105,13493,240970,239985,1131,8.4,1011,7.5,24847,5874,18973,2.4,10.4,22876,6235,16641,2.6,9.5,1971,0.9,19,0,611,616,3445
2013,44140,11062,13467,256697,248637,962,7.2,996,7.4,35046,15515,19531,6.2,14.1,18925,5077,13848,2,7.6,16121,6.5,15.2,0,604,615,2852
2014,44140,11013,13413,244766,250023,1008,7.5,982,7.3,20991,5981,15010,2.4,8.4,31504,5644,25860,2.3,12.6,-10513,-4.2,16.8,0,654,655,3467
1977,44180,4633,5101,71480,68876,922,18.5,697,14,14935,6073,8862,8.8,21.7,9727,4222,5505,6.1,14.1,5208,7.6,28.2,0,474,474,2525
1978,44180,4778,5277,78353,74884,923,17.8,737,14.2,17025,6053,10972,8.1,22.7,10086,4532,5554,6.1,13.5,6939,9.2,27,0,510,515,2717
1979,44180,4883,5397,82883,80572,843,15.8,679,12.7,14565,4939,9626,6.1,18.1,9943,4020,5923,5,12.3,4622,5.8,24.6,0,490,493,2653
1980,44180,4861,5370,83485,83169,689,12.8,677,12.6,12479,4129,8350,5,15,11847,3652,8195,4.4,14.2,632,0.8,28.4,0,502,503,2536
1981,44180,4718,5196,81622,81656,716,13.6,818,15.5,12762,5176,7586,6.3,15.6,12830,5034,7796,6.2,15.7,-68,-0.1,31.2,0,519,519,2580
1982,44180,4686,5228,82514,81853,769,14.8,667,12.8,14048,6453,7595,7.9,17.2,12725,5541,7184,6.8,15.5,1323,1.7,31,0,389,390,2319
1983,44180,4958,5493,82903,82365,772,14.4,570,10.6,13593,5802,7791,7,16.5,12517,4286,8231,5.2,15.2,1076,1.3,30.4,0,390,396,2261
1984,44180,5166,5735,89081,86109,890,15.9,646,11.5,16168,5488,10680,6.4,18.8,10224,4261,5963,4.9,11.9,5944,6.9,23.8,0,407,407,2399
1985,44180,5375,5954,95229,93096,881,15,680,11.6,14799,5274,9525,5.7,15.9,10533,3813,6720,4.1,11.3,4266,4.6,22.6,0,465,465,2295
1986,44180,5758,6349,99342,97214,995,16.2,593,9.6,16835,7007,9828,7.2,17.3,12578,4570,8008,4.7,12.9,4257,4.4,25.8,0,340,346,2607
1987,44180,6029,6682,102626,100977,1102,16.9,754,11.6,17387,6668,10719,6.6,17.2,14089,5269,8820,5.2,14,3298,3.2,28,0,507,515,2909
1988,44180,6102,6784,105277,103052,948,14.1,764,11.4,16614,6191,10423,6,16.1,12163,4392,7771,4.3,11.8,4451,4.3,23.6,0,558,558,2303
1989,44180,6230,6946,116502,110996,895,13,736,10.7,23355,5885,17470,5.3,21,12343,4177,8166,3.8,11.1,11012,9.9,22.2,0,513,518,2683
1990,44180,6412,7157,116101,116387,926,13.1,664,9.4,18094,5664,12430,4.9,15.5,18665,4698,13967,4,16,-571,-0.5,31,0,480,481,3070
1991,44180,6536,7351,116764,116398,965,13.3,765,10.5,17573,8326,9247,7.2,15.1,16840,6267,10573,5.4,14.5,733,0.6,29,0,519,521,3560
1992,44180,6704,7567,121723,118758,1009,13.5,752,10.1,20565,8297,12268,7,17.3,14635,5184,9451,4.4,12.3,5930,5,24.6,0,534,535,3241
1993,44180,6961,7827,124751,123193,974,12.7,692,9,19127,6243,12884,5.1,15.5,16011,6275,9736,5.1,13,3116,2.5,26,0,510,511,4033
1994,44180,7271,8169,133253,128813,1173,14.7,812,10.2,24775,8988,15787,7,19.2,15895,6321,9574,4.9,12.3,8880,6.9,24.6,0,589,590,3562
1995,44180,7482,8429,140996,137068,1200,14.5,901,10.9,26862,8482,18380,6.2,19.6,19006,6121,12885,4.5,13.9,7856,5.7,27.8,0,674,674,4600
1996,44180,7626,8613,142221,141447,1149,13.5,956,11.2,22492,9486,13006,6.7,15.9,20944,6707,14237,4.7,14.8,1548,1.1,29.6,0,650,650,3432
1997,44180,7732,8784,145320,143754,1221,14,1021,11.7,26823,10402,16421,7.2,18.7,23691,7805,15886,5.4,16.5,3132,2.2,33,0,697,697,4519
1998,44180,7803,8901,150543,147958,1138,12.9,1004,11.4,24988,9448,15540,6.4,16.9,19818,7913,11905,5.3,13.4,5170,3.5,26.8,0,697,697,3959
1999,44180,7857,9022,155927,153188,1097,12.2,958,10.7,24398,8805,15593,5.7,15.9,18919,6582,12337,4.3,12.4,5479,3.5,24.8,0,690,690,3406
2000,44180,7935,9190,162224,159094,1184,13,1014,11.1,27363,11431,15932,7.2,17.2,21103,8742,12361,5.5,13.3,6260,3.9,26.6,0,655,655,3178
2001,44180,8008,9333,161462,161989,1085,11.7,1026,11.1,22070,8059,14011,5,13.6,23124,6628,16496,4.1,14.3,-1054,-0.7,27.2,0,673,673,3334
2002,44180,8019,9439,161217,161171,1288,13.7,1168,12.5,25390,10981,14409,6.8,15.8,25297,8071,17226,5,15.7,93,0.1,31.4,0,712,712,3837
2003,44180,8164,9606,166911,163282,1214,12.8,877,9.2,26859,8540,18319,5.2,16.4,19600,7204,12396,4.4,12,7259,4.4,24,0,644,644,4057
2004,44180,8352,9822,172550,169403,1213,12.5,932,9.6,25802,7400,18402,4.4,15.2,19508,6298,13210,3.7,11.5,6294,3.7,23,0,671,671,4006
2005,44180,8619,10159,172895,172372,1351,13.6,933,9.4,24257,9782,14475,5.7,14.1,23210,7374,15836,4.3,13.5,1047,0.6,27,0,669,669,5636
2006,44180,8706,10284,176465,174385,1303,12.8,1083,10.6,25165,9775,15390,5.6,14.4,21004,8409,12595,4.8,12,4161,2.4,24,0,769,771,5359
2007,44180,8771,10387,175984,175989,1195,11.6,1084,10.5,26725,9912,16813,5.6,15.2,26734,9585,17149,5.4,15.2,-9,0,30.4,0,760,765,4972
2008,44180,8783,10427,179387,176886,1135,10.9,984,9.5,26141,9004,17137,5.1,14.8,21138,6792,14346,3.8,12,5003,2.8,24,0,749,749,4492
2009,44180,8436,10098,169148,173283,898,8.8,1176,11.5,19510,5708,13802,3.3,11.3,27780,8576,19204,4.9,16,-8270,-4.7,22.6,0,877,877,5539
2010,44180,8254,9915,162018,165099,895,9,1000,10,19724,7593,12131,4.6,11.9,25885,6620,19265,4,15.7,-6161,-3.8,23.8,0,706,713,5163
2011,44180,8109,9803,164098,162723,959,9.8,997,10.1,22166,7447,14719,4.6,13.6,19416,5500,13916,3.4,11.9,2750,1.7,23.8,0,736,736,4006
2012,44180,8135,9870,168756,166383,1021,10.4,986,10,23578,8233,15345,4.9,14.2,18831,6221,12610,3.7,11.3,4747,2.9,22.6,0,671,674,3223
2013,44180,8286,10016,170239,169294,987,10,840,8.5,20632,5272,15360,3.1,12.2,18742,6096,12646,3.6,11.1,1890,1.1,22.2,0,562,563,3475
2014,44180,8573,10308,173444,171573,1163,11.5,799,7.9,18701,5552,13149,3.2,10.9,14958,4145,10813,2.4,8.7,3743,2.2,17.4,0,597,597,2890
1977,44220,2106,2401,39693,39838,364,15.4,294,12.4,6337,2887,3450,7.2,15.9,6627,2909,3718,7.3,16.6,-290,-0.7,31.8,0,175,176,1762
1978,44220,2088,2392,42520,41111,261,10.9,271,11.3,6930,2192,4738,5.3,16.9,4111,1588,2523,3.9,10,2819,6.9,20,0,178,178,809
1979,44220,2120,2419,44842,43663,284,11.8,242,10.1,6947,1948,4999,4.5,15.9,4589,1812,2777,4.1,10.5,2358,5.4,21,0,149,150,842
1980,44220,2079,2348,37277,41019,235,9.9,294,12.3,4533,1676,2857,4.1,11.1,12016,2758,9258,6.7,29.3,-7483,-18.2,22.2,0,166,167,745
1981,44220,1998,2265,40684,38648,232,10.1,296,12.9,10363,3925,6438,10.2,26.8,6290,2750,3540,7.1,16.3,4073,10.5,32.6,0,152,152,661
1982,44220,1969,2263,37358,38980,260,11.5,243,10.7,4490,2015,2475,5.2,11.5,7734,1206,6528,3.1,19.8,-3244,-8.3,23,0,143,143,801
1983,44220,1962,2240,35830,36609,194,8.6,240,10.7,4326,1101,3225,3,11.8,5884,2025,3859,5.5,16.1,-1558,-4.3,23.6,0,142,145,824
1984,44220,2006,2294,39579,37690,262,11.6,208,9.2,7579,1669,5910,4.4,20.1,3800,1054,2746,2.8,10.1,3779,10,20.2,0,130,130,653
1985,44220,2044,2322,40585,40063,266,11.5,236,10.2,5168,1317,3851,3.3,12.9,4123,1628,2495,4.1,10.3,1045,2.6,20.6,0,144,144,914
1986,44220,2086,2366,41071,40817,251,10.7,201,8.6,5546,2308,3238,5.7,13.6,5037,1229,3808,3,12.3,509,1.3,24.6,0,133,133,610
1987,44220,2135,2438,42303,41722,293,12.2,205,8.5,6678,2542,4136,6.1,16,5515,1920,3595,4.6,13.2,1163,2.8,26.4,0,131,131,791
1988,44220,2137,2445,44229,43317,252,10.3,239,9.8,7167,1880,5287,4.3,16.5,5342,1729,3613,4,12.3,1825,4.2,24.6,0,153,153,755
1989,44220,2138,2448,46358,45370,233,9.5,240,9.8,6977,1882,5095,4.1,15.4,5000,2274,2726,5,11,1977,4.4,22,0,140,142,645
1990,44220,2175,2490,45842,46083,257,10.4,203,8.2,6055,2330,3725,5.1,13.1,6536,1288,5248,2.8,14.2,-481,-1.1,26.2,0,130,130,694
1991,44220,2205,2508,47623,46717,239,9.6,220,8.8,6995,2224,4771,4.8,15,5182,1529,3653,3.3,11.1,1813,3.9,22.2,0,143,146,999
1992,44220,2189,2507,46377,47081,235,9.3,231,9.2,5458,1616,3842,3.4,11.6,6866,1719,5147,3.7,14.6,-1408,-3,23.2,0,141,142,919
1993,44220,2195,2502,46508,46456,192,7.7,196,7.8,4833,936,3897,2,10.4,4729,1427,3302,3.1,10.2,104,0.2,20.4,0,122,122,539
1994,44220,2216,2529,47304,46877,225,8.9,195,7.8,5591,2216,3375,4.7,11.9,4736,1403,3333,3,10.1,855,1.8,20.2,0,138,138,842
1995,44220,2251,2557,48698,47979,237,9.3,201,7.9,6462,1593,4869,3.3,13.5,5024,1986,3038,4.1,10.5,1438,3,21,0,136,136,810
1996,44220,2244,2543,49617,49158,239,9.4,245,9.6,6705,2420,4285,4.9,13.6,5787,1551,4236,3.2,11.8,918,1.8,23.6,0,141,141,596
1997,44220,2243,2530,47489,48624,261,10.3,270,10.6,6430,2179,4251,4.5,13.2,8700,3217,5483,6.6,17.9,-2270,-4.7,26.4,0,168,168,1534
1998,44220,2250,2543,48484,47981,236,9.3,227,8.9,7783,2723,5060,5.7,16.2,6777,2185,4592,4.6,14.1,1006,2.1,28.2,0,136,136,610
1999,44220,2194,2502,49387,48945,219,8.7,249,9.9,6498,1930,4568,3.9,13.3,5614,1979,3635,4,11.5,884,1.8,23,0,164,164,931
2000,44220,2181,2484,50643,50014,174,7,193,7.7,6289,1418,4871,2.8,12.6,5031,1647,3384,3.3,10.1,1258,2.5,20.2,0,123,123,543
2001,44220,2159,2459,48978,49834,192,7.8,233,9.4,5587,2462,3125,4.9,11.2,7298,2160,5138,4.3,14.6,-1711,-3.4,22.4,0,138,138,821
2002,44220,2186,2483,46898,47876,247,10,223,9,6369,2369,4000,4.9,13.3,8325,1926,6399,4,17.4,-1956,-4.1,26.6,0,107,107,586
2003,44220,2134,2430,45694,45966,212,8.7,213,8.7,5871,2070,3801,4.5,12.8,6414,1741,4673,3.8,14,-543,-1.2,25.6,0,145,145,1056
2004,44220,2101,2389,44836,45139,175,7.3,187,7.8,4894,1248,3646,2.8,10.8,5499,1772,3727,3.9,12.2,-605,-1.4,21.6,0,123,123,920
2005,44220,2137,2440,46514,45623,213,8.8,151,6.3,7171,2642,4529,5.8,15.7,5389,941,4448,2.1,11.8,1782,3.9,23.6,0,107,107,681
2006,44220,2092,2395,44819,44966,201,8.3,222,9.2,5055,1416,3639,3.1,11.2,5349,1225,4124,2.7,11.9,-294,-0.7,22.4,0,149,149,805
2007,44220,2073,2391,44244,44535,208,8.7,218,9.1,6917,2067,4850,4.6,15.5,7498,1515,5983,3.4,16.8,-581,-1.3,31,0,143,143,952
2008,44220,2041,2363,44133,44111,196,8.3,195,8.2,4886,1711,3175,3.9,11.1,4841,1422,3419,3.2,11,45,0.1,22,0,123,123,678
2009,44220,1979,2303,42834,43451,140,6,183,7.9,4341,1380,2961,3.2,10,5574,1300,4274,3,12.8,-1233,-2.8,20,0,118,118,842
2010,44220,1937,2259,41855,42155,143,6.3,168,7.4,4216,1328,2888,3.2,10,4816,1193,3623,2.8,11.4,-600,-1.4,20,0,101,101,689
2011,44220,1922,2242,42392,42053,159,7.1,153,6.8,4644,885,3759,2.1,11,3966,1099,2867,2.6,9.4,678,1.6,18.8,0,113,113,608
2012,44220,1911,2221,44088,43290,142,6.4,159,7.1,5785,1047,4738,2.4,13.4,4189,1391,2798,3.2,9.7,1596,3.7,19.4,0,93,94,847
2013,44220,1888,2203,43781,43840,130,5.9,143,6.5,5061,1038,4023,2.4,11.5,5178,1286,3892,2.9,11.8,-117,-0.3,23,0,93,93,974
2014,44220,1842,2149,42028,42774,132,6.1,162,7.5,4756,1310,3446,3.1,11.1,6247,2813,3434,6.6,14.6,-1491,-3.5,22.2,0,119,119,834
1977,44300,1595,1769,24065,23502,264,15.2,202,11.6,4114,1596,2518,6.8,17.5,2987,1154,1833,4.9,12.7,1127,4.8,25.4,0,137,138,685
1978,44300,1625,1817,25375,24721,247,13.8,199,11.1,4887,1695,3192,6.9,19.8,3578,1846,1732,7.5,14.5,1309,5.3,29,0,125,125,1087
1979,44300,1678,1875,26131,25734,232,12.6,161,8.7,4477,1608,2869,6.2,17.4,3683,1697,1986,6.6,14.3,794,3.1,28.6,0,106,106,1060
1980,44300,1693,1894,25896,26015,205,10.9,176,9.3,3638,1338,2300,5.1,14,3876,1762,2114,6.8,14.9,-238,-0.9,28,0,112,114,1284
1981,44300,1644,1836,27028,26279,188,10.1,223,12,5596,2781,2815,10.6,21.3,4097,1694,2403,6.4,15.6,1499,5.7,31.2,0,125,126,742
1982,44300,1651,1890,27195,27115,245,13.1,170,9.1,4147,2311,1836,8.5,15.3,3986,1287,2699,4.7,14.7,161,0.6,29.4,0,109,109,728
1983,44300,1728,1954,27014,27121,212,11,162,8.4,3827,1180,2647,4.4,14.1,4041,1197,2844,4.4,14.9,-214,-0.8,28.2,0,91,92,412
1984,44300,1796,2026,29407,28277,269,13.5,199,10,5449,1853,3596,6.6,19.3,3189,1125,2064,4,11.3,2260,8,22.6,0,118,118,535
1985,44300,1863,2092,30993,30236,253,12.3,192,9.3,4953,1832,3121,6.1,16.4,3439,1405,2034,4.6,11.4,1514,5,22.8,0,128,129,860
1986,44300,1945,2191,32082,31510,314,14.7,202,9.4,5324,2586,2738,8.2,16.9,4180,2063,2117,6.5,13.3,1144,3.6,26.6,0,121,121,1498
1987,44300,2047,2325,34442,33432,356,15.8,215,9.5,6943,3071,3872,9.2,20.8,4923,1805,3118,5.4,14.7,2020,6.1,29.4,0,140,141,1122
1988,44300,2077,2356,35566,34885,278,11.9,229,9.8,6221,1979,4242,5.7,17.8,4858,2021,2837,5.8,13.9,1363,3.9,27.8,0,148,148,1228
1989,44300,2115,2414,37230,36366,253,10.6,194,8.1,6408,1946,4462,5.4,17.6,4679,1734,2945,4.8,12.9,1729,4.7,25.8,0,133,133,571
1990,44300,2183,2495,39948,38601,265,10.8,179,7.3,6840,2094,4746,5.4,17.7,4145,1663,2482,4.3,10.7,2695,7,21.4,0,114,114,848
1991,44300,2248,2583,38535,39284,281,11.1,197,7.8,5776,2578,3198,6.6,14.7,7273,2683,4590,6.8,18.5,-1497,-3.8,29.4,0,131,131,1083
1992,44300,2278,2615,39219,38882,257,9.9,220,8.5,5903,1988,3915,5.1,15.2,5229,1679,3550,4.3,13.4,674,1.8,26.8,0,150,150,862
1993,44300,2300,2629,39639,39420,230,8.8,206,7.9,5258,1850,3408,4.7,13.3,4819,1258,3561,3.2,12.2,439,1.1,24.4,0,139,140,789
1994,44300,2337,2671,39870,39738,286,10.8,231,8.7,6182,2533,3649,6.4,15.6,5918,2463,3455,6.2,14.9,264,0.7,29.8,0,149,149,1515
1995,44300,2391,2733,41285,40548,266,9.8,197,7.3,5896,2178,3718,5.4,14.5,4422,1478,2944,3.6,10.9,1474,3.6,21.8,0,127,127,734
1996,44300,2430,2765,44196,42743,253,9.2,218,7.9,6834,2390,4444,5.6,16,3928,1046,2882,2.4,9.2,2906,6.8,18.4,0,152,152,755
1997,44300,2416,2764,42986,43586,275,9.9,269,9.7,5312,1922,3390,4.4,12.2,6512,2462,4050,5.6,14.9,-1200,-2.7,24.4,0,175,175,1111
1998,44300,2463,2809,43606,43292,263,9.4,219,7.9,5211,1667,3544,3.9,12,4583,1452,3131,3.4,10.6,628,1.4,21.2,0,132,132,692
1999,44300,2462,2808,44297,43915,261,9.3,262,9.3,6291,1961,4330,4.5,14.3,5527,1652,3875,3.8,12.6,764,1.7,25.2,0,166,166,888
2000,44300,2472,2832,45979,45158,252,8.9,223,7.9,7096,2761,4335,6.1,15.7,5454,1628,3826,3.6,12.1,1642,3.6,24.2,0,133,133,758
2001,44300,2492,2851,45838,45990,257,9,264,9.3,5914,2596,3318,5.6,12.9,6217,1672,4545,3.6,13.5,-303,-0.6,25.8,0,155,155,957
2002,44300,2507,2868,43258,44273,298,10.4,275,9.6,6505,2934,3571,6.6,14.7,8534,2199,6335,5,19.3,-2029,-4.6,29.4,0,136,137,734
2003,44300,2515,2884,44741,43688,255,8.9,202,7,6748,2066,4682,4.7,15.4,4642,1250,3392,2.9,10.6,2106,4.8,21.2,0,135,135,771
2004,44300,2526,2912,44014,43839,283,9.8,229,7.9,5883,2071,3812,4.7,13.4,5533,1608,3925,3.7,12.6,350,0.8,25.2,0,157,157,1192
2005,44300,2580,2972,44137,43657,296,10.1,210,7.2,6073,2216,3857,5.1,13.9,5113,1385,3728,3.2,11.7,960,2.2,23.4,0,133,133,850
2006,44300,2609,3023,45245,44583,328,11,239,8,6629,2505,4124,5.6,14.9,5304,2032,3272,4.6,11.9,1325,3,23.8,0,153,156,1626
2007,44300,2619,3019,43959,44363,256,8.5,252,8.4,6245,1564,4681,3.5,14.1,7053,2255,4798,5.1,15.9,-808,-1.8,28.2,0,148,149,997
2008,44300,2578,2984,44797,44427,245,8.2,251,8.4,5938,1984,3954,4.5,13.4,5198,1621,3577,3.6,11.7,740,1.7,23.4,0,160,160,809
2009,44300,2564,2985,43574,44143,222,7.5,209,7,4631,1535,3096,3.5,10.5,5769,1328,4441,3,13.1,-1138,-2.6,21,0,138,138,1048
2010,44300,2531,2953,43501,43409,202,6.8,213,7.2,5879,2576,3303,5.9,13.5,5694,1769,3925,4.1,13.1,185,0.4,26.2,0,142,142,1223
2011,44300,2546,2988,44296,43834,246,8.3,199,6.7,5437,1672,3765,3.8,12.4,4512,1042,3470,2.4,10.3,925,2.1,20.6,0,140,140,573
2012,44300,2558,3005,44773,44380,229,7.7,210,7,6959,1481,5478,3.3,15.7,6173,2024,4149,4.6,13.9,786,1.8,27.8,0,114,115,687
2013,44300,2554,3000,45480,45048,212,7.1,213,7.1,6128,1492,4636,3.3,13.6,5263,1171,4092,2.6,11.7,865,1.9,23.4,0,138,138,914
2014,44300,2597,3051,46214,45766,250,8.3,175,5.8,5504,2393,3111,5.2,12,4607,1321,3286,2.9,10.1,897,1.9,20.2,0,112,112,777
1977,44600,2322,2534,50322,50358,346,13.8,294,11.7,5388,2415,2973,4.8,10.7,5460,2271,3189,4.5,10.8,-72,-0.1,21.4,0,196,196,1108
1978,44600,2307,2522,50514,50413,302,11.9,319,12.6,5799,1682,4117,3.3,11.5,5597,2272,3325,4.5,11.1,202,0.4,22.2,0,241,241,939
1979,44600,2308,2525,54546,52514,311,12.3,297,11.8,8432,2733,5699,5.2,16.1,4367,1642,2725,3.1,8.3,4065,7.8,16.6,0,203,205,888
1980,44600,2281,2502,52461,53481,251,10,259,10.3,4381,1298,3083,2.4,8.2,6420,1322,5098,2.5,12,-2039,-3.8,16.4,0,170,172,710
1981,44600,2160,2373,48905,50393,226,9.3,327,13.5,4083,1612,2471,3.2,8.1,7059,2084,4975,4.1,14,-2976,-5.9,16.2,0,193,193,680
1982,44600,2086,2311,43418,46159,255,10.9,289,12.3,3722,1627,2095,3.5,8.1,9203,1982,7221,4.3,19.9,-5481,-11.8,16.2,0,174,175,738
1983,44600,2091,2314,40311,41835,205,8.9,228,9.9,4140,991,3149,2.4,9.9,7188,1167,6021,2.8,17.2,-3048,-7.3,19.8,0,156,156,659
1984,44600,2058,2282,41539,41028,239,10.4,265,11.5,5230,1247,3983,3,12.7,4208,1853,2355,4.5,10.3,1022,2.4,20.6,0,148,148,586
1985,44600,2148,2370,42048,41847,281,12.1,197,8.5,4726,1791,2935,4.3,11.3,4323,1678,2645,4,10.3,403,1,20.6,0,104,104,649
1986,44600,2141,2362,41325,41676,265,11.2,259,11,11783,9497,2286,22.8,28.3,12484,9096,3388,21.8,30,-701,-1.7,56.6,0,173,173,766
1987,44600,2137,2369,43683,42466,277,11.7,251,10.6,6119,2594,3525,6.1,14.4,3685,1559,2126,3.7,8.7,2434,5.7,17.4,0,163,163,766
1988,44600,2124,2359,43007,43047,237,10,250,10.6,4833,1980,2853,4.6,11.2,4913,1984,2929,4.6,11.4,-80,-0.2,22.4,0,158,158,585
1989,44600,2125,2376,44259,43773,226,9.5,208,8.8,5095,1911,3184,4.4,11.6,4122,1518,2604,3.5,9.4,973,2.2,18.8,0,132,134,1110
1990,44600,2167,2428,45103,44676,240,10,173,7.2,4337,1761,2576,3.9,9.7,3483,1105,2378,2.5,7.8,854,1.9,15.6,0,123,123,587
1991,44600,2197,2479,44670,44881,248,10.1,201,8.2,4593,1991,2602,4.4,10.2,5015,1079,3936,2.4,11.2,-422,-1,20.4,0,132,132,699
1992,44600,2206,2489,44263,44471,224,9,210,8.4,4662,1213,3449,2.7,10.5,5077,1573,3504,3.5,11.4,-415,-0.9,21,0,130,131,629
1993,44600,2240,2513,44815,44612,224,9,196,7.8,4408,1339,3069,3,9.9,4001,1278,2723,2.9,9,407,0.9,18,0,128,128,585
1994,44600,2275,2536,42538,43676,240,9.5,209,8.3,4185,1550,2635,3.5,9.6,6460,1723,4737,3.9,14.8,-2275,-5.2,19.2,0,137,138,982
1995,44600,2281,2541,45082,43789,228,9,217,8.6,6347,1406,4941,3.2,14.5,3761,946,2815,2.2,8.6,2586,5.9,17.2,0,141,141,469
1996,44600,2290,2553,44239,44642,227,8.9,215,8.4,4683,1848,2835,4.1,10.5,5488,1475,4013,3.3,12.3,-805,-1.8,21,0,148,148,589
1997,44600,2285,2550,40837,42565,242,9.5,245,9.6,4653,1824,2829,4.3,10.9,8108,1738,6370,4.1,19,-3455,-8.1,21.8,0,146,146,636
1998,44600,2285,2542,42985,41903,239,9.4,244,9.6,5888,1515,4373,3.6,14.1,3723,1148,2575,2.7,8.9,2165,5.2,17.8,0,163,163,727
1999,44600,2244,2499,43384,43203,190,7.5,233,9.2,5987,1221,4766,2.8,13.9,5625,2265,3360,5.2,13,362,0.9,26,0,159,159,800
2000,44600,2203,2454,43785,43590,190,7.7,236,9.5,4561,1628,2933,3.7,10.5,4171,1298,2873,3,9.6,390,0.9,19.2,0,134,134,551
2001,44600,2169,2432,42789,43306,189,7.7,223,9.1,4287,1417,2870,3.3,9.9,5321,1028,4293,2.4,12.3,-1034,-2.4,19.8,0,123,123,454
2002,44600,2170,2436,38110,40411,243,10,237,9.7,5717,2912,2805,7.2,14.1,10318,5829,4489,14.4,25.5,-4601,-11.4,28.2,0,123,123,609
2003,44600,2135,2399,41856,39632,207,8.6,203,8.4,8347,5632,2715,14.2,21.1,3899,1405,2494,3.5,9.8,4448,11.3,19.6,0,135,135,809
2004,44600,2129,2396,40682,41237,203,8.5,182,7.6,3815,1216,2599,2.9,9.3,4924,1134,3790,2.7,11.9,-1109,-2.6,18.6,0,126,126,861
2005,44600,2130,2406,41170,40816,222,9.3,192,8,4978,1968,3010,4.8,12.2,4269,1389,2880,3.4,10.5,709,1.7,21,0,132,132,690
2006,44600,2066,2347,41102,40981,212,9,242,10.2,4245,1578,2667,3.9,10.4,4002,1495,2507,3.6,9.8,243,0.6,19.6,0,147,147,1126
2007,44600,2050,2336,39665,40353,208,8.9,225,9.6,4312,1370,2942,3.4,10.7,5687,1522,4165,3.8,14.1,-1375,-3.4,21.4,0,142,142,844
2008,44600,1971,2268,39980,39777,149,6.5,193,8.4,4571,1095,3476,2.8,11.5,4165,1147,3018,2.9,10.5,406,1,21,0,139,139,596
2009,44600,1907,2200,38163,39048,119,5.3,180,8.1,2981,780,2201,2,7.6,4751,899,3852,2.3,12.2,-1770,-4.6,15.2,0,128,128,612
2010,44600,1873,2162,37148,37568,143,6.6,169,7.8,4066,1324,2742,3.5,10.8,4905,1046,3859,2.8,13.1,-839,-2.3,21.6,0,123,123,761
2011,44600,1831,2127,35549,36329,122,5.7,148,6.9,2845,700,2145,1.9,7.8,4404,981,3423,2.7,12.1,-1559,-4.3,15.6,0,114,116,896
2012,44600,1825,2108,36484,36009,157,7.4,184,8.7,3826,1097,2729,3,10.6,2876,1026,1850,2.8,8,950,2.6,16,0,102,112,657
2013,44600,1802,2084,36072,36119,122,5.8,144,6.9,3349,1092,2257,3,9.3,3443,1102,2341,3.1,9.5,-94,-0.2,18.6,0,92,95,656
2014,44600,1757,2044,35462,35701,132,6.4,156,7.6,2867,1038,1829,2.9,8,3345,1177,2168,3.3,9.4,-478,-1.4,16,0,119,119,783
1977,44700,5619,6161,73708,71137,1113,18.5,815,13.5,16172,6743,9429,9.5,22.7,11029,4926,6103,6.9,15.5,5143,7.2,31,0,517,520,3028
1978,44700,5735,6306,78923,76290,1043,16.7,884,14.2,18171,6372,11799,8.4,23.8,12904,6235,6669,8.2,16.9,5267,6.9,33.8,0,554,554,3158
1979,44700,6000,6601,87017,82969,1148,17.8,814,12.6,20243,8092,12151,9.8,24.4,12147,4599,7548,5.5,14.6,8096,9.8,29.2,0,569,574,3044
1980,44700,6203,6800,85771,86309,1059,15.8,824,12.3,14897,6068,8829,7,17.3,15972,5439,10533,6.3,18.5,-1075,-1.2,34.6,0,564,567,3051
1981,44700,6136,6722,87130,86299,986,14.6,994,14.7,17541,8829,8712,10.2,20.3,15878,6799,9079,7.9,18.4,1663,1.9,36.8,0,597,597,3414
1982,44700,6242,6918,93887,90346,1093,16,822,12,22217,12840,9377,14.2,24.6,15134,4399,10735,4.9,16.8,7083,7.8,33.6,0,459,459,2327
1983,44700,6431,7136,89743,91560,1007,14.3,822,11.7,18164,8347,9817,9.1,19.8,21797,4392,17405,4.8,23.8,-3633,-4,39.6,0,516,516,2298
1984,44700,6670,7404,97187,93092,1072,14.8,799,11,22576,8017,14559,8.6,24.3,14385,5454,8931,5.9,15.5,8191,8.8,31,0,485,485,2533
1985,44700,6998,7737,104602,101445,1154,15.2,843,11.1,22435,8485,13950,8.4,22.1,16120,7085,9035,7,15.9,6315,6.2,31.8,0,515,517,3423
1986,44700,7152,7879,106211,105325,1073,13.7,891,11.4,20728,7715,13013,7.3,19.7,18955,5701,13254,5.4,18,1773,1.7,36,0,560,560,3337
1987,44700,7330,8170,112742,109323,1323,16.5,989,12.3,24672,10153,14519,9.3,22.6,17833,7035,10798,6.4,16.3,6839,6.3,32.6,0,654,656,3473
1988,44700,7453,8314,118767,115955,1119,13.6,942,11.4,24427,9708,14719,8.4,21.1,18803,7262,11541,6.3,16.2,5624,4.9,32.4,0,606,606,3112
1989,44700,7095,7947,122690,120852,1074,13.2,1439,17.7,28095,8843,19252,7.3,23.2,24418,12003,12415,9.9,20.2,3677,3,40.4,0,619,619,3835
1990,44700,7765,8679,126952,124576,1565,18.8,752,9.1,27776,13188,14588,10.6,22.3,23024,10989,12035,8.8,18.5,4752,3.8,37,0,511,511,2810
1991,44700,7921,8884,127679,128121,1089,12.4,905,10.3,22644,10247,12397,8,17.7,23528,7077,16451,5.5,18.4,-884,-0.7,35.4,0,572,572,3978
1992,44700,7788,8765,123981,125569,1055,11.9,1113,12.6,18958,6859,12099,5.5,15.1,22134,7587,14547,6,17.6,-3176,-2.5,30.2,0,705,709,4394
1993,44700,7680,8612,122394,122100,855,9.8,958,11,20073,6859,13214,5.6,16.4,19485,7176,12309,5.9,16,588,0.4,32,0,639,641,3335
1994,44700,7631,8588,122081,122166,957,11.1,930,10.8,19746,7667,12079,6.3,16.2,19916,6300,13616,5.2,16.3,-170,-0.1,32.4,0,621,621,3775
1995,44700,7604,8567,126065,124040,980,11.4,951,11.1,21616,8622,12994,7,17.4,17566,6281,11285,5.1,14.2,4050,3.2,28.4,0,643,646,3588
1996,44700,7622,8578,130707,128355,1030,12,977,11.4,22844,7788,15056,6.1,17.8,18140,6851,11289,5.3,14.1,4704,3.7,28.2,0,643,643,3753
1997,44700,7703,8666,135988,133561,1074,12.4,1001,11.6,26052,9939,16113,7.4,19.5,21197,8154,13043,6.1,15.9,4855,3.6,31.8,0,579,579,3469
1998,44700,7671,8705,140437,137951,996,11.5,926,10.7,24749,10366,14383,7.5,17.9,19777,7438,12339,5.4,14.3,4972,3.6,28.6,0,608,608,3524
1999,44700,7759,8865,145161,142944,1064,12.1,902,10.3,24542,9468,15074,6.6,17.2,20108,8581,11527,6,14.1,4434,3.1,28.2,0,587,587,3201
2000,44700,7830,9019,152885,148869,1041,11.6,892,10,27403,9564,17839,6.4,18.4,19371,7567,11804,5.1,13,8032,5.4,26,0,561,561,3635
2001,44700,8021,9250,161035,157421,1063,11.6,943,10.3,28562,10650,17912,6.8,18.1,21334,7957,13377,5.1,13.6,7228,4.5,27.2,0,550,550,3542
2002,44700,8220,9546,161272,161138,1330,14.2,1009,10.8,30032,14187,15845,8.8,18.6,29764,10738,19026,6.7,18.5,268,0.1,37,0,544,545,4244
2003,44700,8429,9804,169352,164484,1261,13.1,834,8.7,29782,11160,18622,6.8,18.1,20045,7028,13017,4.3,12.2,9737,5.9,24.4,0,589,590,3879
2004,44700,8385,9762,168813,166421,1118,11.5,1022,10.5,27679,10017,17662,6,16.6,22895,7612,15283,4.6,13.8,4784,2.8,27.6,0,682,682,4228
2005,44700,8535,10011,172754,170364,1307,13.2,956,9.7,28660,11530,17130,6.8,16.8,23880,7001,16879,4.1,14,4780,2.8,28,0,683,683,4343
2006,44700,8686,10278,177923,174873,1366,13.5,1017,10,29164,13484,15680,7.7,16.7,23063,7472,15591,4.3,13.2,6101,3.5,26.4,0,695,698,4001
2007,44700,8789,10445,176696,177067,1295,12.5,1068,10.3,26548,9982,16566,5.6,15,27289,9541,17748,5.4,15.4,-741,-0.4,30,0,714,716,4883
2008,44700,8588,10278,172639,173611,1081,10.5,1089,10.6,23195,9110,14085,5.2,13.4,25139,6348,18791,3.7,14.5,-1944,-1.1,26.8,0,801,807,4041
2009,44700,8297,9986,163437,167435,907,9,1103,10.9,21179,8866,12313,5.3,12.6,29174,9162,20012,5.5,17.4,-7995,-4.8,25.2,0,784,784,4385
2010,44700,8074,9760,158287,160148,855,8.7,986,10,17389,5679,11710,3.5,10.9,21111,5362,15749,3.3,13.2,-3722,-2.3,21.8,0,685,685,3482
2011,44700,7926,9621,157840,157709,883,9.1,942,9.8,18445,6536,11909,4.1,11.7,18183,5678,12505,3.6,11.5,262,0.2,23,0,629,629,3190
2012,44700,7985,9663,160813,159099,953,9.9,935,9.7,22060,6746,15314,4.2,13.9,18632,6973,11659,4.4,11.7,3428,2.2,23.4,0,552,556,3663
2013,44700,8007,9664,165225,162807,853,8.9,841,8.7,21856,6785,15071,4.2,13.4,17020,5725,11295,3.5,10.5,4836,2.9,21,0,536,542,3171
2014,44700,8080,9756,166419,165233,956,9.9,760,7.9,20968,7163,13805,4.3,12.7,18596,5442,13154,3.3,11.3,2372,1.4,22.6,0,538,538,3419
1977,44940,1198,1305,22461,20613,209,16.5,134,10.6,5501,1420,4081,6.9,26.7,1805,651,1154,3.2,8.8,3696,17.9,17.6,0,99,99,427
1978,44940,1227,1330,24433,23455,171,13,148,11.2,4222,1387,2835,5.9,18,2266,768,1498,3.3,9.7,1956,8.3,19.4,0,101,101,462
1979,44940,1261,1363,25133,24758,178,13.2,136,10.1,3506,1053,2453,4.3,14.2,2756,661,2095,2.7,11.1,750,3.1,22.2,0,96,96,400
1980,44940,1256,1353,23472,24301,168,12.4,176,13,2267,868,1399,3.6,9.3,3924,939,2985,3.9,16.1,-1657,-6.8,18.6,0,124,124,504
1981,44940,1214,1313,22968,23151,163,12.3,192,14.4,3419,1585,1834,6.8,14.8,3785,1192,2593,5.1,16.3,-366,-1.5,29.6,0,120,121,748
1982,44940,1195,1304,22709,22823,153,11.7,148,11.3,2767,1356,1411,5.9,12.1,2994,794,2200,3.5,13.1,-227,-1,24.2,0,91,91,396
1983,44940,1130,1237,22426,22292,127,10,169,13.3,2930,807,2123,3.6,13.1,2662,968,1694,4.3,11.9,268,1.2,23.8,0,95,95,417
1984,44940,1261,1375,23496,22991,188,14.4,75,5.7,3188,1120,2068,4.9,13.9,2177,821,1356,3.6,9.5,1011,4.4,19,1,2,2,
1985,44940,1326,1438,23244,23478,196,13.9,144,10.2,3420,1379,2041,5.9,14.6,3887,2309,1578,9.8,16.6,-467,-2,29.2,0,96,96,929
1986,44940,1355,1466,24595,23913,178,12.3,140,9.6,3767,1267,2500,5.3,15.8,2402,791,1611,3.3,10,1365,5.8,20,0,90,90,397
1987,44940,1412,1527,25114,24739,192,12.8,132,8.8,3709,1208,2501,4.9,15,2958,1084,1874,4.4,12,751,3,24,0,86,86,691
1988,44940,1413,1537,24936,24776,172,11.2,152,9.9,3805,919,2886,3.7,15.4,3484,1592,1892,6.4,14.1,321,1.3,28.2,0,96,96,602
1989,44940,1411,1545,27060,26177,153,9.9,153,9.9,4740,1832,2908,7,18.1,2974,1108,1866,4.2,11.4,1766,6.7,22.8,0,105,105,789
1990,44940,1443,1579,27786,27400,194,12.4,151,9.7,3710,1168,2542,4.3,13.5,2938,867,2071,3.2,10.7,772,2.8,21.4,0,114,114,612
1991,44940,1459,1596,25230,26349,169,10.6,151,9.5,3508,1549,1959,5.9,13.3,5746,1980,3766,7.5,21.8,-2238,-8.5,26.6,0,87,87,589
1992,44940,1457,1583,27954,26775,167,10.5,170,10.7,5535,2902,2633,10.8,20.7,3176,911,2265,3.4,11.9,2359,8.8,23.8,0,106,106,398
1993,44940,1481,1620,31252,30114,160,10,122,7.6,4572,896,3676,3,15.2,2296,721,1575,2.4,7.6,2276,7.6,15.2,0,83,83,419
1994,44940,1485,1611,32786,32024,142,8.8,149,9.2,4919,859,4060,2.7,15.4,3395,1521,1874,4.7,10.6,1524,4.8,21.2,0,95,95,632
1995,44940,1500,1628,33924,33329,154,9.5,128,7.9,4366,1250,3116,3.8,13.1,3175,841,2334,2.5,9.5,1191,3.6,19,0,92,92,426
1996,44940,1522,1660,34335,34195,170,10.4,130,7.9,3754,1220,2534,3.6,11,3474,712,2762,2.1,10.2,280,0.8,20.4,0,92,92,442
1997,44940,1559,1698,38259,36313,194,11.5,155,9.2,6851,1367,5484,3.8,18.9,2959,1137,1822,3.1,8.1,3892,10.8,16.2,0,101,101,406
1998,44940,1605,1746,34368,36314,198,11.5,147,8.5,3940,1429,2511,3.9,10.8,7831,1092,6739,3,21.6,-3891,-10.8,21.6,0,96,96,447
1999,44940,1605,1758,35168,34792,185,10.6,175,10,5065,2058,3007,5.9,14.6,4313,1579,2734,4.5,12.4,752,2.2,24.8,0,113,113,1108
2000,44940,1577,1736,37265,36159,172,9.8,190,10.9,5243,1276,3967,3.5,14.5,3030,1238,1792,3.4,8.4,2213,6.1,16.8,0,119,119,548
2001,44940,1570,1735,36488,36962,127,7.3,143,8.2,4235,1178,3057,3.2,11.5,5183,1864,3319,5,14,-948,-2.5,23,0,69,69,757
2002,44940,1588,1778,33733,35084,216,12.3,172,9.8,3727,1496,2231,4.3,10.6,6429,1822,4607,5.2,18.3,-2702,-7.7,21.2,0,96,96,441
2003,44940,1596,1779,33577,33481,191,10.8,158,8.9,3527,1424,2103,4.3,10.5,3335,1012,2323,3,10,192,0.5,20,0,107,107,654
2004,44940,1602,1793,33088,33253,162,9.1,139,7.8,3691,900,2791,2.7,11.1,4020,1383,2637,4.2,12.1,-329,-1,22.2,0,97,97,496
2005,44940,1603,1797,34126,33476,173,9.7,153,8.5,4861,1756,3105,5.2,14.5,3560,741,2819,2.2,10.6,1301,3.9,21.2,0,103,103,506
2006,44940,1587,1798,32640,33366,193,10.7,182,10.1,3572,1355,2217,4.1,10.7,5024,1440,3584,4.3,15.1,-1452,-4.4,21.4,0,131,131,862
2007,44940,1616,1825,32733,32536,192,10.6,169,9.3,4795,2508,2287,7.7,14.7,4401,1246,3155,3.8,13.5,394,1.2,27,0,123,124,744
2008,44940,1562,1776,31010,31640,126,7,152,8.5,3022,807,2215,2.6,9.6,4282,850,3432,2.7,13.5,-1260,-3.9,19.2,0,117,117,662
2009,44940,1502,1725,28109,29458,135,7.7,167,9.6,2168,863,1305,2.9,7.4,4866,1339,3527,4.5,16.5,-2698,-9.1,14.8,0,121,121,481
2010,44940,1481,1712,27628,27823,121,7.1,126,7.4,2691,757,1934,2.7,9.7,3081,555,2526,2,11.1,-390,-1.4,19.4,0,94,94,409
2011,44940,1468,1702,29044,28316,121,7.1,127,7.4,4092,800,3292,2.8,14.5,2636,684,1952,2.4,9.3,1456,5.2,18.6,0,93,94,541
2012,44940,1438,1664,29247,29119,116,6.9,154,9.2,3015,724,2291,2.5,10.4,2758,732,2026,2.5,9.5,257,0.9,19,0,96,96,340
2013,44940,1448,1667,29815,29489,123,7.4,110,6.6,2942,940,2002,3.2,10,2289,565,1724,1.9,7.8,653,2.2,15.6,0,66,66,356
2014,44940,1435,1657,30662,30209,137,8.3,136,8.2,3829,1028,2801,3.4,12.7,2922,1271,1651,4.2,9.7,907,3,19.4,0,104,104,1085
1977,45060,9709,11075,200778,195734,1585,14.5,1339,12.2,38551,11944,26607,6.1,19.7,28463,11096,17367,5.7,14.5,10088,5.2,29,0,806,807,4692
1978,45060,9889,11277,212292,206487,1391,12.4,1179,10.5,38628,10130,28498,4.9,18.7,27018,9909,17109,4.8,13.1,11610,5.6,26.2,0,773,773,4137
1979,45060,9918,11344,222058,217005,1244,11,1110,9.8,33777,8138,25639,3.8,15.6,23671,7577,16094,3.5,10.9,10106,4.7,21.8,0,748,751,4326
1980,45060,9869,11314,215355,218142,1128,10,1127,10,28038,7624,20414,3.5,12.9,33611,8402,25209,3.9,15.4,-5573,-2.5,25.8,0,782,783,4296
1981,45060,9551,10933,212945,212833,1082,9.7,1375,12.4,30055,10487,19568,4.9,14.1,29830,10270,19560,4.8,14,225,0.1,28,0,796,800,4209
1982,45060,9625,11164,223559,217686,1380,12.5,1076,9.7,38990,11308,27682,5.2,17.9,27244,7684,19560,3.5,12.5,11746,5.4,25,0,558,558,2837
1983,45060,9909,11461,214494,220062,1165,10.3,969,8.6,28351,8771,19580,4,12.9,39486,8336,31150,3.8,17.9,-11135,-5,25.8,0,607,611,3636
1984,45060,10189,11744,227131,221052,1311,11.3,1032,8.9,33971,8915,25056,4,15.4,21814,7535,14279,3.4,9.9,12157,5.5,19.8,0,643,644,3101
1985,45060,10554,12151,237539,233853,1465,12.3,1078,9,33432,10220,23212,4.4,14.3,26060,10930,15130,4.7,11.1,7372,3.2,22.2,0,667,668,5038
1986,45060,10849,12497,244744,240496,1548,12.6,1174,9.5,35708,12050,23658,5,14.8,27212,8923,18289,3.7,11.3,8496,3.5,22.6,0,743,746,4036
1987,45060,11222,13035,251791,249446,1818,14.2,1195,9.4,40481,15685,24796,6.3,16.2,35791,9395,26396,3.8,14.3,4690,1.9,28.6,0,754,755,4465
1988,45060,11350,13271,257025,253053,1596,12.1,1300,9.9,40612,13313,27299,5.3,16,32669,9610,23059,3.8,12.9,7943,3.1,25.8,0,871,871,4720
1989,45060,11567,13561,263877,260117,1581,11.8,1321,9.8,42767,12482,30285,4.8,16.4,35248,15450,19798,5.9,13.6,7519,2.8,27.2,0,834,838,9766
1990,45060,11650,13717,267241,265511,1471,10.8,1241,9.1,37076,12911,24165,4.9,14,33615,10141,23474,3.8,12.7,3461,1.3,25.4,0,831,835,4842
1991,45060,11776,13966,262607,264792,1627,11.8,1380,10,35195,13743,21452,5.2,13.3,39565,11862,27703,4.5,14.9,-4370,-1.6,26.6,0,842,845,5893
1992,45060,11681,13896,261909,262024,1489,10.7,1485,10.6,38583,12337,26246,4.7,14.7,38812,11754,27058,4.5,14.8,-229,-0.1,29.4,0,921,934,4874
1993,45060,11719,13880,256442,258489,1324,9.5,1322,9.5,32027,10033,21994,3.9,12.4,36121,9101,27020,3.5,14,-4094,-1.6,24.8,0,873,876,5000
1994,45060,11521,13634,255634,256348,1225,8.9,1404,10.2,30014,8303,21711,3.2,11.7,31442,11102,20340,4.3,12.3,-1428,-0.6,23.4,0,884,888,5099
1995,45060,11535,13656,258444,256945,1417,10.4,1348,9.9,37104,12160,24944,4.7,14.4,34106,12284,21822,4.8,13.3,2998,1.1,26.6,0,872,876,4929
1996,45060,11466,13567,256303,257574,1269,9.3,1330,9.8,32677,13562,19115,5.3,12.7,35219,10061,25158,3.9,13.7,-2542,-1,25.4,0,829,829,4448
1997,45060,11396,13531,259312,257977,1346,9.9,1402,10.3,33819,11363,22456,4.4,13.1,31148,11900,19248,4.6,12.1,2671,1,24.2,0,851,851,5136
1998,45060,11311,13452,264851,261941,1224,9.1,1266,9.4,36125,11108,25017,4.2,13.8,30304,11158,19146,4.3,11.6,5821,2.2,23.2,0,792,792,4604
1999,45060,11300,13521,267919,266355,1273,9.4,1187,8.8,36281,14197,22084,5.3,13.6,33153,11465,21688,4.3,12.4,3128,1.2,24.8,0,728,728,4788
2000,45060,11227,13407,272950,271623,1134,8.4,1266,9.4,35328,11628,23700,4.3,13,32674,13037,19637,4.8,12,2654,1,24,0,725,725,4805
2001,45060,11327,13632,271900,272883,1299,9.6,1171,8.6,32195,13788,18407,5.1,11.8,34161,9593,24568,3.5,12.5,-1966,-0.7,23.6,0,691,693,5457
2002,45060,11315,13642,265366,265380,1552,11.4,1501,11,39161,14016,25145,5.3,14.8,39189,12366,26823,4.7,14.8,-28,0,29.6,0,762,763,4703
2003,45060,11435,13762,265200,263538,1406,10.3,1099,8.1,36768,13319,23449,5.1,14,33444,11637,21807,4.4,12.7,3324,1.3,25.4,0,719,723,4954
2004,45060,11516,13895,267915,265374,1427,10.4,1146,8.3,38438,13397,25041,5,14.5,33355,8519,24836,3.2,12.6,5083,1.9,25.2,0,745,747,4292
2005,45060,11533,13988,263599,263174,1380,9.9,1162,8.4,31973,11537,20436,4.4,12.1,31123,8203,22920,3.1,11.8,850,0.3,23.6,0,793,794,5047
2006,45060,11566,14112,265455,263795,1382,9.9,1133,8.1,33088,12041,21047,4.6,12.5,29768,8341,21427,3.2,11.3,3320,1.2,22.6,0,789,789,5561
2007,45060,11515,14127,266271,265082,1320,9.4,1252,8.9,35738,12163,23575,4.6,13.5,33360,11262,22098,4.2,12.6,2378,0.9,25.2,0,727,733,4055
2008,45060,11496,14117,264212,264619,1197,8.5,1102,7.8,30789,9336,21453,3.5,11.6,31603,11854,19749,4.5,11.9,-814,-0.3,23.2,0,744,746,9470
2009,45060,11328,13874,252461,257849,1093,7.8,1233,8.8,23184,7367,15817,2.9,9,33959,7838,26121,3,13.2,-10775,-4.2,18,0,767,776,4165
2010,45060,11323,13833,252602,251971,1091,7.9,1047,7.6,26519,9664,16855,3.8,10.5,25256,5843,19413,2.3,10,1263,0.5,20,0,692,692,3739
2011,45060,11256,13788,255169,252807,1095,7.9,1069,7.8,29166,7930,21236,3.1,11.5,24443,7901,16542,3.1,9.7,4723,1.8,19.4,0,695,695,4261
2012,45060,11379,13925,261029,257745,1252,9.1,1082,7.8,32720,8811,23909,3.4,12.7,26153,6411,19742,2.5,10.1,6567,2.6,20.2,0,674,680,3959
2013,45060,11268,13811,261894,260849,1104,8,1196,8.7,30055,9634,20421,3.7,11.5,27964,9066,18898,3.5,10.7,2091,0.8,21.4,0,738,740,4411
2014,45060,11232,13793,259530,260174,1138,8.3,1067,7.8,27333,9271,18062,3.6,10.5,28621,11246,17375,4.3,11,-1288,-0.5,21,0,701,702,3718
1977,45220,3239,3566,36907,37033,681,19.5,497,14.3,7838,4234,3604,11.4,21.2,8089,3395,4694,9.2,21.8,-251,-0.6,42.4,0,356,358,2450
1978,45220,3381,3714,40737,38815,624,17.1,473,13,10046,4045,6001,10.4,25.9,6201,2886,3315,7.4,16,3845,9.9,32,0,344,345,1535
1979,45220,3476,3821,44055,42366,593,15.7,475,12.6,10065,4017,6048,9.5,23.8,6687,2773,3914,6.5,15.8,3378,8,31.6,0,348,348,1849
1980,45220,3614,4037,46139,45906,735,18.7,501,12.8,10376,5129,5247,11.2,22.6,9909,5002,4907,10.9,21.6,467,1,43.2,0,377,378,3468
1981,45220,3653,4086,47100,46211,657,16.2,575,14.2,9968,4404,5564,9.5,21.6,8190,4055,4135,8.8,17.7,1778,3.9,35.4,0,341,348,2596
1982,45220,3794,4296,49231,48174,729,17.4,488,11.6,10480,5277,5203,11,21.8,8366,3087,5279,6.4,17.4,2114,4.4,34.8,0,284,284,1658
1983,45220,3909,4427,50183,49730,604,13.9,507,11.6,9916,4371,5545,8.8,19.9,9010,3375,5635,6.8,18.1,906,1.8,36.2,0,321,324,2230
1984,45220,4191,4742,55162,52679,769,16.8,456,9.9,12169,5343,6826,10.1,23.1,7203,2783,4420,5.3,13.7,4966,9.4,27.4,0,302,305,1631
1985,45220,4340,4902,57923,56749,754,15.6,582,12.1,11665,4840,6825,8.5,20.6,9316,3925,5391,6.9,16.4,2349,4.2,32.8,0,384,384,2123
1986,45220,4518,5098,61530,59695,804,16.1,587,11.7,12940,6009,6931,10.1,21.7,9269,3833,5436,6.4,15.5,3671,6.2,31,0,364,364,2254
1987,45220,4721,5368,70099,67291,861,16.4,565,10.8,15068,5741,9327,8.5,22.4,9451,3372,6079,5,14,5617,8.4,28,0,372,372,1984
1988,45220,4767,5444,72739,71167,752,13.9,659,12.2,14256,5419,8837,7.6,20,11111,4512,6599,6.3,15.6,3145,4.4,31.2,0,447,447,2880
1989,45220,4882,5624,76314,74760,765,13.8,588,10.6,14301,5933,8368,7.9,19.1,11193,3986,7207,5.3,15,3108,4.1,30,0,405,407,2438
1990,45220,5013,5813,79064,77420,800,14,572,10,14634,6194,8440,8,18.9,11345,3977,7368,5.1,14.7,3289,4.2,29.4,0,386,391,2349
1991,45220,5145,5953,79754,79491,740,12.6,604,10.3,13612,5597,8015,7,17.1,13085,4206,8879,5.3,16.5,527,0.6,33,0,356,362,2182
1992,45220,5221,6035,81292,80475,812,13.5,714,11.9,14869,5546,9323,6.9,18.5,13235,5108,8127,6.3,16.4,1634,2.1,32.8,0,471,483,2883
1993,45220,5307,6120,85229,83414,739,12.2,644,10.6,15056,5144,9912,6.2,18,11426,4143,7283,5,13.7,3630,4.3,27.4,0,442,445,2150
1994,45220,5366,6182,88656,86872,708,11.5,620,10.1,15121,4821,10300,5.5,17.4,11553,4360,7193,5,13.3,3568,4.1,26.6,0,412,413,2614
1995,45220,5504,6332,90485,89648,781,12.5,611,9.8,14400,5804,8596,6.5,16.1,12726,3858,8868,4.3,14.2,1674,1.9,28.4,0,420,420,2158
1996,45220,5631,6436,93136,91768,765,12,641,10,16208,5969,10239,6.5,17.7,13471,4806,8665,5.2,14.7,2737,3,29.4,0,413,413,2332
1997,45220,5685,6539,93583,93282,897,13.8,770,11.9,16843,6899,9944,7.4,18.1,16241,6215,10026,6.7,17.4,602,0.7,34.8,0,485,485,2510
1998,45220,5688,6521,95537,94510,797,12.2,786,12,15033,5565,9468,5.9,15.9,12979,4677,8302,4.9,13.7,2054,2.2,27.4,0,487,487,2612
1999,45220,5773,6666,97561,96535,838,12.7,690,10.5,15576,6246,9330,6.5,16.1,13523,4878,8645,5.1,14,2053,2.1,28,0,433,433,2192
2000,45220,5807,6718,102360,100830,811,12.1,750,11.2,18235,7308,10927,7.2,18.1,15175,6777,8398,6.7,15.1,3060,3,30.2,0,443,443,2341
2001,45220,5925,6906,106399,104977,827,12.1,706,10.4,17096,8196,8900,7.8,16.3,14251,5080,9171,4.8,13.6,2845,2.7,27.2,0,389,389,2107
2002,45220,5962,6952,112123,109234,895,12.9,835,12.1,24389,8861,15528,8.1,22.3,18610,6364,12246,5.8,17,5779,5.3,34,0,443,443,2050
2003,45220,6152,7120,106821,108276,936,13.4,598,8.6,18070,7074,10996,6.5,16.7,20979,11188,9791,10.3,19.4,-2909,-2.7,33.4,0,406,407,2211
2004,45220,6373,7364,105717,105719,1038,14.4,704,9.7,17994,7174,10820,6.8,17,17998,7630,10368,7.2,17,-4,0,34,0,465,474,2119
2005,45220,6566,7629,109042,107009,992,13.3,663,8.9,17872,8412,9460,7.9,16.7,13805,4591,9214,4.3,12.9,4067,3.8,25.8,0,447,447,2177
2006,45220,6711,7855,110870,109426,1055,13.7,748,9.7,18369,7790,10579,7.1,16.8,15480,5489,9991,5,14.1,2889,2.7,28.2,0,485,485,3255
2007,45220,6915,8079,110567,110547,999,12.5,795,10,18223,7575,10648,6.9,16.5,18183,5739,12444,5.2,16.4,40,0.1,32.8,0,480,497,2564
2008,45220,6830,8008,109210,109483,799,10,796,9.9,15206,5308,9898,4.8,13.9,15751,4511,11240,4.1,14.4,-545,-0.5,27.8,0,541,541,2559
2009,45220,6631,7861,102870,105519,762,9.6,832,10.5,13614,6895,6719,6.5,12.9,18912,4790,14122,4.5,17.9,-5298,-5,25.8,0,555,558,2223
2010,45220,6576,7807,102148,102348,774,9.9,780,10,13212,5220,7992,5.1,12.9,13611,4290,9321,4.2,13.3,-399,-0.4,25.8,0,520,520,2810
2011,45220,6497,7713,101401,101447,748,9.7,769,9.9,13083,5082,8001,5,12.9,13175,4664,8511,4.6,13,-92,-0.1,25.8,0,517,521,2835
2012,45220,6561,7768,103396,102324,807,10.4,737,9.5,15087,5475,9612,5.4,14.7,12943,4691,8252,4.6,12.6,2144,2.1,25.2,0,429,430,2431
2013,45220,6618,7847,103759,103416,737,9.5,671,8.6,13178,5536,7642,5.4,12.7,12492,4705,7787,4.5,12.1,686,0.6,24.2,0,445,448,2683
2014,45220,6678,7881,107286,105026,839,10.7,708,9.1,15898,6190,9708,5.9,15.1,11378,4159,7219,4,10.8,4520,4.3,21.6,0,476,481,2656
1977,45300,23054,27654,374691,363814,5713,21.2,4254,15.8,91213,46871,44342,12.9,25.1,69458,32778,36680,9,19.1,21755,6,38.2,0,2955,2964,19451
1978,45300,24019,28695,406814,390795,5033,17.9,3984,14.1,94600,36838,57762,9.4,24.2,62561,30032,32529,7.7,16,32039,8.2,32,0,2787,2804,16744
1979,45300,25165,30142,442024,424037,5405,18.4,3785,12.9,100123,41068,59055,9.7,23.6,64148,28100,36048,6.6,15.1,35975,8.5,30.2,0,2748,2759,15809
1980,45300,26520,31649,463428,452699,5572,18,3962,12.8,90678,37444,53234,8.3,20,69220,27824,41396,6.1,15.3,21458,4.7,30.6,0,2831,2837,15929
1981,45300,26959,32122,495756,478586,5393,16.9,4690,14.7,112246,43089,69157,9,23.5,77906,33417,44489,7,16.3,34340,7.2,32.6,0,2974,2987,16414
1982,45300,28357,34317,519824,507384,6548,19.7,4112,12.4,114626,57811,56815,11.4,22.6,89745,31543,58202,6.2,17.7,24881,4.9,35.4,0,2440,2445,15416
1983,45300,29516,35631,522906,521718,5903,16.9,4812,13.8,103839,46993,56846,9,19.9,101463,37064,64399,7.1,19.4,2376,0.5,38.8,0,2939,2955,17474
1984,45300,32118,38519,586908,555003,7213,19.5,4328,11.7,137340,53970,83370,9.7,24.7,73529,29466,44063,5.3,13.2,63811,11.5,26.4,0,2881,2891,16594
1985,45300,34019,40886,638540,613244,7336,18.5,4950,12.5,152854,59366,93488,9.7,24.9,102262,44854,57408,7.3,16.7,50592,8.2,33.4,0,3416,3427,23603
1986,45300,35707,42876,651165,644174,7555,18,5423,13,135584,60785,74799,9.4,21,121602,42085,79517,6.5,18.9,13982,2.1,37.8,0,3710,3714,24318
1987,45300,37118,45040,678702,672225,8438,19.2,6100,13.9,142393,66396,75997,9.9,21.2,129438,54414,75024,8.1,19.3,12955,1.9,38.6,0,4169,4193,28444
1988,45300,37477,45860,714330,694336,7402,16.3,6408,14.1,158417,65448,92969,9.4,22.8,118429,49127,69302,7.1,17.1,39988,5.7,34.2,0,4490,4490,25752
1989,45300,37863,46494,747057,731788,6784,14.7,6213,13.5,152741,59813,92928,8.2,20.9,122203,49283,72920,6.7,16.7,30538,4.2,33.4,0,4206,4224,28550
1990,45300,38419,47179,757647,751410,6860,14.7,5869,12.5,145021,57579,87442,7.7,19.3,132548,49149,83399,6.5,17.6,12473,1.7,35.2,0,4081,4106,27665
1991,45300,39261,48329,769748,763975,7412,15.5,6236,13.1,157379,73180,84199,9.6,20.6,145833,53159,92674,7,19.1,11546,1.5,38.2,0,3886,3932,28449
1992,45300,39833,48855,768779,769120,7423,15.3,6699,13.8,150980,60561,90419,7.9,19.6,151662,58628,93034,7.6,19.7,-682,-0.1,39.2,0,4218,4305,30003
1993,45300,40736,49411,785135,776490,6942,14.1,6274,12.8,158643,58401,100242,7.5,20.4,141352,61313,80039,7.9,18.2,17291,2.2,36.4,0,4156,4187,33640
1994,45300,41415,50193,817318,800747,6987,14,6030,12.1,161086,54632,106454,6.8,20.1,127944,47697,80247,6,16,33142,4.1,32,0,4201,4224,26559
1995,45300,41979,50978,861230,838662,7110,14.1,6124,12.1,176624,73298,103326,8.7,21.1,131487,50658,80829,6,15.7,45137,5.4,31.4,0,4219,4260,29417
1996,45300,42513,51582,897124,879082,6954,13.6,6183,12.1,185150,70194,114956,8,21.1,149066,55199,93867,6.3,17,36084,4.1,34,0,4096,4096,29654
1997,45300,42921,52372,925420,912687,7397,14.2,6669,12.8,200127,81800,118327,9,21.9,174661,74816,99845,8.2,19.1,25466,2.8,38.2,0,4227,4227,33131
1998,45300,43065,52582,959547,942956,7088,13.5,6710,12.8,188220,67235,120985,7.1,20,155038,62257,92781,6.6,16.4,33182,3.6,32.8,0,4324,4324,30060
1999,45300,43308,53214,1002378,979880,7363,13.9,6594,12.5,235091,74595,160496,7.6,24,190095,72224,117871,7.4,19.4,44996,4.6,38.8,0,4191,4191,27204
2000,45300,43209,53171,1073017,1040816,6900,13,6948,13.1,229328,76591,152737,7.4,22,164926,69492,95434,6.7,15.8,64402,6.2,31.6,0,4206,4206,24514
2001,45300,43765,54215,1127785,1102194,7589,14.1,6958,13,246243,96078,150165,8.7,22.3,195061,72188,122873,6.5,17.7,51182,4.6,35.4,0,4023,4024,32506
2002,45300,44371,54781,1098520,1101093,8280,15.2,7692,14.1,212757,78174,134583,7.1,19.3,217903,90694,127209,8.2,19.8,-5146,-0.5,38.6,0,3974,3984,33796
2003,45300,45715,56331,1149038,1113974,8619,15.6,5943,10.8,258373,95350,163023,8.6,23.2,188247,73835,114412,6.6,16.9,70126,6.3,33.8,0,4046,4061,51686
2004,45300,47886,58669,1106892,1123375,9308,16.2,6283,11,253748,90354,163394,8,22.6,286715,138178,148537,12.3,25.5,-32967,-2.9,45.2,0,4152,4192,32172
2005,45300,50120,61235,1122723,1109131,9549,16,6374,10.7,221336,80861,140475,7.3,20,194152,66229,127923,6,17.5,27184,2.5,35,0,4216,4221,36860
2006,45300,51477,63114,1173879,1145167,9486,15.3,6976,11.2,213529,76617,136912,6.7,18.6,156105,62855,93250,5.5,13.6,57424,5,27.2,0,4792,4815,35632
2007,45300,52369,64435,1178706,1173537,9329,14.6,7757,12.2,201053,77384,123669,6.6,17.1,190717,63212,127505,5.4,16.3,10336,0.8,32.6,0,5017,5066,33204
2008,45300,51179,63355,1160293,1166064,7932,12.5,8312,13.1,185606,70337,115269,6,15.9,197148,60611,136537,5.2,16.9,-11542,-1,31.8,0,5935,5948,33416
2009,45300,49021,60878,1083927,1118624,6821,11,8592,13.9,146246,50693,95553,4.5,13.1,215642,56787,158855,5.1,19.3,-69396,-6.2,26.2,0,5789,5814,32845
2010,45300,48661,60387,1142811,1123880,7038,11.6,7092,11.7,210610,79669,130941,7.1,18.7,172749,54136,118613,4.8,15.4,37861,3.3,30.8,0,4646,4648,29305
2011,45300,48828,60678,1201861,1178506,7591,12.6,6959,11.5,232298,87961,144337,7.5,19.7,185589,58576,127013,5,15.7,46709,4,31.4,0,4611,4616,33819
2012,45300,50206,62209,1213310,1205445,7888,12.9,6341,10.3,186751,62710,124041,5.2,15.5,171021,66089,104932,5.5,14.2,15730,1.3,28.4,0,3951,4004,46175
2013,45300,51214,63453,1232455,1221992,7429,11.9,6355,10.1,196614,64794,131820,5.3,16.1,175689,61002,114687,5,14.4,20925,1.7,28.8,0,4042,4044,23291
2014,45300,51743,64138,1223309,1214140,7611,12,6461,10.2,204487,58972,145515,4.9,16.8,186149,60103,126046,5,15.3,18338,1.5,30.6,0,4472,4475,29708
1977,45460,2730,3059,51168,48418,456,15,391,12.9,11633,4172,7461,8.6,24,6132,2374,3758,4.9,12.7,5501,11.3,25.4,0,248,248,1211
1978,45460,2785,3120,50499,50854,355,11.5,295,9.5,8050,2243,5807,4.4,15.8,8759,1905,6854,3.7,17.2,-709,-1.4,31.6,0,214,214,1258
1979,45460,2804,3144,53696,52074,358,11.4,319,10.2,9635,2698,6937,5.2,18.5,6390,2962,3428,5.7,12.3,3245,6.2,24.6,0,232,232,933
1980,45460,2769,3105,55343,54487,320,10.2,348,11.1,9776,3001,6775,5.5,17.9,8064,2785,5279,5.1,14.8,1712,3.1,29.6,0,243,245,1281
1981,45460,2660,2979,48691,50898,305,10.1,376,12.4,5902,2358,3544,4.6,11.6,10316,5365,4951,10.5,20.3,-4414,-8.7,23.2,0,233,236,1208
1982,45460,2662,3033,46526,47539,414,13.8,333,11.1,6128,3042,3086,6.4,12.9,8154,2339,5815,4.9,17.2,-2026,-4.3,25.8,0,205,206,1171
1983,45460,2502,2856,43112,44791,256,8.7,406,13.8,5511,1890,3621,4.2,12.3,8868,2793,6075,6.2,19.8,-3357,-7.5,24.6,0,217,217,1095
1984,45460,2694,3053,45823,44529,323,10.9,189,6.4,6339,2057,4282,4.6,14.2,3750,875,2875,2,8.4,2589,5.8,16.8,0,6,7,24
1985,45460,2719,3070,45572,46287,308,10,307,10,6699,2488,4211,5.4,14.5,8128,4713,3415,10.2,17.6,-1429,-3.1,29,0,190,190,2100
1986,45460,2716,3062,47825,46752,323,10.5,319,10.4,8660,4692,3968,10,18.5,6513,2460,4053,5.3,13.9,2147,4.6,27.8,0,207,208,1130
1987,45460,2759,3117,48942,48119,392,12.7,323,10.4,7448,2958,4490,6.1,15.5,5801,2434,3367,5.1,12.1,1647,3.4,24.2,0,203,204,1028
1988,45460,2745,3113,47218,46739,345,11.1,323,10.4,7298,2709,4589,5.8,15.6,6339,2573,3766,5.5,13.6,959,2,27.2,0,213,213,1046
1989,45460,2772,3143,50329,49100,337,10.8,309,9.9,7767,2681,5086,5.5,15.8,5308,2255,3053,4.6,10.8,2459,5,21.6,0,215,215,1177
1990,45460,2821,3209,54238,53143,352,11.1,269,8.5,8086,2427,5659,4.6,15.2,5896,1971,3925,3.7,11.1,2190,4.1,22.2,0,180,180,1160
1991,45460,2845,3268,55698,54911,339,10.5,287,8.9,8304,2650,5654,4.8,15.1,6730,1672,5058,3,12.3,1574,2.8,24.6,0,202,202,1131
1992,45460,2910,3344,56471,56156,399,12.1,316,9.5,7731,2919,4812,5.2,13.8,7101,2151,4950,3.8,12.6,630,1.2,25.2,0,200,201,1008
1993,45460,2947,3371,58046,57228,329,9.8,289,8.6,8304,1899,6405,3.3,14.5,6667,1747,4920,3.1,11.6,1637,2.9,23.2,0,198,199,1057
1994,45460,3050,3474,58522,58251,399,11.7,288,8.4,8086,2600,5486,4.5,13.9,7543,2838,4705,4.9,12.9,543,1,25.8,0,193,195,1305
1995,45460,3067,3510,60733,59598,389,11.1,334,9.6,8899,3240,5659,5.4,14.9,6629,2087,4542,3.5,11.1,2270,3.8,22.2,0,236,236,1090
1996,45460,3100,3552,60193,60448,403,11.4,348,9.9,8658,3517,5141,5.8,14.3,9168,2809,6359,4.6,15.2,-510,-0.9,28.6,0,245,245,1403
1997,45460,3106,3551,58105,59127,378,10.6,379,10.7,7504,2685,4819,4.5,12.7,9547,2479,7068,4.2,16.1,-2043,-3.4,25.4,0,258,258,1343
1998,45460,3059,3514,59382,58883,337,9.5,363,10.3,7472,2569,4903,4.4,12.7,6473,2001,4472,3.4,11,999,1.7,22,0,246,246,1015
1999,45460,3086,3551,60435,60126,359,10.2,318,9,8867,3550,5317,5.9,14.7,8249,2445,5804,4.1,13.7,618,1,27.4,0,200,200,985
2000,45460,3058,3492,61712,60859,330,9.4,394,11.2,9206,3392,5814,5.6,15.1,7499,2902,4597,4.8,12.3,1707,2.8,24.6,0,219,219,1137
2001,45460,3027,3483,61643,61823,354,10.1,396,11.3,8500,3286,5214,5.3,13.7,8860,2711,6149,4.4,14.3,-360,-0.6,27.4,0,240,240,1444
2002,45460,2994,3469,58279,59929,402,11.6,406,11.7,7085,3061,4024,5.1,11.8,10385,3368,7017,5.6,17.3,-3300,-5.5,23.6,0,219,219,1422
2003,45460,2983,3444,60873,59369,301,8.7,271,7.9,10377,3845,6532,6.5,17.5,7368,3429,3939,5.8,12.4,3009,5.1,24.8,0,177,178,1042
2004,45460,3022,3489,63051,61838,319,9.2,240,6.9,8592,2948,5644,4.8,13.9,6165,2187,3978,3.5,10,2427,3.9,20,0,162,162,1293
2005,45460,3007,3507,62076,62441,329,9.4,277,7.9,7907,2836,5071,4.5,12.7,8637,2371,6266,3.8,13.8,-730,-1.1,25.4,0,212,212,1984
2006,45460,2996,3510,62716,62280,358,10.2,331,9.4,9532,3782,5750,6.1,15.3,8660,3565,5095,5.7,13.9,872,1.4,27.8,0,212,214,1078
2007,45460,2983,3500,61533,61853,320,9.1,332,9.5,8337,2918,5419,4.7,13.5,8977,2009,6968,3.2,14.5,-640,-1,27,0,226,228,1133
2008,45460,2960,3481,59741,60414,307,8.8,305,8.8,8131,2345,5786,3.9,13.5,9476,2708,6768,4.5,15.7,-1345,-2.2,27,0,208,208,1274
2009,45460,2919,3433,59494,59556,237,6.9,265,7.7,8033,2698,5335,4.5,13.5,8156,1590,6566,2.7,13.7,-123,-0.2,27,0,179,181,1038
2010,45460,2906,3440,57893,58557,254,7.4,231,6.7,5472,1810,3662,3.1,9.3,6799,1625,5174,2.8,11.6,-1327,-2.3,18.6,0,152,152,1196
2011,45460,2819,3360,58559,57988,250,7.4,293,8.7,6967,1903,5064,3.3,12,5825,1565,4260,2.7,10,1142,2,20,0,209,209,1064
2012,45460,2855,3391,60106,59080,273,8.1,239,7.1,7502,2132,5370,3.6,12.7,5450,1612,3838,2.7,9.2,2052,3.5,18.4,0,152,159,1125
2013,45460,2809,3332,58970,59472,183,5.5,250,7.5,5038,1612,3426,2.7,8.5,6041,1407,4634,2.4,10.2,-1003,-1.7,17,0,172,173,912
2014,45460,2759,3291,65524,62142,216,6.5,230,7,12895,2428,10467,3.9,20.8,6130,2359,3771,3.8,9.9,6765,10.9,19.8,0,160,160,1267
1977,45500,1878,2034,29483,27724,327,16.3,267,13.3,8209,2955,5254,10.7,29.6,4691,2599,2092,9.4,16.9,3518,12.7,33.8,0,178,179,1191
1978,45500,1814,1985,28895,29170,280,13.9,315,15.7,4935,1527,3408,5.2,16.9,5485,1818,3667,6.2,18.8,-550,-1.9,33.8,0,195,195,938
1979,45500,1962,2147,31189,30056,308,14.9,155,7.5,6338,2312,4026,7.7,21.1,4071,1037,3034,3.5,13.5,2267,7.6,27,1,2,2,
1980,45500,2000,2160,38625,34884,287,13.3,260,12.1,12853,1643,11210,4.7,36.8,5371,1686,3685,4.8,15.4,7482,21.4,30.8,0,156,156,873
1981,45500,1966,2131,29268,33475,285,13.3,289,13.5,4406,1754,2652,5.2,13.2,12820,1531,11289,4.6,38.3,-8414,-25.1,26.4,0,175,175,769
1982,45500,1981,2167,31695,30432,325,15.1,258,12,6906,2307,4599,7.6,22.7,4380,1494,2886,4.9,14.4,2526,8.3,28.8,0,135,135,732
1983,45500,2007,2203,29562,30641,278,12.7,252,11.5,4561,1551,3010,5.1,14.9,6719,1371,5348,4.5,21.9,-2158,-7,29.8,0,172,173,729
1984,45500,2104,2297,31591,30601,334,14.8,245,10.9,5425,2178,3247,7.1,17.7,3444,1283,2161,4.2,11.3,1981,6.4,22.6,0,159,159,731
1985,45500,2139,2331,33187,32459,301,13,267,11.5,5924,2203,3721,6.8,18.3,4467,1875,2592,5.8,13.8,1457,4.5,27.6,0,173,173,864
1986,45500,2142,2337,33063,33126,296,12.7,284,12.2,5336,1985,3351,6,16.1,5462,2045,3417,6.2,16.5,-126,-0.4,32.2,0,206,206,1151
1987,45500,2141,2335,33373,33176,319,13.7,299,12.8,5587,2584,3003,7.8,16.8,5193,1977,3216,6,15.7,394,1.1,31.4,0,194,194,1203
1988,45500,2058,2257,31685,32338,246,10.7,296,12.9,4032,1566,2466,4.8,12.5,5337,2218,3119,6.9,16.5,-1305,-4,25,0,201,201,822
1989,45500,2081,2289,33366,32624,267,11.7,246,10.8,5665,2661,3004,8.2,17.4,4180,1614,2566,4.9,12.8,1485,4.6,25.6,0,162,164,832
1990,45500,2105,2316,34834,34075,251,10.9,210,9.1,5162,1540,3622,4.5,15.1,3643,1212,2431,3.6,10.7,1519,4.4,21.4,0,145,145,768
1991,45500,2165,2393,35542,35188,309,13.1,233,9.9,5746,2640,3106,7.5,16.3,5038,2225,2813,6.3,14.3,708,2,28.6,0,144,149,954
1992,45500,2147,2391,34567,34626,251,10.5,245,10.2,5229,1773,3456,5.1,15.1,5347,1701,3646,4.9,15.4,-118,-0.3,30.2,0,155,158,1030
1993,45500,2145,2375,35743,35042,254,10.7,253,10.6,6112,2364,3748,6.7,17.4,4709,1791,2918,5.1,13.4,1403,4,26.8,0,171,172,786
1994,45500,2195,2435,34802,35267,293,12.2,231,9.6,5026,2318,2708,6.6,14.3,5955,1713,4242,4.9,16.9,-929,-2.6,28.6,0,170,170,1127
1995,45500,2211,2468,37400,36072,283,11.5,244,10,7727,4165,3562,11.5,21.4,5070,1598,3472,4.4,14.1,2657,7.3,28.2,0,172,172,759
1996,45500,2260,2508,37372,37266,279,11.2,232,9.3,5121,1889,3232,5.1,13.7,4908,1436,3472,3.9,13.2,213,0.5,26.4,0,154,154,796
1997,45500,2280,2558,38824,38192,327,12.9,281,11.1,6454,2862,3592,7.5,16.9,5189,1781,3408,4.7,13.6,1265,3.3,27.2,0,183,183,1083
1998,45500,2305,2578,39349,39035,285,11.1,258,10,6193,1939,4254,5,15.9,5565,2098,3467,5.4,14.3,628,1.6,28.6,0,163,163,1114
1999,45500,2323,2630,41108,40327,319,12.3,270,10.4,7074,3112,3962,7.7,17.5,5512,2016,3496,5,13.7,1562,3.8,27.4,0,178,178,1274
2000,45500,2295,2577,42504,41790,232,8.9,283,10.9,6631,1860,4771,4.5,15.9,5203,1991,3212,4.8,12.5,1428,3.4,25,0,158,158,1031
2001,45500,2253,2557,41605,42129,244,9.5,290,11.3,5159,2010,3149,4.8,12.2,6207,2045,4162,4.9,14.7,-1048,-2.5,24.4,0,171,171,823
2002,45500,2289,2595,41739,41634,333,12.9,296,11.5,7194,3433,3761,8.2,17.3,6983,2564,4419,6.2,16.8,211,0.5,33.6,0,175,175,1418
2003,45500,2283,2609,40945,40779,283,10.9,229,8.8,6547,3125,3422,7.7,16.1,6214,1634,4580,4,15.2,333,0.9,30.4,0,184,184,1252
2004,45500,2327,2646,41421,40406,274,10.5,214,8.2,7074,1666,5408,4.1,17.5,5043,2083,2960,5.2,12.5,2031,5,25,0,159,159,606
2005,45500,2352,2698,41414,41130,295,11.1,217,8.1,6136,2648,3488,6.4,14.9,5568,1283,4285,3.1,13.5,568,1.4,27,0,159,159,985
2006,45500,2362,2718,43071,42151,296,10.9,250,9.2,7077,2724,4353,6.5,16.8,5236,1884,3352,4.5,12.4,1841,4.4,24.8,0,178,178,1152
2007,45500,2398,2784,43160,43020,310,11.3,233,8.5,6111,2485,3626,5.8,14.2,5831,1407,4424,3.3,13.6,280,0.6,27.2,0,155,156,850
2008,45500,2370,2773,43063,43063,224,8.1,216,7.8,5391,1800,3591,4.2,12.5,5390,1466,3924,3.4,12.5,1,0,25,0,172,172,1078
2009,45500,2321,2716,42543,42687,212,7.8,237,8.7,5244,2031,3213,4.8,12.3,5531,1798,3733,4.2,13,-287,-0.7,24.6,0,158,158,1016
2010,45500,2315,2717,41125,41712,202,7.5,182,6.7,4372,1222,3150,2.9,10.5,5546,1390,4156,3.3,13.3,-1174,-2.8,21,0,138,138,594
2011,45500,2282,2682,41567,41208,204,7.6,204,7.6,4837,1705,3132,4.1,11.7,4119,1007,3112,2.4,10,718,1.7,20,0,144,145,691
2012,45500,2302,2704,42136,41771,231,8.6,217,8.1,5634,1612,4022,3.9,13.5,4903,1275,3628,3.1,11.7,731,1.8,23.4,0,143,144,778
2013,45500,2310,2715,42576,42293,210,7.8,195,7.2,4904,1456,3448,3.4,11.6,4337,1062,3275,2.5,10.3,567,1.3,20.6,0,143,143,638
2014,45500,2301,2717,44176,43229,217,8,189,7,5597,1840,3757,4.3,12.9,3703,1211,2492,2.8,8.6,1894,4.3,17.2,0,135,136,809
1977,45780,10179,12066,243841,225607,1640,13.7,1381,11.6,63023,14108,48915,6.3,27.9,26555,11249,15306,5,11.8,36468,16.1,23.6,0,869,872,5183
1978,45780,10296,12205,223478,233663,1459,12,1320,10.9,34293,9780,24513,4.2,14.7,54662,14153,40509,6.1,23.4,-20369,-8.7,29.4,0,854,862,5841
1979,45780,10433,12369,235294,229363,1484,12.1,1256,10.2,35914,10959,24955,4.8,15.7,24052,7497,16555,3.3,10.5,11862,5.2,21,0,804,806,3950
1980,45780,10449,12407,224613,229900,1322,10.7,1247,10.1,29298,10144,19154,4.4,12.7,39871,8916,30955,3.9,17.3,-10573,-4.6,25.4,0,835,841,4380
1981,45780,10115,12010,213761,217297,1282,10.5,1576,12.9,28619,12667,15952,5.8,13.2,35691,11785,23906,5.4,16.4,-7072,-3.2,26.4,0,854,859,5057
1982,45780,10083,12165,209854,212014,1496,12.4,1226,10.1,28564,11597,16967,5.5,13.5,32883,9683,23200,4.6,15.5,-4319,-2,27,0,656,658,3983
1983,45780,10129,12187,207897,208763,1145,9.4,1234,10.1,28995,9056,19939,4.3,13.9,30727,10739,19988,5.1,14.7,-1732,-0.8,27.8,0,750,753,4432
1984,45780,10374,12444,221865,214696,1431,11.6,1167,9.5,36605,11279,25326,5.3,17,22267,7436,14831,3.5,10.4,14338,6.6,20.8,0,702,710,3395
1985,45780,10579,12617,225601,222698,1441,11.5,1262,10.1,36717,14893,21824,6.7,16.5,30911,15198,15713,6.8,13.9,5806,2.6,27.8,0,756,758,8688
1986,45780,10742,12891,239969,232745,1549,12.1,1237,9.7,45778,18126,27652,7.8,19.7,31329,10001,21328,4.3,13.5,14449,6.2,27,0,764,767,5003
1987,45780,11101,13365,247933,245470,1852,14.1,1319,10,41051,15189,25862,6.2,16.7,36124,12714,23410,5.2,14.7,4927,2,29.4,0,773,779,4911
1988,45780,11295,13623,256833,251422,1673,12.4,1404,10.4,45241,15954,29287,6.3,18,34418,11684,22734,4.6,13.7,10823,4.3,27.4,0,841,841,5166
1989,45780,11461,13872,265147,261847,1504,10.9,1270,9.2,41778,15346,26432,5.9,16,35178,12637,22541,4.8,13.4,6600,2.6,26.8,0,826,834,5982
1990,45780,11528,13949,263731,264341,1389,10,1242,8.9,35723,13650,22073,5.2,13.5,36943,11183,25760,4.2,14,-1220,-0.5,27,0,808,818,5494
1991,45780,11509,13984,256501,260193,1364,9.8,1330,9.5,32410,12305,20105,4.7,12.5,39793,11447,28346,4.4,15.3,-7383,-2.8,25,0,802,805,5408
1992,45780,11568,14084,255304,255965,1462,10.4,1333,9.5,35555,11098,24457,4.3,13.9,36876,10963,25913,4.3,14.4,-1321,-0.5,27.8,0,774,790,5082
1993,45780,11639,14070,258853,256913,1345,9.6,1322,9.4,37456,12848,24608,5,14.6,33575,12477,21098,4.9,13.1,3881,1.5,26.2,0,801,812,5588
1994,45780,11725,14209,268217,263309,1376,9.7,1224,8.7,39944,12710,27234,4.8,15.2,30127,10222,19905,3.9,11.4,9817,3.8,22.8,0,790,799,4876
1995,45780,11848,14325,279818,273798,1412,9.9,1252,8.8,41503,13410,28093,4.9,15.2,29462,10513,18949,3.8,10.8,12041,4.4,21.6,0,771,773,5108
1996,45780,11900,14416,281863,280906,1389,9.7,1282,8.9,40094,13519,26575,4.8,14.3,38179,14934,23245,5.3,13.6,1915,0.7,27.2,0,796,796,5235
1997,45780,11953,14496,286613,284258,1557,10.8,1452,10,43311,15347,27964,5.4,15.2,38601,12082,26519,4.3,13.6,4710,1.6,27.2,0,841,841,5245
1998,45780,12040,14575,294296,290785,1414,9.7,1309,9,43289,13718,29571,4.7,14.9,36266,13507,22759,4.6,12.5,7023,2.4,25,0,790,790,4522
1999,45780,12001,14657,292021,293171,1358,9.3,1270,8.7,38980,14639,24341,5,13.3,41279,13196,28083,4.5,14.1,-2299,-0.8,26.6,0,813,813,6151
2000,45780,11976,14636,299378,295665,1248,8.5,1274,8.7,40955,12852,28103,4.3,13.9,33529,10176,23353,3.4,11.3,7426,2.6,22.6,0,763,763,3920
2001,45780,11944,14655,297231,299385,1277,8.7,1344,9.2,36169,11683,24486,3.9,12.1,40476,12291,28185,4.1,13.5,-4307,-1.4,24.2,0,726,727,4424
2002,45780,11841,14583,292259,294554,1532,10.5,1577,10.8,41826,17085,24741,5.8,14.2,46416,13762,32654,4.7,15.8,-4590,-1.6,28.4,0,788,789,5198
2003,45780,11844,14563,290841,289575,1379,9.5,1144,7.9,37908,13054,24854,4.5,13.1,35375,9565,25810,3.3,12.2,2533,0.9,24.4,0,760,765,5673
2004,45780,11799,14517,294954,292624,1281,8.8,1153,8,39938,13574,26364,4.6,13.6,35279,9138,26141,3.1,12.1,4659,1.5,24.2,0,754,754,4659
2005,45780,11794,14532,294147,293949,1256,8.7,1148,7.9,39010,15927,23083,5.4,13.3,38615,8522,30093,2.9,13.1,395,0.2,26.2,0,785,787,5353
2006,45780,11617,14436,298069,294759,1318,9.1,1241,8.6,39794,15500,24294,5.3,13.5,33174,8646,24528,2.9,11.3,6620,2.2,22.6,0,814,814,5499
2007,45780,11444,14393,293458,295238,1367,9.5,1365,9.5,39273,13842,25431,4.7,13.3,42832,11936,30896,4,14.5,-3559,-1.2,26.6,0,832,835,6219
2008,45780,11198,14133,285858,288590,1126,7.9,1239,8.7,34097,13091,21006,4.5,11.8,39560,10827,28733,3.8,13.7,-5463,-1.9,23.6,0,826,826,6259
2009,45780,10812,13651,265586,274743,935,6.8,1285,9.3,24140,8977,15163,3.3,8.8,42453,9611,32842,3.5,15.5,-18313,-6.7,17.6,0,815,830,5006
2010,45780,10604,13422,263838,264124,1013,7.5,1158,8.6,29596,8227,21369,3.1,11.2,30167,8155,22012,3.1,11.4,-571,-0.2,22.4,0,733,733,4556
2011,45780,10495,13316,269246,265779,969,7.3,1011,7.6,33845,9073,24772,3.4,12.7,26910,9961,16949,3.7,10.1,6935,2.6,20.2,0,658,658,6351
2012,45780,10507,13291,268053,266464,1048,7.9,1072,8.1,33772,9027,24745,3.4,12.7,30593,10723,19870,4,11.5,3179,1.2,23,0,621,622,5073
2013,45780,10410,13181,273469,270111,899,6.8,967,7.3,32749,9246,23503,3.4,12.1,26032,6498,19534,2.4,9.6,6717,2.5,19.2,0,608,608,4630
2014,45780,10250,13109,275482,273913,1013,7.7,990,7.6,32112,8208,23904,3,11.7,28973,8686,20287,3.2,10.6,3139,1.1,21.2,0,647,662,6306
1977,45820,3672,4003,55881,54729,602,15,592,14.8,10287,4732,5555,8.6,18.8,7983,3978,4005,7.3,14.6,2304,4.2,29.2,0,428,429,2919
1978,45820,3807,4153,58955,57504,607,14.9,455,11.2,9817,3357,6460,5.8,17.1,6915,3155,3760,5.5,12,2902,5.1,24,0,327,327,1795
1979,45820,3862,4215,61680,60296,572,13.7,490,11.7,10165,3914,6251,6.5,16.9,7396,2860,4536,4.7,12.3,2769,4.6,24.6,0,349,351,1697
1980,45820,3856,4211,60527,61035,524,12.4,510,12.1,8984,3161,5823,5.2,14.7,9999,2997,7002,4.9,16.4,-1015,-1.7,29.4,0,367,370,1769
1981,45820,3758,4115,60142,59957,509,12.3,558,13.4,8731,3656,5075,6.1,14.6,8361,2825,5536,4.7,13.9,370,0.7,27.8,0,349,350,1632
1982,45820,3778,4208,71646,65888,589,14.1,430,10.3,20149,5141,15008,7.8,30.6,8632,2814,5818,4.3,13.1,11517,17.5,26.2,0,258,259,1539
1983,45820,3865,4284,60594,65288,505,11.9,476,11.2,10205,4884,5321,7.5,15.6,19593,13732,5861,21,30,-9388,-14.4,31.2,0,317,317,1581
1984,45820,3887,4308,64240,62355,559,13,541,12.6,12707,5078,7629,8.1,20.4,8936,4013,4923,6.4,14.3,3771,6.1,28.6,0,324,324,2622
1985,45820,4010,4419,65905,65395,586,13.4,477,10.9,10823,4090,6733,6.3,16.6,9802,4216,5586,6.4,15,1021,1.6,30,0,297,302,2012
1986,45820,4071,4490,67148,66505,576,12.9,494,11.1,10531,4388,6143,6.6,15.8,9244,2881,6363,4.3,13.9,1287,1.9,27.8,0,334,336,1683
1987,45820,4170,4590,71365,70286,640,14.1,536,11.8,11985,4716,7269,6.7,17.1,9826,4265,5561,6.1,14,2159,3.1,28,0,344,345,2013
1988,45820,4173,4665,73655,72076,603,13.1,495,10.7,13090,5927,7163,8.2,18.2,9932,3428,6504,4.8,13.8,3158,4.4,27.6,0,364,364,2254
1989,45820,4212,4730,75256,74690,556,11.8,485,10.3,10826,5143,5683,6.9,14.5,9694,3273,6421,4.4,13,1132,1.5,26,0,334,339,1953
1990,45820,4246,4757,75958,75568,511,10.8,471,9.9,10492,3818,6674,5.1,13.9,9712,3786,5926,5,12.9,780,1,25.8,0,319,320,2130
1991,45820,4265,4790,74797,75367,548,11.5,510,10.7,10585,4929,5656,6.5,14,11725,3845,7880,5.1,15.6,-1140,-1.6,28,0,322,330,2565
1992,45820,4323,4861,75184,74981,532,11,449,9.3,9977,3406,6571,4.5,13.3,9570,2482,7088,3.3,12.8,407,0.5,25.6,0,275,275,1426
1993,45820,4300,4834,76119,75604,460,9.5,484,10,10168,2687,7481,3.6,13.4,9138,3418,5720,4.5,12.1,1030,1.3,24.2,0,329,332,1635
1994,45820,4346,4889,78898,77405,525,10.8,458,9.4,10782,4558,6224,5.9,13.9,7797,2359,5438,3,10.1,2985,3.8,20.2,0,316,320,1307
1995,45820,4412,4950,80266,79597,509,10.3,430,8.7,9640,3135,6505,3.9,12.1,8302,2640,5662,3.3,10.4,1338,1.7,20.8,0,299,301,1329
1996,45820,4476,5023,82716,81557,516,10.4,442,8.9,11854,4679,7175,5.7,14.5,9535,3032,6503,3.7,11.7,2319,2.8,23.4,0,306,306,1777
1997,45820,4468,5039,85328,84053,596,11.8,577,11.5,13399,5121,8278,6.1,15.9,10848,3848,7000,4.6,12.9,2551,3,25.8,0,350,350,1963
1998,45820,4546,5130,88065,87083,569,11.2,473,9.3,12408,5045,7363,5.8,14.2,10444,3794,6650,4.4,12,1964,2.2,24,0,316,316,1644
1999,45820,4559,5153,91890,89930,513,10,482,9.4,14416,4310,10106,4.8,16,10496,3703,6793,4.1,11.7,3920,4.3,23.4,0,328,328,1800
2000,45820,4536,5141,94554,93215,495,9.6,504,9.8,13493,4762,8731,5.1,14.5,10815,4611,6204,4.9,11.6,2678,2.9,23.2,0,317,317,1567
2001,45820,4506,5127,87464,91214,474,9.2,532,10.3,9784,3523,6261,3.9,10.7,17283,5509,11774,6,18.9,-7499,-8.2,21.4,0,310,310,1282
2002,45820,4546,5160,86389,86927,620,12.1,581,11.3,13778,5592,8186,6.4,15.9,14853,5725,9128,6.6,17.1,-1075,-1.2,31.8,0,314,314,2389
2003,45820,4539,5151,87539,86533,539,10.5,465,9.1,12040,4332,7708,5,13.9,10027,2942,7085,3.4,11.6,2013,2.3,23.2,0,327,327,1806
2004,45820,4562,5190,84560,85498,528,10.2,440,8.5,10499,4341,6158,5.1,12.3,12374,3676,8698,4.3,14.5,-1875,-2.2,24.6,0,302,302,2446
2005,45820,4600,5214,87352,85738,521,10.1,435,8.4,13789,5865,7924,6.8,16.1,10561,3163,7398,3.7,12.3,3228,3.8,24.6,0,308,308,1899
2006,45820,4575,5205,85939,86328,524,10.1,490,9.4,10937,4634,6303,5.4,12.7,11714,3606,8108,4.2,13.6,-777,-0.9,25.4,0,318,318,1770
2007,45820,4595,5230,83029,84326,531,10.2,505,9.7,11405,5126,6279,6.1,13.5,13998,3613,10385,4.3,16.6,-2593,-3.1,27,0,338,339,1965
2008,45820,4503,5174,84402,83687,442,8.5,460,8.9,10423,3872,6551,4.6,12.5,8992,2905,6087,3.5,10.7,1431,1.8,21.4,0,332,332,1749
2009,45820,4366,5020,85154,84575,353,6.9,460,9.1,10207,3316,6891,3.9,12.1,9049,2442,6607,2.9,10.7,1158,1.4,21.4,0,320,320,1587
2010,45820,4290,4962,84108,84438,362,7.3,400,8,8575,2225,6350,2.6,10.2,9235,2301,6934,2.7,10.9,-660,-0.7,20.4,0,285,285,1641
2011,45820,4168,4858,82526,83233,336,6.9,399,8.1,8831,2278,6553,2.7,10.6,10244,2832,7412,3.4,12.3,-1413,-1.7,21.2,0,277,277,2116
2012,45820,4214,4923,83836,83228,409,8.4,368,7.5,10129,3224,6905,3.9,12.2,8913,2372,6541,2.9,10.7,1216,1.5,21.4,0,223,228,1345
2013,45820,4104,4817,83805,83364,313,6.5,412,8.5,9509,3660,5849,4.4,11.4,8626,2589,6037,3.1,10.3,883,1.1,20.6,0,284,286,1705
2014,45820,4040,4742,84482,83816,322,6.8,355,7.5,9127,2669,6458,3.2,10.9,7795,2392,5403,2.9,9.3,1332,1.6,18.6,0,244,244,1250
1977,45940,5340,5825,109261,106527,874,15.3,658,11.5,19121,8266,10855,7.8,17.9,13654,5481,8173,5.1,12.8,5467,5.1,25.6,0,420,421,2594
1978,45940,5415,5906,120428,114862,689,11.7,619,10.6,23193,4869,18324,4.2,20.2,12060,5206,6854,4.5,10.5,11133,9.7,21,0,375,375,1931
1979,45940,5508,6009,120993,120645,718,12.1,579,9.7,20086,6302,13784,5.2,16.6,19391,4881,14510,4,16.1,695,0.5,32.2,0,391,391,2386
1980,45940,5559,6054,121304,121101,678,11.2,603,10,16067,4732,11335,3.9,13.3,15662,3835,11827,3.2,12.9,405,0.4,25.8,0,411,411,2008
1981,45940,5439,5912,117566,118083,654,10.9,747,12.5,16109,5775,10334,4.9,13.6,17142,6910,10232,5.9,14.5,-1033,-0.9,27.2,0,423,424,2482
1982,45940,5514,6047,118642,118033,771,12.9,605,10.1,17213,6556,10657,5.6,14.6,15995,5828,10167,4.9,13.6,1218,1,27.2,0,340,341,2738
1983,45940,5713,6253,121041,119817,714,11.6,555,9,17704,7165,10539,6,14.8,15257,4090,11167,3.4,12.7,2447,2.1,25.4,0,334,335,1876
1984,45940,5886,6437,128753,124551,795,12.5,621,9.8,21680,8644,13036,6.9,17.4,13275,4995,8280,4,10.7,8405,6.7,21.4,0,389,391,1812
1985,45940,6118,6703,133042,132880,824,12.5,570,8.7,21407,8194,13213,6.2,16.1,21082,12300,8782,9.3,15.9,325,0.2,31.8,0,369,370,2393
1986,45940,6327,6915,146043,139502,914,13.4,675,9.9,29512,14973,14539,10.7,21.2,16429,5512,10917,4,11.8,13083,9.4,23.6,0,423,424,2601
1987,45940,6567,7233,156389,151573,1076,15.2,732,10.3,29787,14398,15389,9.5,19.7,20155,7329,12826,4.8,13.3,9632,6.4,26.6,0,471,472,3058
1988,45940,6729,7447,153200,153226,1015,13.8,759,10.4,27223,12488,14735,8.2,17.8,27274,8979,18295,5.9,17.8,-51,0,35.6,0,492,492,3181
1989,45940,6789,7715,159217,156161,1043,13.8,782,10.3,29141,12357,16784,7.9,18.7,23028,9668,13360,6.2,14.7,6113,4,29.4,0,504,504,3649
1990,45940,6855,7834,162976,162253,886,11.4,719,9.2,22438,8723,13715,5.4,13.8,20991,6829,14162,4.2,12.9,1447,0.9,25.8,0,484,484,2541
1991,45940,6831,7885,159640,161258,895,11.4,835,10.6,23445,10870,12575,6.7,14.5,26680,9665,17015,6,16.5,-3235,-2,29,0,489,492,4196
1992,45940,6807,7878,158876,158166,824,10.4,800,10.1,26086,5480,20606,3.5,16.5,24665,7209,17456,4.6,15.6,1421,0.9,31.2,0,470,472,2114
1993,45940,6896,7908,157076,158259,790,10,714,9,21735,5925,15810,3.7,13.7,24103,5871,18232,3.7,15.2,-2368,-1.5,27.4,0,466,467,2885
1994,45940,6974,7973,155967,156010,804,10.1,759,9.6,19863,5750,14113,3.7,12.7,19949,6235,13714,4,12.8,-86,-0.1,25.4,0,435,435,2282
1995,45940,7037,8038,159766,157870,836,10.4,760,9.5,22891,7977,14914,5.1,14.5,19099,4862,14237,3.1,12.1,3792,2.4,24.2,0,477,477,2058
1996,45940,7108,8113,159355,159418,832,10.3,750,9.3,20628,6464,14164,4.1,12.9,20753,7109,13644,4.5,13,-125,-0.1,25.8,0,473,473,2849
1997,45940,7259,8209,160459,160211,981,12,881,10.8,24409,7492,16917,4.7,15.2,23912,9257,14655,5.8,14.9,497,0.3,29.8,0,481,481,2893
1998,45940,7385,8340,160520,160455,983,11.9,836,10.1,24315,8907,15408,5.6,15.2,24184,9362,14822,5.8,15.1,131,0.1,30.2,0,521,521,2552
1999,45940,7443,8437,169288,164776,895,10.7,781,9.3,30896,11788,19108,7.2,18.8,21872,9477,12395,5.8,13.3,9024,5.5,26.6,0,497,497,4029
2000,45940,7467,8615,176956,173285,1065,12.5,895,10.5,29664,12556,17108,7.2,17.1,22321,8702,13619,5,12.9,7343,4.2,25.8,0,539,539,3266
2001,45940,7538,8790,180165,179023,1055,12.1,945,10.8,29484,11612,17872,6.5,16.5,27199,10343,16856,5.8,15.2,2285,1.3,30.4,0,542,542,6899
2002,45940,7603,8966,179154,178780,1103,12.4,908,10.2,29878,11794,18084,6.6,16.7,29130,10255,18875,5.7,16.3,748,0.4,32.6,0,478,478,3309
2003,45940,7644,9100,182222,179793,1203,13.4,942,10.5,29599,11692,17907,6.5,16.5,24740,7087,17653,3.9,13.8,4859,2.7,27.6,0,558,558,3148
2004,45940,7751,8757,182260,181363,968,10.9,1221,13.7,30127,9307,20820,5.1,16.6,28333,11849,16484,6.5,15.6,1794,1,31.2,0,502,502,3722
2005,45940,7880,8913,181976,181582,1042,11.8,820,9.3,24598,9642,14956,5.3,13.5,23809,8948,14861,4.9,13.1,789,0.4,26.2,0,538,538,4819
2006,45940,7910,8988,189620,185357,999,11.2,845,9.5,30502,12489,18013,6.7,16.5,21976,8930,13046,4.8,11.9,8526,4.6,23.8,0,576,576,3895
2007,45940,7878,9026,192373,190828,1011,11.2,959,10.7,31220,11011,20209,5.8,16.4,28129,8471,19658,4.4,14.7,3091,1.7,29.4,0,633,633,4260
2008,45940,7900,9076,195844,193487,932,10.3,800,8.9,30975,13951,17024,7.2,16,26260,7909,18351,4.1,13.6,4715,2.4,27.2,0,562,562,4068
2009,45940,7619,8843,181642,188457,788,8.8,940,10.5,17599,6816,10783,3.6,9.3,31229,8332,22897,4.4,16.6,-13630,-7.3,18.6,0,628,628,3786
2010,45940,7519,8689,176388,177543,813,9.3,901,10.3,19420,6196,13224,3.5,10.9,21730,7431,14299,4.2,12.2,-2310,-1.3,21.8,0,520,520,2564
2011,45940,7515,8690,184169,180197,866,10,821,9.5,25973,11394,14579,6.3,14.4,18028,5265,12763,2.9,10,7945,4.4,20,0,526,526,2650
2012,45940,7483,8657,195351,189486,836,9.7,851,9.8,29851,5351,24500,2.8,15.8,18120,6611,11509,3.5,9.6,11731,6.2,19.2,0,494,494,2995
2013,45940,7554,8738,197477,196213,857,9.9,774,8.9,31685,6631,25054,3.4,16.1,29157,7571,21586,3.9,14.9,2528,1.2,29.8,0,484,485,3674
2014,45940,7475,8660,190278,193537,840,9.7,870,10,20885,8230,12655,4.3,10.8,27402,5654,21748,2.9,14.2,-6517,-3.4,21.6,0,587,587,3650
1977,46060,7323,8494,112964,110868,1691,20.5,1161,14.1,25296,12860,12436,11.6,22.8,21104,10464,10640,9.4,19,4192,3.8,38,0,817,819,6020
1978,46060,7149,8389,122195,117385,1480,17.5,1500,17.8,30656,12585,18071,10.7,26.1,21038,10046,10992,8.6,17.9,9618,8.2,35.8,0,837,841,4600
1979,46060,8163,9483,142559,132707,1762,19.7,734,8.2,38150,16757,21393,12.6,28.7,18446,6340,12106,4.8,13.9,19704,14.8,27.8,0,26,29,503
1980,46060,8599,9969,149307,145735,1755,18.1,1210,12.4,31925,13236,18689,9.1,21.9,24780,9570,15210,6.6,17,7145,4.9,34,0,869,871,5757
1981,46060,8547,9962,155029,151504,1639,16.5,1555,15.6,33690,12945,20745,8.5,22.2,26640,11183,15457,7.4,17.6,7050,4.6,35.2,0,1014,1016,5739
1982,46060,8909,10636,160505,156621,2120,20.6,1369,13.3,38204,22039,16165,14.1,24.4,30436,9780,20656,6.2,19.4,7768,5,38.8,0,765,766,4071
1983,46060,9334,11123,156387,157668,1699,15.6,1282,11.8,32382,15510,16872,9.8,20.5,34943,10589,24354,6.7,22.2,-2561,-1.7,41,0,837,845,5418
1984,46060,9866,11690,174141,165650,1916,16.8,1371,12,40694,15754,24940,9.5,24.6,23712,8898,14814,5.4,14.3,16982,10.3,28.6,0,875,879,4664
1985,46060,10291,12107,187246,181071,2019,17,1581,13.3,45283,18022,27261,10,25,32934,15815,17119,8.7,18.2,12349,6.8,36.4,0,1018,1028,8076
1986,46060,10675,12584,194478,190962,2175,17.6,1656,13.4,43938,21390,22548,11.2,23,36907,14021,22886,7.3,19.3,7031,3.7,38.6,0,1092,1093,8870
1987,46060,11077,13168,205735,202610,2381,18.5,1721,13.4,45427,21420,24007,10.6,22.4,39177,18940,20237,9.3,19.3,6250,3.1,38.6,0,1098,1116,8534
1988,46060,11159,13342,210115,207138,2035,15.4,1792,13.5,45867,21604,24263,10.4,22.1,39913,15419,24494,7.4,19.3,5954,2.8,38.6,0,1193,1193,7873
1989,46060,11312,13582,211174,211021,1971,14.6,1732,12.9,42447,20676,21771,9.8,20.1,42140,17468,24672,8.3,20,307,0.1,40,0,1123,1127,11854
1990,46060,11434,13682,209034,209814,1846,13.5,1648,12.1,37595,13069,24526,6.2,17.9,39154,13625,25529,6.5,18.7,-1559,-0.8,35.8,0,1122,1136,6783
1991,46060,11707,14032,208923,208874,1902,13.7,1554,11.2,34262,13647,20615,6.5,16.4,34164,10099,24065,4.8,16.4,98,0,32.8,0,968,982,5731
1992,46060,11739,14110,210245,209681,1832,13,1706,12.1,36623,13921,22702,6.6,17.5,35495,13444,22051,6.4,16.9,1128,0.6,33.8,0,1069,1097,7873
1993,46060,12031,14272,218229,214283,1764,12.4,1563,11,39562,11978,27584,5.6,18.5,31669,11432,20237,5.3,14.8,7893,3.7,29.6,0,971,974,5833
1994,46060,12470,14822,234852,226384,2051,14.1,1454,10,47487,16831,30656,7.4,21,30551,10839,19712,4.8,13.5,16936,7.5,27,0,979,981,6737
1995,46060,12815,15186,240918,237560,1990,13.3,1558,10.4,41904,18295,23609,7.7,17.6,35188,11805,23383,5,14.8,6716,2.8,29.6,0,1015,1042,6258
1996,46060,13035,15471,245766,243196,2023,13.2,1682,11,39177,14956,24221,6.1,16.1,34036,11040,22996,4.5,14,5141,2.1,28,0,1107,1107,6005
1997,46060,13316,15850,254684,250262,2255,14.4,1893,12.1,48983,20530,28453,8.2,19.6,40141,15360,24781,6.1,16,8842,3.6,32,0,1162,1162,7762
1998,46060,13348,15956,263537,258899,1978,12.4,1825,11.5,48275,21035,27240,8.1,18.6,38999,15055,23944,5.8,15.1,9276,3.5,30.2,0,1200,1200,7586
1999,46060,13397,16171,276190,270509,2082,13,1871,11.6,50338,18861,31477,7,18.6,38976,17404,21572,6.4,14.4,11362,4.2,28.8,0,1162,1162,8029
2000,46060,13441,16338,287230,281949,2071,12.7,1907,11.7,53000,18396,34604,6.5,18.8,42437,18960,23477,6.7,15.1,10563,3.7,30.2,0,1126,1126,7292
2001,46060,13700,16698,291767,290346,2042,12.3,1843,11.1,48049,19039,29010,6.6,16.5,45207,17525,27682,6,15.6,2842,0.9,31.2,0,1033,1033,7807
2002,46060,13800,16860,290321,292142,2219,13.2,2040,12.2,51225,22647,28578,7.8,17.5,54867,18468,36399,6.3,18.8,-3642,-1.3,35,0,1073,1075,6890
2003,46060,14028,17133,296110,292242,2150,12.7,1604,9.5,47620,16605,31015,5.7,16.3,39884,11902,27982,4.1,13.6,7736,2.7,27.2,0,1058,1066,5851
2004,46060,14182,17347,303546,298525,2026,11.8,1576,9.2,46640,16613,30027,5.6,15.6,36597,11058,25539,3.7,12.3,10043,3.3,24.6,0,1049,1049,5626
2005,46060,14551,17868,312921,307265,2213,12.6,1477,8.4,50775,20118,30657,6.5,16.5,39462,12069,27393,3.9,12.8,11313,3.7,25.6,0,1055,1055,7821
2006,46060,15016,18567,336354,324007,2549,14,1719,9.5,59093,22650,36443,7,18.2,34399,12272,22127,3.8,10.6,24694,7.6,21.2,0,1151,1153,7341
2007,46060,15438,19152,336100,335182,2402,12.7,1794,9.5,54364,19400,34964,5.8,16.2,52528,15362,37166,4.6,15.7,1836,0.5,31.4,0,1102,1110,8000
2008,46060,15248,19085,329853,331731,2082,10.9,1960,10.3,46162,16743,29419,5,13.9,49918,14182,35736,4.3,15,-3756,-1.1,27.8,0,1411,1415,8841
2009,46060,14593,18353,308623,317807,1595,8.6,2086,11.2,35483,13538,21945,4.3,11.2,53850,13674,40176,4.3,16.9,-18367,-5.7,22.4,0,1385,1385,7502
2010,46060,14261,18046,304425,305627,1679,9.3,1839,10.1,39454,17539,21915,5.7,12.9,41858,9869,31989,3.2,13.7,-2404,-0.8,25.8,0,1217,1228,5864
2011,46060,14052,17934,303751,303194,1708,9.5,1713,9.6,36568,12871,23697,4.2,12.1,35454,10268,25186,3.4,11.7,1114,0.4,23.4,0,1159,1164,6002
2012,46060,14039,17922,307517,305182,1730,9.7,1711,9.6,41278,13040,28238,4.3,13.5,36608,11392,25216,3.7,12,4670,1.5,24,0,1046,1062,4942
2013,46060,13977,17875,309477,307827,1518,8.5,1567,8.8,37599,12772,24827,4.1,12.2,34300,9121,25179,3,11.1,3299,1.1,22.2,0,1001,1006,6274
2014,46060,13856,17787,302079,305024,1608,9.1,1560,8.8,31792,11142,20650,3.7,10.4,37682,10799,26883,3.5,12.4,-5890,-2,20.8,0,1079,1100,7009
1977,46140,12878,14774,234885,225983,2694,18.7,1930,13.4,51637,23376,28261,10.3,22.8,33833,14299,19534,6.3,15,17804,7.8,30,0,1375,1378,8928
1978,46140,12220,14150,237071,235616,2195,15.2,2654,18.4,48630,16368,32262,6.9,20.6,45721,25170,20551,10.7,19.4,2909,1.2,38.8,0,1562,1564,14232
1979,46140,13500,15521,259893,248780,2568,17.3,1302,8.8,53937,19515,34422,7.8,21.7,31710,10459,21251,4.2,12.7,22227,9,25.4,0,28,28,419
1980,46140,13828,15873,275177,267014,2456,15.6,2017,12.9,57109,20782,36327,7.8,21.4,40783,13524,27259,5.1,15.3,16326,6.1,30.6,0,1451,1458,7826
1981,46140,13929,15885,284132,276839,2449,15.5,2258,14.2,57412,21569,35843,7.8,20.7,42826,18188,24638,6.6,15.5,14586,5.2,31,0,1445,1446,7226
1982,46140,14663,16928,296085,289928,3057,18.6,1905,11.6,62502,28002,34500,9.7,21.6,50188,18352,31836,6.3,17.3,12314,4.3,34.6,0,1128,1130,8425
1983,46140,14904,17165,276821,284694,2342,13.7,2190,12.9,48587,22778,25809,8,17.1,64332,17815,46517,6.3,22.6,-15745,-5.5,34.2,0,1574,1578,8964
1984,46140,15234,17557,279743,278225,2651,15.3,2238,12.9,53776,22065,31711,7.9,19.3,50740,16302,34438,5.9,18.2,3036,1.1,36.4,0,1525,1527,7692
1985,46140,15650,18012,289213,287509,2776,15.6,2379,13.4,51021,20215,30806,7,17.7,47613,15961,31652,5.6,16.6,3408,1.1,33.2,0,1620,1625,7813
1986,46140,15516,17907,287883,288345,2618,14.6,2627,14.6,50776,22129,28647,7.7,17.6,51700,19689,32011,6.8,17.9,-924,-0.3,35.2,0,1835,1839,10215
1987,46140,15198,17749,273705,280699,2677,15,2710,15.2,47771,23524,24247,8.4,17,61759,22202,39557,7.9,22,-13988,-5,34,0,1799,1815,11153
1988,46140,14660,17321,273474,270414,2307,13.2,2532,14.5,52961,19147,33814,7.1,19.6,46840,20023,26817,7.4,17.3,6121,2.3,34.6,0,1669,1669,8970
1989,46140,14850,17522,279647,276963,2342,13.4,2177,12.5,48683,18541,30142,6.7,17.6,43315,16684,26631,6,15.6,5368,2,31.2,0,1446,1447,8687
1990,46140,15109,17773,293333,286398,2286,13,1935,11,53032,17874,35158,6.2,18.5,39161,14522,24639,5.1,13.7,13871,4.8,27.4,0,1273,1273,8237
1991,46140,15515,18244,299386,296346,2374,13.2,1924,10.7,47004,18393,28611,6.2,15.9,40923,14413,26510,4.9,13.8,6081,2.1,27.6,0,1189,1197,7716
1992,46140,15670,18537,298359,298382,2437,13.2,2050,11.1,47588,17225,30363,5.8,15.9,47634,15042,32592,5,16,-46,-0.1,31.8,0,1397,1411,8262
1993,46140,16052,18846,305184,301914,2236,12,1904,10.2,48807,17425,31382,5.8,16.2,42267,14828,27439,4.9,14,6540,2.2,28,0,1264,1265,6479
1994,46140,16396,19213,308504,306635,2392,12.6,1967,10.3,48701,17653,31048,5.8,15.9,44962,13697,31265,4.5,14.7,3739,1.2,29.4,0,1373,1373,7184
1995,46140,16641,19519,314617,311399,2492,12.9,2098,10.8,49897,18663,31234,6,16,43462,16607,26855,5.3,14,6435,2,28,0,1454,1465,7589
1996,46140,16883,19803,326420,320983,2366,12,2068,10.5,53082,20688,32394,6.4,16.5,42208,14765,27443,4.6,13.1,10874,3.4,26.2,0,1390,1390,7259
1997,46140,17079,20203,339400,332904,2714,13.6,2293,11.5,64684,22158,42526,6.7,19.4,51692,17988,33704,5.4,15.5,12992,3.9,31,0,1483,1483,10515
1998,46140,17289,20375,359603,349180,2395,11.8,2172,10.7,64012,19774,44238,5.7,18.3,43166,17250,25916,4.9,12.4,20846,5.9,24.8,0,1407,1407,9264
1999,46140,17305,20502,361938,360840,2390,11.7,2221,10.9,63681,26412,37269,7.3,17.6,61484,20727,40757,5.7,17,2197,0.6,34,0,1408,1408,7852
2000,46140,17262,20560,371047,366471,2312,11.3,2259,11,63599,25338,38261,6.9,17.4,54447,17844,36603,4.9,14.9,9152,2.5,29.8,0,1368,1368,8028
2001,46140,17311,20739,375776,373875,2400,11.6,2398,11.6,62168,21853,40315,5.8,16.6,58366,23515,34851,6.3,15.6,3802,1,31.2,0,1352,1352,6978
2002,46140,17537,20934,369775,371747,2711,13,2463,11.8,66224,26850,39374,7.2,17.8,70168,27344,42824,7.4,18.9,-3944,-1.1,35.6,0,1310,1310,8850
2003,46140,17584,21074,359555,362557,2497,11.9,1952,9.3,52546,19932,32614,5.5,14.5,58550,15972,42578,4.4,16.1,-6004,-1.6,29,0,1431,1431,9428
2004,46140,17782,21254,354430,354583,2420,11.5,2031,9.6,50599,18541,32058,5.2,14.3,50905,15664,35241,4.4,14.4,-306,-0.1,28.6,0,1335,1340,8308
2005,46140,18052,21661,362120,358827,2646,12.4,2011,9.4,55045,21285,33760,5.9,15.3,48458,15773,32685,4.4,13.5,6587,1.8,27,0,1442,1448,10159
2006,46140,18242,21957,385114,371283,2567,11.8,2050,9.4,68793,25653,43140,6.9,18.5,41130,14113,27017,3.8,11.1,27663,7.4,22.2,0,1374,1383,7975
2007,46140,18363,22236,393438,388757,2558,11.6,2211,10,67261,21113,46148,5.4,17.3,57899,19057,38842,4.9,14.9,9362,2.4,29.8,0,1410,1423,8587
2008,46140,18360,22376,401527,396224,2290,10.3,1977,8.9,60655,20766,39889,5.2,15.3,50049,12743,37306,3.2,12.6,10606,2.7,25.2,0,1390,1393,8025
2009,46140,18172,22147,389357,394616,2033,9.2,2121,9.6,47461,17515,29946,4.4,12,57978,17710,40268,4.5,14.7,-10517,-2.7,24,0,1472,1473,9458
2010,46140,17954,21916,368438,377509,1835,8.4,1946,8.9,40922,16964,23958,4.5,10.8,59063,14397,44666,3.8,15.6,-18141,-4.8,21.6,0,1292,1294,8053
2011,46140,17620,21692,372779,370146,1954,9,2027,9.3,47645,14516,33129,3.9,12.9,42378,13884,28494,3.8,11.4,5267,1.5,22.8,0,1417,1417,8525
2012,46140,17822,21871,382206,377336,2121,9.8,1963,9,53913,17476,36437,4.6,14.3,44172,15102,29070,4,11.7,9741,2.6,23.4,0,1141,1154,7015
2013,46140,17928,22011,392975,386918,1974,9,1829,8.4,53023,15303,37720,4,13.7,40909,15069,25840,3.9,10.6,12114,3.1,21.2,0,1229,1236,9876
2014,46140,17906,22000,399791,394959,1959,8.9,1818,8.3,54553,19278,35275,4.9,13.8,44889,16500,28389,4.2,11.4,9664,2.4,22.8,0,1279,1281,11439
1977,46220,2228,2474,36286,34268,379,15.6,291,12,9858,6528,3330,19,28.8,5822,2001,3821,5.8,17,4036,11.8,34,0,206,207,1505
1978,46220,2274,2530,35225,35759,397,15.9,338,13.5,8129,3252,4877,9.1,22.7,9196,3697,5499,10.3,25.7,-1067,-3,45.4,0,248,250,1380
1979,46220,2297,2559,37112,36131,335,13.2,294,11.6,7431,2472,4959,6.8,20.6,5468,1740,3728,4.8,15.1,1963,5.5,30.2,0,207,207,1043
1980,46220,2266,2528,35431,36236,289,11.4,303,11.9,4794,1689,3105,4.7,13.2,6404,2289,4115,6.3,17.7,-1610,-4.5,26.4,0,228,228,1448
1981,46220,2218,2482,34587,34071,331,13.3,329,13.2,7027,2724,4303,8,20.6,5994,2931,3063,8.6,17.6,1033,3,35.2,0,200,200,1767
1982,46220,2224,2512,34543,34553,345,13.8,281,11.2,6589,3628,2961,10.5,19.1,6608,3481,3127,10.1,19.1,-19,0,38.2,0,158,158,930
1983,46220,2305,2587,33425,33827,331,13,286,11.2,5544,2707,2837,8,16.4,6348,1771,4577,5.2,18.8,-804,-2.4,32.8,0,188,188,912
1984,46220,2440,2735,38543,36011,409,15.4,270,10.1,9356,3064,6292,8.5,26,4291,1845,2446,5.1,11.9,5065,14.1,23.8,0,183,185,1116
1985,46220,2498,2794,39186,39334,322,11.6,276,10,6238,2136,4102,5.4,15.9,6533,2333,4200,5.9,16.6,-295,-0.7,31.8,0,163,163,998
1986,46220,2602,2894,41492,40210,414,14.6,302,10.6,7516,2873,4643,7.1,18.7,4952,2318,2634,5.8,12.3,2564,6.4,24.6,0,204,207,1202
1987,46220,2690,3002,45085,44910,457,15.5,343,11.6,8045,3827,4218,8.5,17.9,7695,3211,4484,7.1,17.1,350,0.8,34.2,0,211,211,1711
1988,46220,2700,3036,47485,45989,397,13.2,336,11.2,8299,3349,4950,7.3,18,5307,2170,3137,4.7,11.5,2992,6.5,23,0,210,210,1113
1989,46220,2730,3087,49752,48660,409,13.4,355,11.6,8159,3010,5149,6.2,16.8,5975,2556,3419,5.3,12.3,2184,4.5,24.6,0,247,247,1657
1990,46220,2839,3194,53915,51750,380,12.1,257,8.2,9383,3028,6355,5.9,18.1,5052,1595,3457,3.1,9.8,4331,8.3,19.6,0,185,185,1118
1991,46220,2913,3286,53020,53376,384,11.9,287,8.9,6865,2531,4334,4.7,12.9,7577,2524,5053,4.7,14.2,-712,-1.3,25.8,0,187,188,1432
1992,46220,2936,3336,52335,52689,412,12.4,347,10.5,6556,2177,4379,4.1,12.4,7263,2426,4837,4.6,13.8,-707,-1.4,24.8,0,239,241,1384
1993,46220,3016,3412,57503,56431,414,12.3,335,9.9,8492,2518,5974,4.5,15,6348,2233,4115,4,11.2,2144,3.8,22.4,0,236,238,1497
1994,46220,3079,3460,59095,58261,421,12.3,360,10.5,8855,2971,5884,5.1,15.2,7186,2139,5047,3.7,12.3,1669,2.9,24.6,0,240,240,1166
1995,46220,3217,3602,62735,60811,471,13.3,315,8.9,10151,4382,5769,7.2,16.7,6303,2181,4122,3.6,10.4,3848,6.3,20.8,0,223,225,1468
1996,46220,3335,3731,65189,64300,512,14,380,10.4,9756,3712,6044,5.8,15.2,7978,2947,5031,4.6,12.4,1778,2.8,24.8,0,257,257,1313
1997,46220,3385,3805,66453,65766,489,13,425,11.3,10810,4069,6741,6.2,16.4,9436,3269,6167,5,14.3,1374,2.1,28.6,0,283,283,1494
1998,46220,3410,3836,68486,67512,446,11.7,404,10.6,10576,3862,6714,5.7,15.7,8628,3328,5300,4.9,12.8,1948,2.9,25.6,0,272,272,1583
1999,46220,3427,3849,70479,69555,428,11.1,410,10.7,10249,3955,6294,5.7,14.7,8400,2951,5449,4.2,12.1,1849,2.6,24.2,0,285,285,1684
2000,46220,3436,3849,73552,72004,397,10.3,396,10.3,11209,3754,7455,5.2,15.6,8113,2856,5257,4,11.3,3096,4.3,22.6,0,258,258,1517
2001,46220,3411,3853,72556,73374,391,10.1,427,11.1,8335,2885,5450,3.9,11.4,9970,2850,7120,3.9,13.6,-1635,-2.2,22.8,0,277,277,1532
2002,46220,3434,3905,70946,71688,469,12.1,422,10.9,9830,4030,5800,5.6,13.7,11313,3034,8279,4.2,15.8,-1483,-2.1,27.4,0,249,249,1397
2003,46220,3446,3929,74239,72274,446,11.4,361,9.3,12243,4536,7707,6.3,16.9,8313,2774,5539,3.8,11.5,3930,5.4,23,0,266,266,1418
2004,46220,3493,3956,74984,74359,431,10.9,379,9.6,10662,3004,7658,4,14.3,9411,2980,6431,4,12.7,1251,1.6,25.4,0,256,256,1370
2005,46220,3509,3991,78245,76181,400,10.1,330,8.3,12408,2755,9653,3.6,16.3,8279,2272,6007,3,10.9,4129,5.4,21.8,0,236,236,1119
2006,46220,3562,4062,79297,78561,463,11.5,336,8.4,12382,4515,7867,5.7,15.8,10909,6036,4873,7.7,13.9,1473,1.9,27.8,0,236,248,1612
2007,46220,3613,4135,78633,78998,436,10.6,388,9.5,10108,3246,6862,4.1,12.8,10837,3093,7744,3.9,13.7,-729,-0.9,25.6,0,282,282,1720
2008,46220,3620,4148,78120,78260,397,9.6,360,8.7,9047,2924,6123,3.7,11.6,9326,2111,7215,2.7,11.9,-279,-0.3,23.2,0,276,276,1228
2009,46220,3497,4012,74843,76192,337,8.3,410,10.1,8034,4160,3874,5.5,10.5,10731,2577,8154,3.4,14.1,-2697,-3.6,21,0,300,301,1557
2010,46220,3464,3985,72890,73622,347,8.7,350,8.8,8516,3759,4757,5.1,11.6,9980,4595,5385,6.2,13.6,-1464,-2,23.2,0,248,248,4043
2011,46220,3404,3913,73100,72859,297,7.6,324,8.2,8266,2498,5768,3.4,11.3,7783,1641,6142,2.3,10.7,483,0.6,21.4,0,219,219,961
2012,46220,3442,3981,74179,73461,362,9.2,289,7.3,8753,2422,6331,3.3,11.9,7316,1863,5453,2.5,10,1437,1.9,20,0,194,196,1007
2013,46220,3446,3987,75690,74879,319,8,317,8,8958,2803,6155,3.7,12,7335,1931,5404,2.6,9.8,1623,2.2,19.6,0,226,226,1289
2014,46220,3469,4001,76329,75895,338,8.5,297,7.5,9168,2903,6265,3.8,12.1,8299,2314,5985,3,10.9,869,1.2,21.8,0,214,214,1038
1977,46340,2623,2814,41264,38728,547,20.2,332,12.2,10351,3715,6636,9.6,26.7,5278,2743,2535,7.1,13.6,5073,13.1,27.2,0,225,228,1704
1978,46340,2483,2680,42995,41857,390,14.2,488,17.8,8650,2974,5676,7.1,20.7,6373,2880,3493,6.9,15.2,2277,5.5,30.4,0,279,279,1518
1979,46340,2746,2962,47190,45318,469,16.6,202,7.2,9321,3187,6134,7,20.6,5576,1382,4194,3,12.3,3745,8.3,24.6,0,3,3,14
1980,46340,2827,3038,47102,47091,448,14.9,354,11.8,7590,3376,4214,7.2,16.1,7567,2382,5185,5.1,16.1,23,0,32.2,0,259,260,1119
1981,46340,2865,3082,48117,47211,502,16.4,434,14.2,8943,3540,5403,7.5,18.9,7130,3302,3828,7,15.1,1813,3.8,30.2,0,270,272,1384
1982,46340,3048,3299,50124,49153,576,18.1,325,10.2,9946,5084,4862,10.3,20.2,8004,3690,4314,7.5,16.3,1942,3.9,32.6,0,177,177,2131
1983,46340,3232,3477,49387,50117,540,15.9,380,11.2,8439,4247,4192,8.5,16.8,9899,3847,6052,7.7,19.8,-1460,-3,33.6,0,266,267,3119
1984,46340,3453,3718,54845,52120,668,18.6,430,12,11926,5479,6447,10.5,22.9,6475,2429,4046,4.7,12.4,5451,10.5,24.8,0,294,294,1478
1985,46340,3596,3879,57213,55957,613,16.1,443,11.7,10537,4030,6507,7.2,18.8,8025,2766,5259,4.9,14.3,2512,4.5,28.6,0,317,317,1788
1986,46340,3650,3947,56001,56571,582,14.9,493,12.6,9350,3849,5501,6.8,16.5,10490,3445,7045,6.1,18.5,-1140,-2,33,0,354,354,2129
1987,46340,3593,3898,52746,54357,510,13,550,14,8149,3328,4821,6.1,15,11370,4314,7056,7.9,20.9,-3221,-5.9,30,0,368,368,2111
1988,46340,3463,3767,50454,51202,475,12.4,560,14.6,8176,3122,5054,6.1,16,9671,4469,5202,8.7,18.9,-1495,-2.9,32,0,380,380,2263
1989,46340,3421,3728,51900,51341,454,12.1,492,13.1,8364,3223,5141,6.3,16.3,7246,2799,4447,5.5,14.1,1118,2.2,28.2,0,323,323,1772
1990,46340,3394,3714,52021,51894,423,11.4,409,11,7736,2521,5215,4.9,14.9,7482,2997,4485,5.8,14.4,254,0.5,28.8,0,299,299,2352
1991,46340,3486,3816,52915,52505,467,12.4,357,9.5,8398,3362,5036,6.4,16,7577,2693,4884,5.1,14.4,821,1.6,28.8,0,226,229,1423
1992,46340,3569,3916,55449,54286,515,13.3,423,10.9,9974,4005,5969,7.4,18.4,7648,2751,4897,5.1,14.1,2326,4.3,28.2,0,279,280,1639
1993,46340,3585,3903,56500,56050,424,10.8,425,10.9,9822,3068,6754,5.5,17.5,8922,3134,5788,5.6,15.9,900,1.6,31.8,0,272,272,1373
1994,46340,3678,4019,58756,57576,510,12.9,381,9.6,9660,3774,5886,6.6,16.8,7299,2512,4787,4.4,12.7,2361,4.1,25.4,0,264,266,1651
1995,46340,3784,4146,61453,60029,556,13.6,418,10.2,10109,4138,5971,6.9,16.8,7260,2249,5011,3.7,12.1,2849,4.7,24.2,0,293,294,1392
1996,46340,3857,4207,63291,62204,530,12.7,456,10.9,11017,4495,6522,7.2,17.7,8843,2880,5963,4.6,14.2,2174,3.5,28.4,0,294,294,1646
1997,46340,3888,4312,65633,64567,562,13.2,477,11.2,12113,5232,6881,8.1,18.8,9980,3420,6560,5.3,15.5,2133,3.3,31,0,311,311,1737
1998,46340,3963,4395,69014,67279,522,12,431,9.9,12139,4375,7764,6.5,18,8668,2909,5759,4.3,12.9,3471,5.1,25.8,0,277,277,1386
1999,46340,3935,4393,71679,71225,493,11.2,484,11,11678,3733,7945,5.2,16.4,10769,4409,6360,6.2,15.1,909,1.3,30.2,0,329,329,2486
2000,46340,3935,4403,74137,72804,460,10.5,455,10.3,12269,4725,7544,6.5,16.9,9602,4340,5262,6,13.2,2667,3.7,26.4,0,295,295,2384
2001,46340,3990,4464,75796,75265,479,10.8,463,10.4,10653,3376,7277,4.5,14.2,9590,3707,5883,4.9,12.7,1063,1.5,25.4,0,278,278,1986
2002,46340,4061,4556,77296,76517,569,12.6,475,10.5,13085,5148,7937,6.7,17.1,11527,3370,8157,4.4,15.1,1558,2,30.2,0,276,278,1449
2003,46340,4141,4630,79725,78187,515,11.3,354,7.7,11461,3895,7566,5,14.7,8385,2066,6319,2.6,10.7,3076,4,21.4,0,266,266,1170
2004,46340,4177,4678,80457,79877,497,10.7,407,8.8,11566,3724,7842,4.7,14.5,10406,2993,7413,3.7,13,1160,1.5,26,0,288,288,1877
2005,46340,4249,4796,80644,80361,559,11.8,407,8.6,11899,4244,7655,5.3,14.8,11333,3426,7907,4.3,14.1,566,0.7,28.2,0,302,302,2334
2006,46340,4273,4851,82941,81708,536,11.1,443,9.2,12116,5014,7102,6.1,14.8,9650,2449,7201,3,11.8,2466,3,23.6,0,322,322,1757
2007,46340,4357,4953,86072,84169,592,12.1,455,9.3,14868,4243,10625,5,17.7,11061,3275,7786,3.9,13.1,3807,4.6,26.2,0,301,302,1613
2008,46340,4376,4984,86897,86325,491,9.9,426,8.6,12422,3244,9178,3.8,14.4,11279,2806,8473,3.3,13.1,1143,1.3,26.2,0,319,320,2122
2009,46340,4363,4956,85307,85838,466,9.4,462,9.3,11768,4454,7314,5.2,13.7,12829,3793,9036,4.4,14.9,-1061,-1.2,27.4,0,312,312,1362
2010,46340,4356,4955,85128,85124,432,8.7,407,8.2,13963,5475,8488,6.4,16.4,13955,4042,9913,4.7,16.4,8,0,32.8,0,309,309,3270
2011,46340,4378,5032,84902,84896,537,10.8,440,8.8,12781,4721,8060,5.6,15.1,12768,4074,8694,4.8,15,13,0.1,30,0,324,324,3141
2012,46340,4435,5111,84560,84766,513,10.1,448,8.8,10469,3387,7082,4,12.4,10881,3125,7756,3.7,12.8,-412,-0.4,24.8,0,300,301,2064
2013,46340,4542,5219,89088,86628,481,9.3,375,7.3,13346,3776,9570,4.4,15.4,8426,2642,5784,3,9.7,4920,5.7,19.4,0,256,256,1601
2014,46340,4560,5248,89250,88823,482,9.2,416,8,11326,4289,7037,4.8,12.8,10472,4127,6345,4.6,11.8,854,1,23.6,0,310,312,2211
1977,46540,4551,5061,78093,77370,621,12.3,626,12.4,12167,5302,6865,6.9,15.7,10720,3590,7130,4.6,13.9,1447,1.8,27.8,0,404,405,2038
1978,46540,4635,5140,82838,80451,608,11.9,531,10.4,12593,2940,9653,3.7,15.7,7818,3395,4423,4.2,9.7,4775,6,19.4,0,363,365,1575
1979,46540,4634,5186,85891,84337,567,11,503,9.7,12347,3467,8880,4.1,14.6,9238,4274,4964,5.1,11,3109,3.6,22,0,357,358,1924
1980,46540,4594,5145,86637,86234,491,9.5,504,9.8,11673,3656,8017,4.2,13.5,10867,3786,7081,4.4,12.6,806,0.9,25.2,0,335,335,1789
1981,46540,4488,5050,83101,83392,541,10.6,582,11.5,11999,5040,6959,6,14.4,12582,4655,7927,5.6,15.1,-583,-0.7,28.8,0,349,350,1940
1982,46540,4422,5032,85683,84258,567,11.2,546,10.8,12930,6522,6408,7.7,15.3,10081,3780,6301,4.5,12,2849,3.3,24,0,312,312,1357
1983,46540,4576,5194,81923,83973,519,10.2,408,8,9724,3603,6121,4.3,11.6,13824,2430,11394,2.9,16.5,-4100,-4.9,23.2,0,266,266,1229
1984,46540,4681,5293,87319,84645,571,10.9,465,8.9,13375,4108,9267,4.9,15.8,8026,2957,5069,3.5,9.5,5349,6.3,19,0,289,289,1329
1985,46540,4766,5403,92058,90740,568,10.6,466,8.7,13227,3700,9527,4.1,14.6,10590,3579,7011,3.9,11.7,2637,2.9,23.4,0,312,312,1664
1986,46540,4833,5472,88577,90279,560,10.3,482,8.9,11853,3751,8102,4.2,13.1,15257,5534,9723,6.1,16.9,-3404,-3.8,26.2,0,291,291,1205
1987,46540,4963,5623,93208,91936,685,12.3,522,9.4,13592,4701,8891,5.1,14.8,11048,4125,6923,4.5,12,2544,2.8,24,0,335,337,1816
1988,46540,4974,5671,92282,90897,646,11.5,554,9.8,14375,5714,8661,6.3,15.8,11604,3630,7974,4,12.8,2771,3,25.6,0,379,379,1455
1989,46540,5046,5771,98262,95258,636,11.1,534,9.3,15246,5431,9815,5.7,16,9237,3437,5800,3.6,9.7,6009,6.3,19.4,0,354,358,1997
1990,46540,5143,5905,99413,99082,597,10.2,445,7.6,13160,4048,9112,4.1,13.3,12497,4165,8332,4.2,12.6,663,0.7,25.2,0,319,319,1555
1991,46540,5210,5994,97790,98650,607,10.2,530,8.9,12551,6594,5957,6.7,12.7,14270,3793,10477,3.8,14.5,-1719,-1.8,25.4,0,322,322,2279
1992,46540,5126,5917,97134,97314,559,9.4,613,10.3,11980,3013,8967,3.1,12.3,12339,3609,8730,3.7,12.7,-359,-0.4,24.6,0,394,400,2156
1993,46540,5024,5803,96887,97118,446,7.6,542,9.3,11948,4040,7908,4.2,12.3,12409,3848,8561,4,12.8,-461,-0.5,24.6,0,349,350,2143
1994,46540,4946,5712,95153,96007,464,8.1,539,9.4,10443,2879,7564,3,10.9,12151,4971,7180,5.2,12.7,-1708,-1.8,21.8,0,354,354,2001
1995,46540,4981,5762,97533,96374,543,9.5,480,8.4,13236,4486,8750,4.7,13.7,10918,2452,8466,2.5,11.3,2318,2.4,22.6,0,318,319,1503
1996,46540,4955,5711,97016,97201,505,8.8,528,9.2,12312,5423,6889,5.6,12.7,12682,4689,7993,4.8,13,-370,-0.3,25.4,0,353,353,1780
1997,46540,4861,5637,96684,96806,513,9,594,10.5,12580,4810,7770,5,13,12824,4438,8386,4.6,13.2,-244,-0.2,26,0,342,342,1865
1998,46540,4773,5534,99116,98101,471,8.4,545,9.8,14598,4721,9877,4.8,14.9,12567,4042,8525,4.1,12.8,2031,2.1,25.6,0,365,365,2332
1999,46540,4732,5538,97213,98203,479,8.7,466,8.4,11383,4806,6577,4.9,11.6,13363,4738,8625,4.8,13.6,-1980,-2,23.2,0,304,304,1725
2000,46540,4727,5531,99362,98292,443,8,465,8.4,13117,4146,8971,4.2,13.3,10977,3717,7260,3.8,11.2,2140,2.1,22.4,0,276,276,1838
2001,46540,4735,5543,99428,100047,444,8,491,8.8,9992,2863,7129,2.9,10,11229,3268,7961,3.3,11.2,-1237,-1.2,20,0,284,284,1425
2002,46540,4690,5512,100274,99913,547,9.9,573,10.4,14499,6389,8110,6.4,14.5,13777,4416,9361,4.4,13.8,722,0.7,27.6,0,283,283,1566
2003,46540,4746,5584,105067,102455,553,10,419,7.6,16202,7145,9057,7,15.8,10977,3281,7696,3.2,10.7,5225,5.1,21.4,0,291,291,2141
2004,46540,4725,5561,103741,104285,495,8.9,473,8.5,12847,4064,8783,3.9,12.3,13934,6351,7583,6.1,13.4,-1087,-1.1,24.6,0,305,305,2241
2005,46540,4713,5549,106152,104540,454,8.2,424,7.7,13319,6239,7080,6,12.7,10095,2344,7751,2.2,9.7,3224,3,19.4,0,283,283,1528
2006,46540,4667,5525,103687,104616,528,9.6,504,9.1,12689,5421,7268,5.2,12.1,14548,5076,9472,4.9,13.9,-1859,-1.8,24.2,0,344,345,2657
2007,46540,4642,5511,101315,102395,472,8.6,470,8.5,12313,3814,8499,3.7,12,14474,3833,10641,3.7,14.1,-2161,-2.1,24,0,280,281,1946
2008,46540,4650,5528,103108,101907,497,9,446,8.1,15248,7748,7500,7.6,15,12847,4770,8077,4.7,12.6,2401,2.4,25.2,0,291,292,2776
2009,46540,4627,5474,102139,102462,399,7.3,417,7.6,9003,2359,6644,2.3,8.8,9649,1843,7806,1.8,9.4,-646,-0.6,17.6,0,266,266,1059
2010,46540,4612,5476,100460,100611,408,7.5,398,7.3,9759,3139,6620,3.1,9.7,10060,2322,7738,2.3,10,-301,-0.3,19.4,0,271,271,1852
2011,46540,4563,5422,99024,99676,406,7.5,443,8.1,8182,2268,5914,2.3,8.2,9485,2002,7483,2,9.5,-1303,-1.3,16.4,0,276,276,1072
2012,46540,4583,5436,99388,99061,441,8.1,414,7.6,9911,2574,7337,2.6,10,9257,2061,7196,2.1,9.3,654,0.7,18.6,0,246,252,1052
2013,46540,4526,5382,100078,99648,366,6.8,411,7.6,9612,2862,6750,2.9,9.6,8751,2292,6459,2.3,8.8,861,0.8,17.6,0,245,245,1339
2014,46540,4539,5391,102673,101259,439,8.2,398,7.4,11670,3161,8509,3.1,11.5,8842,2395,6447,2.4,8.7,2828,2.8,17.4,0,241,242,1689
1977,46660,1573,1715,19136,18796,274,16.1,236,13.9,3997,1709,2288,9.1,21.3,3316,1487,1829,7.9,17.6,681,3.7,35.2,0,163,163,865
1978,46660,1607,1748,22205,20673,250,14.4,219,12.6,5682,1585,4097,7.7,27.5,2617,1131,1486,5.5,12.7,3065,14.8,25.4,0,156,156,723
1979,46660,1630,1779,22063,22127,233,13.2,199,11.3,4335,1466,2869,6.6,19.6,4462,1280,3182,5.8,20.2,-127,-0.6,39.2,0,143,143,663
1980,46660,1626,1791,21794,21917,222,12.4,197,11,3274,1369,1905,6.2,14.9,3519,951,2568,4.3,16.1,-245,-1.2,29.8,0,140,140,645
1981,46660,1582,1743,21841,21573,197,11.2,219,12.4,3784,1244,2540,5.8,17.5,3247,1164,2083,5.4,15.1,537,2.4,30.2,0,135,135,606
1982,46660,1599,1773,20832,21319,252,14.3,200,11.4,3151,1739,1412,8.2,14.8,4124,1096,3028,5.1,19.3,-973,-4.5,29.6,0,124,124,739
1983,46660,1664,1832,21801,21237,257,14.3,217,12,4408,1986,2422,9.4,20.8,3279,1605,1674,7.6,15.4,1129,5.4,30.8,0,141,144,746
1984,46660,1723,1900,24809,23311,268,14.4,199,10.7,5834,2207,3627,9.5,25,2837,1209,1628,5.2,12.2,2997,12.8,24.4,0,138,138,670
1985,46660,1815,1998,25480,25300,281,14.4,190,9.7,4432,1587,2845,6.3,17.5,4072,1508,2564,6,16.1,360,1.4,32.2,0,113,113,507
1986,46660,1867,2065,26590,26001,314,15.5,237,11.7,5195,1848,3347,7.1,20,4017,1552,2465,6,15.4,1178,4.6,30.8,0,165,165,977
1987,46660,1907,2102,28842,27739,292,14,248,11.9,6300,2958,3342,10.7,22.7,4093,1614,2479,5.8,14.8,2207,7.9,29.6,0,170,170,836
1988,46660,1899,2123,28880,28599,281,13.3,244,11.6,5453,2917,2536,10.2,19.1,4891,2245,2646,7.8,17.1,562,2,34.2,0,173,173,1013
1989,46660,1952,2186,32175,31179,272,12.6,218,10.1,7032,2866,4166,9.2,22.6,5040,1729,3311,5.5,16.2,1992,6.4,32.4,0,149,149,686
1990,46660,1955,2195,32397,32244,249,11.4,228,10.4,5657,2014,3643,6.2,17.5,5351,1995,3356,6.2,16.6,306,0.9,33.2,0,155,155,1366
1991,46660,1945,2221,30534,30667,245,11.1,213,9.7,5210,2294,2916,7.5,17,5476,1607,3869,5.2,17.9,-266,-0.9,34,0,147,147,999
1992,46660,1989,2260,30083,30284,287,12.8,230,10.3,4436,1670,2766,5.5,14.6,4837,1853,2984,6.1,16,-401,-1.4,29.2,0,137,138,1089
1993,46660,2035,2310,32197,31145,290,12.7,239,10.5,6302,1991,4311,6.4,20.2,4198,1640,2558,5.3,13.5,2104,6.7,27,0,164,164,995
1994,46660,2021,2308,32584,32396,285,12.3,278,12,5486,1896,3590,5.9,16.9,5110,1908,3202,5.9,15.8,376,1.1,31.6,0,195,195,1084
1995,46660,2029,2314,37500,35712,249,10.8,229,9.9,7530,3775,3755,10.6,21.1,3953,1484,2469,4.2,11.1,3577,10,22.2,0,151,151,621
1996,46660,2070,2347,36931,37211,286,12.3,257,11,5533,2043,3490,5.5,14.9,6092,1605,4487,4.3,16.4,-559,-1.5,29.8,0,151,151,705
1997,46660,2095,2365,35823,36350,299,12.7,281,11.9,5227,2199,3028,6,14.4,6280,2776,3504,7.6,17.3,-1053,-2.9,28.8,0,164,164,1260
1998,46660,2136,2400,37184,36603,308,12.9,274,11.5,6124,2559,3565,7,16.7,4961,2116,2845,5.8,13.6,1163,3.1,27.2,0,160,160,841
1999,46660,2133,2410,39450,38294,262,10.9,258,10.7,6878,2407,4471,6.3,18,4566,1473,3093,3.8,11.9,2312,6.1,23.8,0,155,155,891
2000,46660,2166,2481,39059,39199,308,12.6,234,9.6,5872,2186,3686,5.6,15,6151,2456,3695,6.3,15.7,-279,-0.7,30,0,147,147,687
2001,46660,2181,2496,39066,39196,283,11.3,288,11.6,5876,1922,3954,4.9,15,6136,2389,3747,6.1,15.7,-260,-0.7,30,0,151,151,866
2002,46660,2212,2541,41151,40236,336,13.3,293,11.6,8073,3257,4816,8.1,20.1,6242,2086,4156,5.2,15.5,1831,4.6,31,0,146,146,852
2003,46660,2259,2598,42741,41455,330,13,205,8.1,7565,2577,4988,6.2,18.2,4993,1257,3736,3,12,2572,6.2,24,0,154,154,883
2004,46660,2310,2632,44043,43253,286,11,228,8.7,7500,2084,5416,4.8,17.3,5920,2344,3576,5.4,13.7,1580,3.6,27.4,0,156,156,924
2005,46660,2341,2688,46412,45081,316,11.9,234,8.8,9437,3896,5541,8.6,20.9,6774,2539,4235,5.6,15,2663,5.9,30,0,178,178,2220
2006,46660,2383,2733,46528,46382,304,11.2,244,9,7532,2905,4627,6.3,16.2,7239,2064,5175,4.5,15.6,293,0.6,31.2,0,170,170,1228
2007,46660,2461,2812,45565,45943,322,11.6,240,8.7,6666,2840,3826,6.2,14.5,7422,2878,4544,6.3,16.2,-756,-1.7,29,0,160,161,1287
2008,46660,2447,2821,44612,44782,289,10.3,252,9,6464,2497,3967,5.6,14.4,6804,2861,3943,6.4,15.2,-340,-0.8,28.8,0,173,173,2307
2009,46660,2419,2802,42376,43315,269,9.6,258,9.2,4652,2067,2585,4.8,10.7,6529,1187,5342,2.7,15.1,-1877,-4.4,21.4,0,186,186,869
2010,46660,2367,2765,39901,40921,247,8.9,257,9.3,4909,2110,2799,5.2,12,6948,2137,4811,5.2,17,-2039,-5,24,0,178,178,1645
2011,46660,2381,2790,39791,39785,262,9.5,225,8.1,4390,1558,2832,3.9,11,4377,1178,3199,3,11,13,0,22,0,140,141,834
2012,46660,2349,2752,41094,40412,284,10.2,329,11.9,7081,2718,4363,6.7,17.5,5717,2664,3053,6.6,14.1,1364,3.4,28.2,0,190,191,1573
2013,46660,2330,2725,41153,41089,189,6.9,219,8,4431,1571,2860,3.8,10.8,4303,1323,2980,3.2,10.5,128,0.3,21,0,138,138,685
2014,46660,2307,2773,42400,41698,291,10.6,218,8,4833,1352,3481,3.2,11.6,3428,902,2526,2.2,8.2,1405,3.4,16.4,0,168,170,666
1977,46700,2718,2998,55787,42772,618,21.4,379,13.2,31157,26119,5038,61.1,72.8,5126,2412,2714,5.6,12,26031,60.8,24,0,240,241,1358
1978,46700,2837,3129,38099,46929,592,19.3,457,14.9,9654,3816,5838,8.1,20.6,27313,2606,24707,5.6,58.2,-17659,-37.6,41.2,0,269,269,1213
1979,46700,3049,3367,41075,39364,666,20.5,399,12.3,10407,4364,6043,11.1,26.4,6985,3090,3895,7.8,17.7,3422,8.7,35.4,0,287,288,1714
1980,46700,3165,3484,42501,41600,585,17.1,450,13.1,9535,4927,4608,11.8,22.9,7733,3341,4392,8,18.6,1802,4.3,37.2,0,318,320,1616
1981,46700,3135,3449,41614,41969,579,16.7,584,16.9,8434,4322,4112,10.3,20.1,9144,3783,5361,9,21.8,-710,-1.7,40.2,0,347,348,1846
1982,46700,3232,3618,43147,42317,667,18.9,447,12.6,10006,5457,4549,12.9,23.6,8346,3021,5325,7.1,19.7,1660,3.9,39.4,0,258,258,1662
1983,46700,3289,3680,44576,43841,487,13.4,451,12.4,9275,3405,5870,7.8,21.2,7804,3075,4729,7,17.8,1471,3.4,35.6,0,284,285,1272
1984,46700,3551,3977,49650,47064,668,17.5,370,9.7,11665,5315,6350,11.3,24.8,6492,2286,4206,4.9,13.8,5173,11,27.6,0,237,237,1207
1985,46700,3694,4130,53380,51530,644,15.9,495,12.2,12349,5098,7251,9.9,24,8648,3667,4981,7.1,16.8,3701,7.2,33.6,0,302,303,1595
1986,46700,3960,4389,57205,55250,745,17.5,473,11.1,14147,6134,8013,11.1,25.6,10236,4660,5576,8.4,18.5,3911,7.1,37,0,282,282,1756
1987,46700,4136,4598,61244,60424,783,17.4,550,12.2,13355,5756,7599,9.5,22.1,11714,3893,7821,6.4,19.4,1641,2.7,38.8,0,341,344,2090
1988,46700,4227,4738,68500,65570,730,15.6,556,11.9,16305,6946,9359,10.6,24.9,10445,3686,6759,5.6,15.9,5860,9,31.8,0,395,395,2418
1989,46700,4045,4551,67766,68085,696,15,871,18.8,13850,5269,8581,7.7,20.3,14488,7132,7356,10.5,21.3,-638,-1,40.6,0,349,349,2230
1990,46700,4558,5109,76699,72150,1068,22.1,482,10,19336,9491,9845,13.2,26.8,10238,3898,6340,5.4,14.2,9098,12.6,28.4,0,330,330,2317
1991,46700,4762,5352,76439,76537,830,15.9,582,11.1,14340,6451,7889,8.4,18.7,14536,3528,11008,4.6,19,-196,-0.3,37.4,0,343,344,2045
1992,46700,4815,5435,76529,76475,789,14.6,686,12.7,15406,5667,9739,7.4,20.1,15298,4135,11163,5.4,20,108,0.1,40,0,425,429,2322
1993,46700,4803,5428,77166,76739,695,12.8,664,12.2,14892,7082,7810,9.2,19.4,14037,5521,8516,7.2,18.3,855,1.1,36.6,0,433,436,2809
1994,46700,4827,5453,78206,77645,700,12.9,651,12,14922,6621,8301,8.5,19.2,13799,4327,9472,5.6,17.8,1123,1.4,35.6,0,416,417,2063
1995,46700,4785,5417,77448,77799,648,11.9,658,12.1,13324,6209,7115,8,17.1,14025,5160,8865,6.6,18,-701,-0.9,34.2,0,423,429,2363
1996,46700,4842,5456,77090,77178,703,12.9,636,11.7,13637,5950,7687,7.7,17.7,13813,5554,8259,7.2,17.9,-176,-0.2,35.4,0,383,383,2771
1997,46700,4933,5552,80715,79129,732,13.3,648,11.8,16972,6522,10450,8.2,21.4,13799,6061,7738,7.7,17.4,3173,4,34.8,0,369,369,2611
1998,46700,4909,5566,84329,82441,681,12.2,641,11.5,16486,7140,9346,8.7,20,12709,5113,7596,6.2,15.4,3777,4.6,30.8,0,419,419,2382
1999,46700,4991,5680,88471,86211,710,12.6,592,10.5,17480,7186,10294,8.3,20.3,12959,5483,7476,6.4,15,4521,5.3,30,0,366,366,2205
2000,46700,5055,5756,93123,90870,679,11.9,624,10.9,17592,6474,11118,7.1,19.4,13087,5860,7227,6.4,14.4,4505,5,28.8,0,388,388,3064
2001,46700,5162,5907,102371,97913,741,12.7,652,11.2,20617,7044,13573,7.2,21.1,11702,4607,7095,4.7,12,8915,9.1,24,0,401,401,2098
2002,46700,5221,6046,105057,103676,850,14.2,706,11.8,20612,8956,11656,8.6,19.9,17849,5664,12185,5.5,17.2,2763,2.7,34.4,0,413,413,2750
2003,46700,5297,6185,104904,104222,821,13.5,580,9.5,20098,9308,10790,8.9,19.3,18734,7528,11206,7.2,18,1364,1.3,36,0,385,389,5079
2004,46700,5388,6286,106224,104920,810,13,638,10.3,17025,6541,10484,6.2,16.2,14417,4702,9715,4.5,13.7,2608,2.5,27.4,0,432,433,2784
2005,46700,5473,6402,106643,106225,826,13,635,10,15676,5009,10667,4.7,14.8,14839,4854,9985,4.6,14,837,0.8,28,0,452,452,2793
2006,46700,5461,6435,111952,108942,826,12.9,731,11.4,19442,8286,11156,7.6,17.8,13421,4322,9099,4,12.3,6021,5.5,24.6,0,496,498,2804
2007,46700,5520,6528,114075,112836,826,12.8,741,11.4,19998,8633,11365,7.7,17.7,17520,5032,12488,4.5,15.5,2478,2.2,31,0,477,477,2393
2008,46700,5384,6372,111297,112298,674,10.5,736,11.5,17991,9312,8679,8.3,16,19992,8286,11706,7.4,17.8,-2001,-1.8,32,0,511,512,4785
2009,46700,5192,6165,100397,104222,569,9.1,675,10.8,12462,4875,7587,4.7,12,20111,5158,14953,4.9,19.3,-7649,-7.3,24,0,461,461,2941
2010,46700,5098,6070,97794,98838,556,9.1,593,9.7,11731,3907,7824,4,11.9,13819,4915,8904,5,14,-2088,-2.1,23.8,0,388,388,2482
2011,46700,5073,6042,97920,97681,576,9.5,540,8.9,11734,4371,7363,4.5,12,11255,2939,8316,3,11.5,479,0.5,23,0,350,350,1686
2012,46700,5057,6039,99658,98696,568,9.4,577,9.6,13776,4008,9768,4.1,14,11852,4073,7779,4.1,12,1924,2,24,0,352,353,1988
2013,46700,5055,6019,105025,102262,527,8.8,553,9.2,16053,4900,11153,4.8,15.7,10526,3142,7384,3.1,10.3,5527,5.4,20.6,0,341,341,1546
2014,46700,5118,6124,105801,105035,655,10.8,503,8.3,12644,4543,8101,4.3,12,11111,3217,7894,3.1,10.6,1533,1.4,21.2,0,335,339,1605
1977,47020,1713,1844,22930,22156,327,18.3,210,11.7,4460,1789,2671,8.1,20.1,2912,1274,1638,5.8,13.1,1548,7,26.2,0,154,155,931
1978,47020,1682,1815,25546,24195,287,15.7,297,16.2,5758,2179,3579,9,23.8,3056,1763,1293,7.3,12.6,2702,11.2,25.2,0,170,170,919
1979,47020,1844,1987,27725,26676,299,15.7,146,7.7,5259,1844,3415,6.9,19.7,3160,789,2371,3,11.8,2099,7.9,23.6,1,3,4,
1980,47020,1386,1538,28017,27181,72,4.1,316,17.9,5990,834,5156,3.1,22,4318,2212,2106,8.1,15.9,1672,6.1,31.8,0,243,245,1400
1981,47020,1892,2055,29829,29618,423,23.6,169,9.4,6429,3893,2536,13.1,21.7,6006,1063,4943,3.6,20.3,423,1.4,40.6,0,83,83,348
1982,47020,2082,2278,33108,31485,440,20.3,211,9.7,8004,3755,4249,11.9,25.4,4757,1779,2978,5.7,15.1,3247,10.3,30.2,0,126,126,975
1983,47020,2124,2326,29725,31314,320,13.9,288,12.5,4284,2046,2238,6.5,13.7,7462,2008,5454,6.4,23.8,-3178,-10.1,27.4,0,200,200,1212
1984,47020,2186,2393,29557,29709,382,16.2,313,13.3,5342,2728,2614,9.2,18,5645,2602,3043,8.8,19,-303,-1,36,0,206,206,1046
1985,47020,2218,2429,32768,31764,333,13.8,290,12,5944,2265,3679,7.1,18.7,3935,1684,2251,5.3,12.4,2009,6.3,24.8,0,199,200,1020
1986,47020,2226,2437,31108,31869,321,13.2,296,12.2,4373,1964,2409,6.2,13.7,5895,2066,3829,6.5,18.5,-1522,-4.8,27.4,0,217,218,1333
1987,47020,2170,2375,27819,29089,285,11.8,334,13.9,3718,1817,1901,6.2,12.8,6257,2500,3757,8.6,21.5,-2539,-8.7,25.6,0,225,225,1297
1988,47020,2110,2317,27193,27314,251,10.7,294,12.5,3834,1659,2175,6.1,14,4076,1804,2272,6.6,14.9,-242,-0.9,28,0,192,192,914
1989,47020,2072,2290,28276,27708,235,10.2,260,11.3,4597,1876,2721,6.8,16.6,3460,1490,1970,5.4,12.5,1137,4.1,25,0,170,170,853
1990,47020,2096,2322,29393,28840,239,10.4,202,8.8,4438,1501,2937,5.2,15.4,3332,1335,1997,4.6,11.6,1106,3.8,23.2,0,158,158,844
1991,47020,2102,2323,29604,29558,225,9.7,226,9.7,4403,1712,2691,5.8,14.9,4310,1344,2966,4.5,14.6,93,0.3,29.2,0,145,145,874
1992,47020,2105,2340,30223,29894,247,10.6,222,9.5,4532,1642,2890,5.5,15.2,3873,1500,2373,5,13,659,2.2,26,0,147,148,880
1993,47020,2144,2367,32125,31170,253,10.7,229,9.7,5610,1639,3971,5.3,18,3699,1525,2174,4.9,11.9,1911,6.1,23.8,0,146,146,868
1994,47020,2182,2421,33778,32841,259,10.8,198,8.3,6325,3180,3145,9.7,19.3,4450,1359,3091,4.1,13.6,1875,5.7,27.2,0,128,128,595
1995,47020,2161,2411,33351,33500,239,9.9,234,9.7,4486,1566,2920,4.7,13.4,4783,1966,2817,5.9,14.3,-297,-0.9,26.8,0,167,169,1304
1996,47020,2185,2419,33733,33520,254,10.5,232,9.6,4693,1899,2794,5.7,14,4267,1282,2985,3.8,12.7,426,1.3,25.4,0,138,138,645
1997,47020,2232,2464,34199,34106,279,11.4,242,9.9,5180,2398,2782,7,15.2,4994,1890,3104,5.5,14.6,186,0.6,29.2,0,159,159,1188
1998,47020,2252,2487,36513,35309,274,11.1,242,9.8,5884,2021,3863,5.7,16.7,3476,1182,2294,3.3,9.8,2408,6.9,19.6,0,152,152,680
1999,47020,2246,2494,37160,37498,257,10.3,252,10.1,4889,2010,2879,5.4,13,5567,2381,3186,6.3,14.8,-678,-1.8,26,0,179,179,926
2000,47020,2210,2480,38031,37633,229,9.2,244,9.8,5266,1714,3552,4.6,14,4471,1629,2842,4.3,11.9,795,2.1,23.8,0,149,149,705
2001,47020,2217,2477,38492,38454,241,9.7,269,10.8,5539,2067,3472,5.4,14.4,5462,2900,2562,7.5,14.2,77,0.2,28.4,0,153,153,1553
2002,47020,2236,2520,36460,37420,296,11.8,254,10.2,5071,2280,2791,6.1,13.6,6991,2167,4824,5.8,18.7,-1920,-5.1,27.2,0,131,131,663
2003,47020,2243,2524,37011,36503,266,10.6,219,8.7,5747,2071,3676,5.7,15.7,4730,1870,2860,5.1,13,1017,2.7,26,0,138,138,906
2004,47020,2249,2529,35669,36298,245,9.7,212,8.4,4409,1713,2696,4.7,12.1,5667,1322,4345,3.6,15.6,-1258,-3.5,24.2,0,134,134,744
2005,47020,2236,2516,37312,36335,229,9.1,213,8.5,5885,2003,3882,5.5,16.2,3931,1394,2537,3.8,10.8,1954,5.4,21.6,0,153,153,990
2006,47020,2252,2546,38484,37739,237,9.4,186,7.4,5776,2832,2944,7.5,15.3,4286,1648,2638,4.4,11.4,1490,3.9,22.8,0,121,121,766
2007,47020,2315,2623,40459,39403,287,11.1,200,7.8,6368,2886,3482,7.3,16.2,4255,1079,3176,2.7,10.8,2113,5.4,21.6,0,133,136,668
2008,47020,2314,2622,41094,40583,219,8.4,191,7.3,6047,2141,3906,5.3,14.9,5025,2055,2970,5.1,12.4,1022,2.5,24.8,0,130,130,599
2009,47020,2271,2590,40906,40970,176,6.8,200,7.7,5480,1924,3556,4.7,13.4,5608,1679,3929,4.1,13.7,-128,-0.3,26.8,0,147,147,1227
2010,47020,2251,2580,39787,40324,160,6.2,163,6.3,4081,1843,2238,4.6,10.1,5155,1265,3890,3.1,12.8,-1074,-2.7,20.2,0,110,110,941
2011,47020,2254,2581,39452,39549,213,8.3,185,7.2,4559,1502,3057,3.8,11.5,4753,1042,3711,2.6,12,-194,-0.5,23,0,130,130,546
2012,47020,2302,2622,39849,39582,242,9.3,199,7.7,5902,1760,4142,4.4,14.9,5368,2082,3286,5.3,13.6,534,1.3,27.2,0,118,118,623
2013,47020,2358,2692,42883,41288,253,9.5,189,7.1,7028,2503,4525,6.1,17,3838,1182,2656,2.9,9.3,3190,7.7,18.6,0,127,127,799
2014,47020,2376,2715,43436,42893,234,8.7,186,6.9,5994,2455,3539,5.7,14,4908,1549,3359,3.6,11.4,1086,2.6,22.8,0,128,128,1006
1977,47220,2340,2523,42240,41634,326,13,284,11.3,6899,2463,4436,5.9,16.6,5687,1661,4026,4,13.7,1212,2.9,27.4,0,179,179,1012
1978,47220,2364,2550,44397,43258,313,12.3,282,11.1,7734,1916,5818,4.4,17.9,5456,2023,3433,4.7,12.6,2278,5.3,25.2,0,195,196,1058
1979,47220,2400,2584,44600,44490,293,11.4,248,9.7,6611,1567,5044,3.5,14.9,6390,1367,5023,3.1,14.4,221,0.5,28.8,0,172,172,614
1980,47220,2418,2586,44940,44732,257,9.9,251,9.7,6153,2229,3924,5,13.8,5736,1646,4090,3.7,12.8,417,1,25.6,0,165,165,867
1981,47220,2286,2439,42644,43327,206,8.2,318,12.7,5260,1078,4182,2.5,12.1,6626,3216,3410,7.4,15.3,-1366,-3.2,24.2,0,186,186,1138
1982,47220,2306,2484,41144,41861,280,11.4,217,8.8,5023,1529,3494,3.7,12,6457,1445,5012,3.5,15.4,-1434,-3.4,24,0,121,121,530
1983,47220,2330,2515,42475,41803,238,9.5,227,9.1,7066,2153,4913,5.2,16.9,5721,1988,3733,4.8,13.7,1345,3.2,27.4,0,155,155,1152
1984,47220,2393,2574,44372,43416,283,11.1,226,8.9,8176,1834,6342,4.2,18.8,6264,2849,3415,6.6,14.4,1912,4.4,28.8,0,138,138,878
1985,47220,2434,2613,42847,44010,275,10.6,251,9.7,6116,1820,4296,4.1,13.9,8441,2917,5524,6.6,19.2,-2325,-5.3,27.8,0,147,147,835
1986,47220,2489,2667,44893,43849,313,11.9,240,9.1,8218,2248,5970,5.1,18.7,6130,2284,3846,5.2,14,2088,4.7,28,0,167,167,838
1987,47220,2567,2764,50675,48901,346,12.7,243,8.9,8142,3182,4960,6.5,16.6,4593,1913,2680,3.9,9.4,3549,7.2,18.8,0,165,166,792
1988,47220,2552,2763,50477,50192,310,11.3,296,10.7,8181,2907,5274,5.8,16.3,7610,2991,4619,6,15.2,571,1.1,30.4,0,189,189,1059
1989,47220,2552,2757,50698,50623,293,10.6,302,10.9,7102,2056,5046,4.1,14,6952,2851,4101,5.6,13.7,150,0.3,27.4,0,211,212,2027
1990,47220,2525,2749,48809,49733,271,9.8,264,9.6,5921,1479,4442,3,11.9,7769,2833,4936,5.7,15.6,-1848,-3.7,23.8,0,187,188,1093
1991,47220,2508,2754,45970,47207,310,11.3,293,10.7,6208,3532,2676,7.5,13.2,8682,2257,6425,4.8,18.4,-2474,-5.2,26.4,0,201,201,1611
1992,47220,2465,2717,43973,44944,263,9.6,278,10.2,6367,2015,4352,4.5,14.2,8308,1893,6415,4.2,18.5,-1941,-4.3,28.4,0,191,192,973
1993,47220,2478,2723,44637,44230,231,8.5,207,7.6,5367,1455,3912,3.3,12.1,4552,1437,3115,3.2,10.3,815,1.8,20.6,0,145,146,670
1994,47220,2472,2698,44993,44862,218,8,244,9,4905,1042,3863,2.3,10.9,4642,1266,3376,2.8,10.3,263,0.6,20.6,0,158,158,579
1995,47220,2529,2757,45993,45502,287,10.5,236,8.7,6637,2687,3950,5.9,14.6,5655,1855,3800,4.1,12.4,982,2.2,24.8,0,168,177,1219
1996,47220,2542,2759,44170,45135,267,9.7,255,9.2,5221,1707,3514,3.8,11.6,7151,2828,4323,6.3,15.8,-1930,-4.2,23.2,0,170,170,727
1997,47220,2562,2769,45032,44626,270,9.8,261,9.4,6449,2244,4205,5,14.5,5636,2021,3615,4.5,12.6,813,1.9,25.2,0,167,167,773
1998,47220,2550,2768,44567,44816,280,10.1,272,9.8,6051,2319,3732,5.2,13.5,6548,1777,4771,4,14.6,-497,-1.1,27,0,184,184,914
1999,47220,2539,2763,45750,45136,269,9.7,266,9.6,6916,2532,4384,5.6,15.3,5687,2402,3285,5.3,12.6,1229,2.7,25.2,0,179,179,1474
2000,47220,2499,2722,45682,45653,245,8.9,280,10.2,7161,2016,5145,4.4,15.7,7103,4042,3061,8.9,15.6,58,0.1,31.2,0,175,175,2191
2001,47220,2484,2728,44154,45011,256,9.4,273,10,5690,2846,2844,6.3,12.6,7403,1879,5524,4.2,16.4,-1713,-3.8,25.2,0,174,174,1016
2002,47220,2478,2766,47753,46126,306,11.1,301,10.9,9491,3024,6467,6.6,20.6,6237,2027,4210,4.4,13.5,3254,7.1,27,0,162,162,944
2003,47220,2524,2801,46536,46161,304,11,229,8.3,6951,2547,4404,5.5,15.1,6200,2280,3920,4.9,13.4,751,1.7,26.8,0,152,152,682
2004,47220,2549,2831,48064,47262,285,10.1,235,8.4,6994,1746,5248,3.7,14.8,5389,1427,3962,3,11.4,1605,3.4,22.8,0,160,160,994
2005,47220,2602,2888,48367,48015,321,11.2,253,8.9,6329,1996,4333,4.2,13.2,5625,1456,4169,3,11.7,704,1.5,23.4,0,194,194,870
2006,47220,2566,2861,48998,48267,272,9.5,273,9.5,6293,2427,3866,5,13,4831,1457,3374,3,10,1462,3,20,0,196,196,1078
2007,47220,2590,2885,48694,48723,291,10.1,252,8.8,7238,2384,4854,4.9,14.9,7295,1871,5424,3.8,15,-57,-0.1,29.8,0,180,180,1188
2008,47220,2564,2864,48921,48628,265,9.2,269,9.4,6447,2135,4312,4.4,13.3,5861,1438,4423,3,12.1,586,1.2,24.2,0,196,197,1152
2009,47220,2458,2757,46429,47421,204,7.3,282,10.1,4787,2012,2775,4.2,10.1,6770,1419,5351,3,14.3,-1983,-4.2,20.2,0,212,213,1050
2010,47220,2424,2729,45186,45685,211,7.7,223,8.2,4504,1308,3196,2.9,9.9,5502,1296,4206,2.8,12,-998,-2.1,19.8,0,160,160,938
2011,47220,2378,2691,45263,45070,208,7.7,229,8.5,4813,1104,3709,2.4,10.7,4426,1154,3272,2.6,9.8,387,0.9,19.6,0,150,150,841
2012,47220,2355,2682,45302,45269,218,8.1,236,8.8,5725,1852,3873,4.1,12.6,5659,2355,3304,5.2,12.5,66,0.1,25,0,145,147,752
2013,47220,2320,2656,44955,45128,213,8,246,9.2,5143,1492,3651,3.3,11.4,5489,1844,3645,4.1,12.2,-346,-0.8,22.8,0,177,177,1412
2014,47220,2300,2614,44331,44516,195,7.4,215,8.2,5633,1111,4522,2.5,12.7,6003,2804,3199,6.3,13.5,-370,-0.8,25.4,0,140,140,692
1977,47260,15144,18407,284323,276746,3020,16.7,2392,13.2,58997,24485,34512,8.8,21.3,43842,17719,26123,6.4,15.8,15155,5.5,31.6,0,1519,1521,10128
1978,47260,15901,19290,300419,292111,2918,15.5,2033,10.8,58534,18530,40004,6.3,20,41917,16119,25798,5.5,14.3,16617,5.7,28.6,0,1362,1372,8991
1979,47260,16081,19627,310772,305373,2674,13.7,2234,11.5,57508,19669,37839,6.4,18.8,46709,14912,31797,4.9,15.3,10799,3.5,30.6,0,1560,1566,8019
1980,47260,16209,19822,318145,314374,2532,12.8,2272,11.5,54954,18675,36279,5.9,17.5,47412,13760,33652,4.4,15.1,7542,2.4,30.2,0,1568,1572,7685
1981,47260,15940,19539,320180,317683,2512,12.8,2666,13.6,55802,21844,33958,6.9,17.6,50807,20888,29919,6.6,16,4995,1.6,32,0,1614,1630,8641
1982,47260,16189,20227,323187,321471,3013,15.1,2138,10.7,57481,25244,32237,7.9,17.9,54049,18016,36033,5.6,16.8,3432,1.1,33.6,0,1186,1187,7716
1983,47260,16998,21050,334685,329103,2688,13,2015,9.8,59329,20617,38712,6.3,18,48164,14061,34103,4.3,14.6,11165,3.4,29.2,0,1316,1326,7270
1984,47260,16656,20820,357096,344988,2922,14,3016,14.4,70712,23404,47308,6.8,20.5,46495,23184,23311,6.7,13.5,24217,7,27,0,1570,1573,10420
1985,47260,18670,23057,388259,374887,3410,15.5,1373,6.3,71969,30344,41625,8.1,19.2,45224,14403,30821,3.8,12.1,26745,7.1,24.2,0,81,89,1446
1986,47260,19713,24303,427067,407382,3768,15.9,2467,10.4,91955,33577,58378,8.2,22.6,52585,19801,32784,4.9,12.9,39370,9.7,25.8,0,1596,1599,9815
1987,47260,20561,25736,432190,430789,4418,17.6,2884,11.5,85371,35943,49428,8.3,19.8,82568,35359,47209,8.2,19.2,2803,0.6,38.4,0,1816,1832,11462
1988,47260,20921,26369,443849,435807,3776,14.5,3045,11.7,85534,35471,50063,8.1,19.6,69452,28395,41057,6.5,15.9,16082,3.7,31.8,0,1963,1963,12704
1989,47260,21182,26919,459275,452173,3562,13.4,3059,11.5,83186,33624,49562,7.4,18.4,68983,23803,45180,5.3,15.3,14203,3.1,30.6,0,1996,2008,12343
1990,47260,21540,27468,474529,466806,3620,13.3,2956,10.9,86260,31729,54531,6.8,18.5,70814,25559,45255,5.5,15.2,15446,3.3,30.4,0,1975,1985,12054
1991,47260,21538,27656,452412,463233,3442,12.5,3249,11.8,67216,28783,38433,6.2,14.5,88858,26909,61949,5.8,19.2,-21642,-4.7,29,0,1983,2004,14302
1992,47260,21663,27829,455944,453666,3478,12.5,3194,11.5,81242,30754,50488,6.8,17.9,76685,28603,48082,6.3,16.9,4557,1,33.8,0,1838,1921,15731
1993,47260,22140,28246,471022,463569,3269,11.7,2832,10.1,84001,28403,55598,6.1,18.1,69095,22158,46937,4.8,14.9,14906,3.2,29.8,0,1804,1816,11614
1994,47260,22468,28530,480389,476451,3155,11.1,2821,9.9,78390,29405,48985,6.2,16.5,70513,23862,46651,5,14.8,7877,1.7,29.6,0,1717,1724,11098
1995,47260,22966,29113,493264,485916,3412,11.8,2738,9.5,78758,27776,50982,5.7,16.2,64061,22171,41890,4.6,13.2,14697,3,26.4,0,1769,1782,10722
1996,47260,23245,29439,502149,497349,3424,11.7,3059,10.5,81962,31310,50652,6.3,16.5,72361,24869,47492,5,14.5,9601,2,29,0,1975,1975,10931
1997,47260,23547,29908,521769,512103,3700,12.4,3269,11,97002,37285,59717,7.3,18.9,77670,25831,51839,5,15.2,19332,3.7,30.4,0,1898,1898,10780
1998,47260,23793,30394,538467,530343,3592,11.9,3035,10.1,90030,31753,58277,6,17,73781,25153,48628,4.7,13.9,16249,3.1,27.8,0,1918,1918,12746
1999,47260,23932,30660,557883,553045,3521,11.5,3204,10.5,90659,34424,56235,6.2,16.4,80984,29808,51176,5.4,14.6,9675,1.8,29.2,0,1935,1935,12063
2000,47260,23922,30679,573636,561687,3274,10.7,3254,10.6,98124,33685,64439,6,17.5,74226,27437,46789,4.9,13.2,23898,4.3,26.4,0,1880,1880,10751
2001,47260,24134,31030,569714,573542,3399,11,3310,10.7,85164,33644,51520,5.9,14.8,92820,26605,66215,4.6,16.2,-7656,-1.4,29.6,0,1837,1838,11478
2002,47260,24537,31610,578978,574863,4009,12.8,3395,10.8,101372,40584,60788,7.1,17.6,93142,34544,58598,6,16.2,8230,1.4,32.4,0,1690,1694,11260
2003,47260,25014,32229,584940,578563,3858,12.2,2683,8.5,87824,30175,57649,5.2,15.2,75070,21092,53978,3.6,13,12754,2.2,26,0,1762,1795,12137
2004,47260,25806,33096,616180,598495,3862,11.9,2652,8.1,101765,35676,66089,6,17,66394,22164,44230,3.7,11.1,35371,5.9,22.2,0,1702,1709,11294
2005,47260,26493,34041,613764,613453,4040,12.1,2790,8.3,86943,34640,52303,5.6,14.2,86321,23516,62805,3.8,14.1,622,0.1,28.2,0,1908,1915,12663
2006,47260,27049,35051,637383,623412,4393,12.8,3033,8.8,101248,39239,62009,6.3,16.2,73305,22541,50764,3.6,11.8,27943,4.4,23.6,0,2050,2053,14416
2007,47260,27436,35787,635040,635430,4265,12.1,3509,9.9,100941,37883,63058,6,15.9,101721,29751,71970,4.7,16,-780,-0.1,31.8,0,2076,2092,12523
2008,47260,27144,35573,631622,631439,3579,10.1,3430,9.7,91213,31363,59850,5,14.4,90847,26256,64591,4.2,14.4,366,0,28.8,0,2355,2369,12768
2009,47260,26090,34662,597422,611474,3119,8.9,3730,10.7,67466,26015,41451,4.3,11,95570,26433,69137,4.3,15.6,-28104,-4.6,22,0,2540,2544,14586
2010,47260,25642,34201,586626,590066,2934,8.6,3149,9.2,69754,24433,45321,4.1,11.8,76633,20538,56095,3.5,13,-6879,-1.2,23.6,0,1942,1960,11685
2011,47260,25173,33790,587252,584863,3048,9,3141,9.3,73506,23834,49672,4.1,12.6,68728,20287,48441,3.5,11.8,4778,0.8,23.6,0,2003,2010,11481
2012,47260,25230,33817,596382,590671,3245,9.6,3145,9.3,86549,28337,58212,4.8,14.7,75126,22389,52737,3.8,12.7,11423,2,25.4,0,1791,1810,9877
2013,47260,25333,33919,600939,597179,2958,8.8,2798,8.3,70996,21873,49123,3.7,11.9,63475,17753,45722,3,10.6,7521,1.3,21.2,0,1701,1708,10073
2014,47260,25187,33794,599145,597703,3030,9,2828,8.4,70620,23998,46622,4,11.8,67736,24497,43239,4.1,11.3,2884,0.5,22.6,0,1897,1904,10414
1977,47300,3580,3929,41856,40859,753,19.7,534,13.9,9376,5062,4314,12.4,22.9,7382,3253,4129,8,18.1,1994,4.8,36.2,0,362,363,2016
1978,47300,3727,4087,45886,43885,703,17.5,549,13.7,10236,3763,6473,8.6,23.3,6233,2940,3293,6.7,14.2,4003,9.1,28.4,0,339,340,1518
1979,47300,3926,4304,51445,48612,797,19,551,13.1,13583,5106,8477,10.5,27.9,7917,3161,4756,6.5,16.3,5666,11.6,32.6,0,406,409,2099
1980,47300,4023,4405,53326,52354,679,15.6,554,12.7,10844,4335,6509,8.3,20.7,8899,3204,5695,6.1,17,1945,3.7,34,0,402,402,2256
1981,47300,3942,4314,52995,52759,631,14.5,662,15.2,10146,3909,6237,7.4,19.2,9673,3647,6026,6.9,18.3,473,0.9,36.6,0,413,413,2113
1982,47300,3921,4343,54216,53561,700,16.2,564,13,11290,6383,4907,11.9,21.1,9979,3254,6725,6.1,18.6,1311,2.5,37.2,0,328,328,1820
1983,47300,4020,4438,51333,52521,528,12,485,11.1,8615,3294,5321,6.3,16.4,10990,2701,8289,5.1,20.9,-2375,-4.5,32.8,0,324,327,1653
1984,47300,4146,4572,56120,53774,659,14.7,508,11.3,12793,3945,8848,7.3,23.8,8100,3265,4835,6.1,15.1,4693,8.7,30.2,0,336,336,1770
1985,47300,4358,4765,55488,55995,680,14.5,512,10.9,11190,4208,6982,7.5,20,12204,4378,7826,7.8,21.8,-1014,-1.8,40,0,309,310,1599
1986,47300,4388,4798,56604,55845,668,14,606,12.7,12461,4683,7778,8.4,22.3,10942,4018,6924,7.2,19.6,1519,2.7,39.2,0,393,395,1915
1987,47300,4454,4896,63069,60037,708,14.6,583,12,16319,6091,10228,10.1,27.2,10255,3600,6655,6,17.1,6064,10.1,34.2,0,365,366,1705
1988,47300,4366,4827,61168,61585,582,12,560,11.6,11423,3922,7501,6.4,18.5,12256,4089,8167,6.6,19.9,-833,-1.4,37,0,378,378,1829
1989,47300,4140,4604,59587,60501,621,13.2,842,17.9,9926,3557,6369,5.9,16.4,11754,6167,5587,10.2,19.4,-1828,-3,32.8,0,336,336,2015
1990,47300,4594,5076,67064,63230,948,19.6,447,9.2,16295,8363,7932,13.2,25.8,8626,2841,5785,4.5,13.6,7669,12.2,27.2,0,308,308,1647
1991,47300,4741,5231,66224,66564,667,13,504,9.8,13716,5167,8549,7.8,20.6,14395,3738,10657,5.6,21.6,-679,-1,41.2,0,316,319,1851
1992,47300,4770,5290,68000,66990,678,12.9,590,11.2,14102,4236,9866,6.3,21.1,12082,3728,8354,5.6,18,2020,3.1,36,0,382,382,2212
1993,47300,4623,5150,66673,67434,508,9.7,600,11.5,11606,3699,7907,5.5,17.2,13127,5357,7770,7.9,19.5,-1521,-2.3,34.4,0,401,404,2154
1994,47300,4621,5169,70101,68439,591,11.5,545,10.6,13455,5578,7877,8.2,19.7,10131,3417,6714,5,14.8,3324,4.9,29.6,0,369,370,1900
1995,47300,4615,5162,73238,72981,568,11,545,10.6,10901,3446,7455,4.7,14.9,10386,3632,6754,5,14.2,515,0.7,28.4,0,378,380,1916
1996,47300,4658,5229,72084,72856,588,11.3,504,9.7,11687,4465,7222,6.1,16,13231,4572,8659,6.3,18.2,-1544,-2.2,32,0,329,329,1644
1997,47300,4673,5181,72464,72228,611,11.7,642,12.3,12363,4686,7677,6.5,17.1,11891,4329,7562,6,16.5,472,0.6,33,0,383,383,2066
1998,47300,4672,5188,70573,69897,552,10.7,538,10.4,10963,4041,6922,5.8,15.7,9610,3666,5944,5.2,13.7,1353,2,27.4,0,341,341,1698
1999,47300,4683,5225,71883,71754,539,10.4,510,9.8,10890,3802,7088,5.3,15.2,10631,3618,7013,5,14.8,259,0.4,29.6,0,347,347,2087
2000,47300,4744,5291,76011,73781,567,10.8,499,9.5,12572,3887,8685,5.3,17,8111,2887,5224,3.9,11,4461,6,22,0,310,310,1607
2001,47300,4830,5407,79375,78270,557,10.4,526,9.8,12962,5336,7626,6.8,16.6,10751,4435,6316,5.7,13.7,2211,2.9,27.4,0,325,325,2313
2002,47300,4853,5459,82471,80705,643,11.9,576,10.6,15200,6112,9088,7.6,18.8,11667,3891,7776,4.8,14.5,3533,4.3,29,0,323,325,1789
2003,47300,4845,5460,87358,85178,573,10.5,471,8.7,15002,4601,10401,5.4,17.6,10641,3559,7082,4.2,12.5,4361,5.1,25,0,324,328,2241
2004,47300,4818,5443,87162,86067,577,10.6,524,9.6,13926,4546,9380,5.3,16.2,11736,4544,7192,5.3,13.6,2190,2.6,27.2,0,343,343,2854
2005,47300,4900,5534,86735,86114,645,11.8,498,9.1,13466,5013,8453,5.8,15.6,12224,4124,8100,4.8,14.2,1242,1.4,28.4,0,350,350,2326
2006,47300,4998,5676,94847,90640,723,12.9,550,9.8,19447,5911,13536,6.5,21.5,11033,3775,7258,4.2,12.2,8414,9.3,24.4,0,387,387,2095
2007,47300,5117,5833,93929,94264,706,12.3,549,9.5,16859,5923,10936,6.3,17.9,17529,3525,14004,3.7,18.6,-670,-0.7,35.8,0,352,358,2164
2008,47300,5109,5848,93675,93524,598,10.3,542,9.3,13892,5103,8789,5.5,14.9,13590,3627,9963,3.9,14.5,302,0.4,29,0,378,378,2111
2009,47300,4968,5713,88369,90555,524,9.1,585,10.2,9328,3482,5846,3.8,10.3,13699,2950,10749,3.3,15.1,-4371,-4.8,20.6,0,426,426,1930
2010,47300,4776,5568,84955,85757,453,8.1,562,10,10359,4911,5448,5.7,12.1,11963,3941,8022,4.6,13.9,-1604,-1.8,24.2,0,398,398,2457
2011,47300,4736,5550,83677,84135,481,8.7,470,8.5,9388,2909,6479,3.5,11.2,10303,3092,7211,3.7,12.2,-915,-1,22.4,0,308,308,1700
2012,47300,4775,5578,87098,85375,505,9.1,492,8.8,12097,3285,8812,3.8,14.2,8651,2955,5696,3.5,10.1,3446,4.1,20.2,0,287,288,1513
2013,47300,4784,5595,89586,88445,460,8.3,438,7.9,10430,2955,7475,3.3,11.8,8147,2805,5342,3.2,9.2,2283,2.6,18.4,0,302,302,2049
2014,47300,4747,5566,90416,89641,529,9.5,505,9.1,10499,3627,6872,4,11.7,8949,3107,5842,3.5,10,1550,1.7,20,0,348,352,1977
1977,47380,3028,3352,52504,49722,570,17.3,432,13.1,12793,7370,5423,14.8,25.7,7228,3873,3355,7.8,14.5,5565,11.2,29,0,306,308,2310
1978,47380,2897,3233,55498,53902,462,14,536,16.3,10452,3226,7226,6,19.4,7259,4075,3184,7.6,13.5,3193,5.9,27,0,299,300,2223
1979,47380,3126,3458,60955,58302,487,14.6,289,8.6,11774,3785,7989,6.5,20.2,6468,2227,4241,3.8,11.1,5306,9.1,22.2,1,1,1,
1980,47380,2492,2819,57647,58100,176,5.6,506,16.1,8445,2827,5618,4.9,14.5,9351,4264,5087,7.3,16.1,-906,-1.6,29,0,385,387,2680
1981,47380,3157,3491,63022,61513,582,18.5,334,10.6,10687,5369,5318,8.7,17.4,7668,2896,4772,4.7,12.5,3019,4.9,25,0,175,175,1046
1982,47380,3235,3637,64286,63604,540,15.1,349,9.8,9974,4115,5859,6.5,15.7,8610,2491,6119,3.9,13.5,1364,2.2,27,0,212,212,1168
1983,47380,3339,3732,64632,64298,458,12.4,398,10.8,10052,3880,6172,6,15.6,9383,2782,6601,4.3,14.6,669,1,29.2,0,272,273,1985
1984,47380,3491,3892,70512,67581,583,15.3,424,11.1,13960,6453,7507,9.5,20.7,8097,3278,4819,4.9,12,5863,8.7,24,0,265,265,1660
1985,47380,3609,4018,70834,70889,552,13.9,416,10.5,10010,3270,6740,4.6,14.1,10120,3143,6977,4.4,14.3,-110,-0.2,28.2,0,288,288,1542
1986,47380,3668,4065,70503,70756,555,13.7,494,12.2,11182,4649,6533,6.6,15.8,11688,4486,7202,6.3,16.5,-506,-0.7,31.6,0,331,334,2725
1987,47380,3667,4068,69601,70793,593,14.6,569,14,10018,4303,5715,6.1,14.2,12402,4795,7607,6.8,17.5,-2384,-3.3,28.4,0,366,366,2554
1988,47380,3586,4012,69252,69115,483,12,519,12.9,11731,5005,6726,7.2,17,11456,4569,6887,6.6,16.6,275,0.4,33.2,0,343,343,1843
1989,47380,3525,3956,69467,69333,398,10,459,11.5,10439,2964,7475,4.3,15.1,10171,3476,6695,5,14.7,268,0.4,29.4,0,309,309,2389
1990,47380,3478,3914,71291,70373,437,11.1,450,11.4,11091,4689,6402,6.7,15.8,9254,4094,5160,5.8,13.1,1837,2.7,26.2,0,310,310,2297
1991,47380,3582,4021,73697,72564,511,12.9,411,10.4,12407,5496,6911,7.6,17.1,10140,4456,5684,6.1,14,2267,3.1,28,0,225,229,2216
1992,47380,3622,4086,75294,74465,497,12.3,408,10.1,11610,4883,6727,6.6,15.6,9951,3386,6565,4.5,13.4,1659,2.2,26.8,0,273,275,2057
1993,47380,3690,4146,73983,74607,462,11.2,402,9.8,11351,3355,7996,4.5,15.2,12599,2919,9680,3.9,16.9,-1248,-1.7,30.4,0,268,269,1684
1994,47380,3800,4266,74915,74284,524,12.5,400,9.5,11176,4685,6491,6.3,15,9913,2763,7150,3.7,13.3,1263,1.7,26.6,0,283,283,1260
1995,47380,3830,4299,79703,77247,497,11.6,441,10.3,13526,4629,8897,6,17.5,8613,3656,4957,4.7,11.1,4913,6.4,22.2,0,297,297,1849
1996,47380,3846,4317,78457,79053,515,12,480,11.1,11356,4307,7049,5.4,14.4,12547,4535,8012,5.7,15.9,-1191,-1.5,28.8,0,328,328,2368
1997,47380,3847,4329,78323,78596,472,10.9,468,10.8,11869,4396,7473,5.6,15.1,12415,5434,6981,6.9,15.8,-546,-0.7,30.2,0,291,291,1927
1998,47380,3800,4295,81513,80588,473,11,499,11.6,12715,6273,6442,7.8,15.8,10865,4400,6465,5.5,13.5,1850,2.3,27,0,328,328,1937
1999,47380,3845,4374,86375,84101,467,10.8,394,9.1,15245,5285,9960,6.3,18.1,10697,3028,7669,3.6,12.7,4548,5.4,25.4,0,279,279,1307
2000,47380,3818,4377,88575,87417,440,10.1,441,10.1,13964,5830,8134,6.7,16,11649,3294,8355,3.8,13.3,2315,2.7,26.6,0,271,271,1648
2001,47380,3809,4362,87136,88312,438,10,490,11.2,11804,3743,8061,4.2,13.4,14156,6123,8033,6.9,16,-2352,-2.6,26.8,0,281,281,1723
2002,47380,3888,4408,87978,86414,515,11.7,466,10.6,19643,10309,9334,11.9,22.7,16515,7629,8886,8.8,19.1,3128,3.6,38.2,0,233,233,1554
2003,47380,3916,4444,86346,86537,486,11.1,361,8.2,12077,4261,7816,4.9,14,12458,2392,10066,2.8,14.4,-381,-0.4,28,0,252,252,1301
2004,47380,3953,4535,87916,86705,495,11,358,8,12547,4960,7587,5.7,14.5,10124,2957,7167,3.4,11.7,2423,2.8,23.4,0,247,247,2038
2005,47380,4005,4617,90290,89065,468,10.3,368,8.1,13974,4305,9669,4.8,15.7,11524,4101,7423,4.6,12.9,2450,2.8,25.8,0,261,261,1933
2006,47380,3940,4552,90820,89951,438,9.6,436,9.5,12499,3657,8842,4.1,13.9,10761,4236,6525,4.7,12,1738,1.9,24,0,292,292,2332
2007,47380,3981,4625,93228,91874,474,10.3,391,8.5,15030,6537,8493,7.1,16.4,12322,4552,7770,5,13.4,2708,3,26.8,0,263,263,2534
2008,47380,3983,4648,96785,94698,424,9.2,344,7.5,13944,4903,9041,5.2,14.7,9769,2442,7327,2.6,10.3,4175,4.4,20.6,0,264,264,1782
2009,47380,3909,4559,94663,95440,359,7.8,406,8.8,11779,4155,7624,4.4,12.3,13332,3479,9853,3.6,14,-1553,-1.7,24.6,0,277,277,1562
2010,47380,3915,4579,95898,94911,375,8.2,336,7.4,12555,4863,7692,5.1,13.2,10580,3158,7422,3.3,11.1,1975,2.1,22.2,0,240,240,1470
2011,47380,3893,4568,97058,96264,378,8.3,345,7.6,10617,3268,7349,3.4,11,9028,2196,6832,2.3,9.4,1589,1.6,18.8,0,242,242,1649
2012,47380,3916,4608,95026,95944,419,9.1,393,8.6,10961,3475,7486,3.6,11.4,12797,3405,9392,3.5,13.3,-1836,-1.9,22.8,0,273,280,1864
2013,47380,3947,4665,99368,96974,404,8.7,350,7.6,14208,4079,10129,4.2,14.7,9420,3210,6210,3.3,9.7,4788,5,19.4,0,227,227,1348
2014,47380,3907,4638,100266,99340,373,8.1,363,7.8,14933,6986,7947,7,15,13080,3560,9520,3.6,13.2,1853,1.8,26.4,0,236,236,1317
1977,47580,986,1064,10244,9988,222,21.6,137,13.4,2436,1449,987,14.5,24.4,1923,952,971,9.5,19.3,513,5.1,38.6,0,97,97,592
1978,47580,979,1062,11244,10743,157,14.8,159,15,2643,1019,1624,9.5,24.6,1640,1024,616,9.5,15.3,1003,9.3,30.6,0,121,121,471
1979,47580,1012,1110,12357,11787,189,17.4,131,12.1,3017,1615,1402,13.7,25.6,1876,749,1127,6.4,15.9,1141,9.7,31.8,0,91,91,414
1980,47580,1001,1096,12359,12353,154,14,162,14.7,2107,933,1174,7.6,17.1,2094,863,1231,7,17,13,0.1,34,0,129,129,510
1981,47580,960,1043,12370,12316,139,13,178,16.7,2523,1155,1368,9.4,20.5,2414,1202,1212,9.8,19.6,109,0.9,39.2,0,105,105,566
1982,47580,963,1062,12664,12464,158,15,128,12.2,2211,1073,1138,8.6,17.7,1810,616,1194,4.9,14.5,401,3.2,29,0,72,72,356
1983,47580,1013,1132,13169,12856,186,17,118,10.8,2919,1495,1424,11.6,22.7,2292,645,1647,5,17.8,627,4.9,35.6,0,81,81,409
1984,47580,1061,1184,14196,13703,187,16.1,142,12.3,3086,1059,2027,7.7,22.5,2099,1135,964,8.3,15.3,987,7.2,30.6,0,96,96,639
1985,47580,1127,1257,15254,14748,200,16.4,126,10.3,3311,1613,1698,10.9,22.5,2299,946,1353,6.4,15.6,1012,6.9,31.2,0,77,77,610
1986,47580,1174,1316,16438,15823,188,14.6,119,9.3,3699,1263,2436,8,23.4,2469,958,1511,6.1,15.6,1230,7.8,31.2,0,85,85,518
1987,47580,1236,1398,17518,17109,230,16.9,155,11.4,3822,1706,2116,10,22.3,3003,1160,1843,6.8,17.6,819,4.7,35.2,0,105,106,686
1988,47580,1264,1447,28492,23303,210,14.8,151,10.6,13415,11566,1849,49.6,57.6,3036,1121,1915,4.8,13,10379,44.6,26,0,97,97,496
1989,47580,1285,1470,18528,23486,188,12.9,167,11.5,3342,1181,2161,5,14.2,13258,1269,11989,5.4,56.5,-9916,-42.3,28.4,0,108,108,726
1990,47580,1308,1488,18237,18361,189,12.8,164,11.1,3342,1523,1819,8.3,18.2,3590,1423,2167,7.8,19.6,-248,-1.4,36.4,0,100,100,506
1991,47580,1341,1527,18057,18111,215,14.3,170,11.3,3701,2429,1272,13.4,20.4,3809,1359,2450,7.5,21,-108,-0.6,40.8,0,109,111,840
1992,47580,1347,1540,18969,18526,191,12.4,178,11.6,3847,1666,2181,9,20.8,2961,1290,1671,7,16,886,4.8,32,0,119,120,819
1993,47580,1380,1563,19424,19164,200,12.9,171,11,3484,1382,2102,7.2,18.2,2964,1394,1570,7.3,15.5,520,2.7,31,0,115,115,599
1994,47580,1427,1616,21578,20521,220,13.8,162,10.2,4336,2210,2126,10.8,21.1,2221,931,1290,4.5,10.8,2115,10.3,21.6,0,118,118,646
1995,47580,1466,1660,23166,22389,217,13.3,167,10.2,4706,2219,2487,9.9,21,3152,1438,1714,6.4,14.1,1554,6.9,28.2,0,116,116,815
1996,47580,1493,1683,23617,23355,236,14.1,210,12.6,4445,1925,2520,8.2,19,3921,1686,2235,7.2,16.8,524,2.2,33.6,0,136,136,874
1997,47580,1565,1766,25296,24503,247,14.3,176,10.2,5968,2486,3482,10.1,24.4,4382,1750,2632,7.1,17.9,1586,6.5,35.8,0,111,111,537
1998,47580,1545,1742,24384,24643,188,10.7,205,11.7,4175,1492,2683,6.1,16.9,4693,1791,2902,7.3,19,-518,-2.1,33.8,0,136,136,921
1999,47580,1574,1787,25298,24822,228,12.9,182,10.3,4627,2168,2459,8.7,18.6,3674,1129,2545,4.5,14.8,953,3.8,29.6,0,132,132,695
2000,47580,1540,1766,26648,25998,204,11.5,218,12.3,5292,1578,3714,6.1,20.4,3992,1384,2608,5.3,15.4,1300,5,30.8,0,133,133,759
2001,47580,1561,1799,26437,26556,229,12.8,206,11.5,4135,1840,2295,6.9,15.6,4373,1651,2722,6.2,16.5,-238,-0.9,31.2,0,125,125,724
2002,47580,1611,1847,30778,28617,268,14.7,222,12.2,9106,5739,3367,20.1,31.8,4783,2153,2630,7.5,16.7,4323,15.1,33.4,0,102,102,1117
2003,47580,1661,1907,30184,30035,242,13,144,7.7,4123,1649,2474,5.5,13.7,3824,893,2931,3,12.7,299,1,25.4,0,106,106,580
2004,47580,1697,1939,30428,30252,226,11.8,174,9.1,5253,1925,3328,6.4,17.4,4900,1859,3041,6.1,16.2,353,1.2,32.4,0,107,107,1130
2005,47580,1744,1999,34362,32303,256,13.1,174,8.9,7507,2135,5372,6.6,23.2,3389,880,2509,2.7,10.5,4118,12.7,21,0,121,121,521
2006,47580,1766,2055,36638,35437,247,12.2,174,8.6,6577,2635,3942,7.4,18.6,4175,1169,3006,3.3,11.8,2402,6.8,23.6,0,124,124,964
2007,47580,1834,2136,34026,35289,285,13.6,200,9.6,4626,1910,2716,5.4,13.1,7151,1481,5670,4.2,20.3,-2525,-7.2,26.2,0,130,136,770
2008,47580,1827,2145,33709,33747,250,11.7,237,11.1,5712,2744,2968,8.1,16.9,5787,2283,3504,6.8,17.1,-75,-0.2,33.8,0,174,174,1904
2009,47580,1784,2100,32894,33237,210,9.9,226,10.7,4625,1835,2790,5.5,13.9,5311,1973,3338,5.9,16,-686,-2.1,27.8,0,171,174,1451
2010,47580,1775,2095,33036,32887,188,9,176,8.4,4092,1438,2654,4.4,12.4,3794,1310,2484,4,11.5,298,0.9,23,0,116,116,1082
2011,47580,1760,2080,33523,33171,191,9.2,194,9.3,4616,1693,2923,5.1,13.9,3912,1321,2591,4,11.8,704,2.1,23.6,0,121,123,534
2012,47580,1786,2093,33089,33297,207,9.9,191,9.2,4314,1436,2878,4.3,13,4730,1500,3230,4.5,14.2,-416,-1.2,26,0,100,100,583
2013,47580,1828,2143,35490,34180,219,10.4,161,7.6,5892,2298,3594,6.7,17.2,3271,1041,2230,3,9.6,2621,7.6,19.2,0,106,107,672
2014,47580,1850,2197,35178,35282,233,10.8,160,7.4,4110,1590,2520,4.5,11.6,4318,1201,3117,3.4,12.2,-208,-0.6,23.2,0,113,113,531
1977,47900,47994,57876,946924,934818,9913,17.6,6905,12.2,215986,97825,118161,10.5,23.1,191775,67222,124553,7.2,20.5,24211,2.6,41,0,4277,4301,32478
1978,47900,49812,60004,1010848,978793,8891,15.1,6777,11.5,218055,73807,144248,7.5,22.3,153945,57455,96490,5.9,15.7,64110,6.6,31.4,0,4400,4435,26214
1979,47900,51118,61828,1089881,1049675,8874,14.6,6738,11.1,228137,73517,154620,7,21.7,147726,59969,87757,5.7,14.1,80411,7.6,28.2,0,4567,4584,26529
1980,47900,52566,63527,1143067,1116137,8731,13.9,6886,11,238517,73490,165027,6.6,21.4,184657,70162,114495,6.3,16.5,53860,4.9,33,0,4579,4603,28594
1981,47900,52066,62869,1157906,1150155,8566,13.6,8765,13.9,243299,100137,143162,8.7,21.2,227797,116114,111683,10.1,19.8,15502,1.4,39.6,0,4810,4836,38461
1982,47900,53815,65964,1180785,1165874,10589,16.4,7051,10.9,251882,109142,142740,9.4,21.6,222060,65603,156457,5.6,19,29822,2.6,38,0,3792,3803,26256
1983,47900,56668,68908,1205790,1193135,9188,13.6,6715,10,237415,75757,161658,6.3,19.9,212105,62951,149154,5.3,17.8,25310,2.1,35.6,0,4126,4166,25761
1984,47900,56444,69098,1277262,1241309,9259,13.4,8728,12.7,258684,100443,158241,8.1,20.8,186777,70988,115789,5.7,15,71907,5.8,30,0,4700,4709,30254
1985,47900,61652,74916,1400433,1342704,10929,15.2,5552,7.7,300645,109180,191465,8.1,22.4,185187,71268,113919,5.3,13.8,115458,8.6,27.6,0,1296,1348,17698
1986,47900,65371,79423,1516176,1464560,12331,16,7612,9.9,317821,134956,182865,9.2,21.7,214589,72268,142321,4.9,14.7,103232,7,29.4,0,4591,4640,33926
1987,47900,68395,83834,1636048,1582204,13557,16.6,9003,11,346597,139334,207263,8.8,21.9,238908,94218,144690,6,15.1,107689,6.8,30.2,0,5391,5455,41156
1988,47900,70738,87627,1705942,1670281,13340,15.6,9284,10.8,353538,134931,218607,8.1,21.2,282217,99562,182655,6,16.9,71321,4.3,33.8,0,5836,5836,43646
1989,47900,72795,91078,1764091,1730323,12873,14.4,9491,10.6,345623,133998,211625,7.7,20,278087,96109,181978,5.6,16.1,67536,3.9,32.2,0,5893,5918,45223
1990,47900,74500,93700,1790932,1776584,12736,13.8,9581,10.4,315485,112704,202781,6.3,17.8,286789,89245,197544,5,16.1,28696,1.7,32.2,0,6094,6128,44912
1991,47900,74522,94567,1704771,1746347,12246,13,11282,12,273915,114712,159203,6.6,15.7,357066,105576,251490,6,20.4,-83151,-4.7,31.4,0,6488,6623,49588
1992,47900,75413,96171,1713800,1710396,12580,13.2,10667,11.2,318462,133434,185028,7.8,18.6,311654,101672,209982,5.9,18.2,6808,0.4,36.4,0,6215,6324,46558
1993,47900,77155,97049,1758730,1735023,11534,11.9,10409,10.8,320770,102663,218107,5.9,18.5,273356,88636,184720,5.1,15.8,47414,2.7,31.6,0,5904,5943,37304
1994,47900,79182,99373,1767468,1762267,12151,12.4,9547,9.7,295873,103098,192775,5.9,16.8,285471,82624,202847,4.7,16.2,10402,0.6,32.4,0,5786,5849,33846
1995,47900,81215,101661,1832898,1798039,12665,12.6,10088,10,316615,111049,205566,6.2,17.6,246898,84678,162220,4.7,13.7,69717,3.9,27.4,0,6141,6180,36936
1996,47900,82757,103382,1838602,1836860,12470,12.2,10578,10.3,303996,112874,191122,6.1,16.5,300512,96300,204212,5.2,16.4,3484,0.1,32.8,0,6351,6352,37840
1997,47900,84407,105442,1921005,1880674,13927,13.3,11904,11.4,381211,135243,245968,7.2,20.3,300549,112642,187907,6,16,80662,4.3,32,0,6680,6680,42058
1998,47900,85511,106871,1993403,1957068,13019,12.3,11308,10.7,364344,139725,224619,7.1,18.6,291674,107648,184026,5.5,14.9,72670,3.7,29.8,0,6783,6783,47748
1999,47900,86293,108416,2052432,2023280,12845,11.9,11136,10.3,362063,131619,230444,6.5,17.9,303759,116105,187654,5.7,15,58304,2.9,30,0,6590,6590,47857
2000,47900,87318,110139,2168956,2111362,13084,12,11329,10.4,414380,151553,262827,7.2,19.6,299191,115814,183377,5.5,14.2,115189,5.4,28.4,0,6319,6319,39192
2001,47900,89155,112788,2240816,2210785,13372,12,11604,10.4,396199,148478,247721,6.7,17.9,336136,116647,219489,5.3,15.2,60063,2.7,30.4,0,6263,6266,43438
2002,47900,90688,114733,2214123,2224720,15342,13.5,13293,11.7,397716,171043,226673,7.7,17.9,418910,152810,266100,6.9,18.8,-21194,-0.9,35.8,0,6368,6397,55265
2003,47900,92012,116318,2236290,2206776,14023,12.2,10393,9,362312,127225,235087,5.8,16.4,303283,95245,208038,4.3,13.7,59029,2.7,27.4,0,6535,6541,47115
2004,47900,94043,118695,2331242,2276991,13955,11.9,10444,8.9,392709,127508,265201,5.6,17.2,284208,87149,197059,3.8,12.5,108501,4.7,25,0,6451,6467,42556
2005,47900,97454,122871,2354831,2335362,15924,13.2,10588,8.8,362666,133586,229080,5.7,15.5,323728,91243,232485,3.9,13.9,38938,1.6,27.8,0,6561,6595,42658
2006,47900,99279,126001,2436617,2387429,15965,12.9,11607,9.4,410180,138356,271824,5.8,17.2,311804,102335,209469,4.3,13.1,98376,4.1,26.2,0,7509,7525,52558
2007,47900,100496,128121,2463755,2443788,15481,12.2,12950,10.2,424085,141586,282499,5.8,17.4,384150,115033,269117,4.7,15.7,39935,1.7,31.4,0,7639,7705,48052
2008,47900,100118,127882,2470726,2459364,13874,10.9,12646,9.9,374190,124617,249573,5.1,15.2,351467,106270,245197,4.3,14.3,22723,0.9,28.6,0,8320,8321,48130
2009,47900,97823,126288,2400110,2427190,12745,10.1,13075,10.3,316764,117264,199500,4.8,13.1,370923,97087,273836,4,15.3,-54159,-2.2,26.2,0,8218,8245,47819
2010,47900,97439,126057,2376838,2382347,12744,10.1,12204,9.7,317095,111241,205854,4.7,13.3,328113,96325,231788,4,13.8,-11018,-0.5,26.6,0,7168,7189,42367
2011,47900,97310,127000,2442183,2405258,13239,10.5,11352,9,359982,114653,245329,4.8,15,286132,79057,207075,3.3,11.9,73850,3.1,23.8,0,7049,7062,44775
2012,47900,98919,128307,2478788,2454452,13077,10.3,11644,9.1,374086,109304,264782,4.5,15.2,325413,99117,226296,4,13.3,48673,1.9,26.6,0,6350,6426,37947
2013,47900,100395,130421,2520912,2494776,13419,10.4,11233,8.7,362279,125683,236596,5,14.5,310006,96501,213505,3.9,12.4,52273,2.1,24.8,0,6421,6442,51520
2014,47900,101378,132209,2558150,2530405,13969,10.7,11047,8.4,363704,126025,237679,5,14.4,308214,72625,235589,2.9,12.2,55490,2.2,24.4,0,7164,7190,40292
1977,47940,3220,3538,56558,55612,584,16.9,418,12.1,8609,4201,4408,7.6,15.5,6716,3005,3711,5.4,12.1,1893,3.4,24.2,0,279,285,1988
1978,47940,3328,3663,60467,58481,513,14.2,384,10.7,9311,2834,6477,4.8,15.9,5339,2587,2752,4.4,9.1,3972,6.8,18.2,0,281,281,1456
1979,47940,3306,3650,61980,61184,417,11.4,412,11.3,9432,2851,6581,4.7,15.4,7839,3205,4634,5.2,12.8,1593,2.6,25.6,0,289,290,1390
1980,47940,3301,3649,63294,62592,402,11,374,10.2,8687,2961,5726,4.7,13.9,7282,2544,4738,4.1,11.6,1405,2.3,23.2,0,286,286,1591
1981,47940,3233,3569,59493,60671,413,11.5,452,12.6,18583,15591,2992,25.7,30.6,20939,15953,4986,26.3,34.5,-2356,-3.9,61.2,0,261,263,1471
1982,47940,3171,3545,56217,57800,433,12.2,402,11.3,7038,2399,4639,4.2,12.2,10204,2229,7975,3.9,17.7,-3166,-5.5,24.4,0,252,252,1109
1983,47940,3189,3558,51233,53773,347,9.8,376,10.6,5809,2683,3126,5,10.8,10888,2447,8441,4.6,20.2,-5079,-9.4,21.6,0,263,263,1212
1984,47940,3245,3621,50896,51038,416,11.6,362,10.1,6016,2123,3893,4.2,11.8,6300,1967,4333,3.9,12.3,-284,-0.5,23.6,0,242,242,1094
1985,47940,3193,3551,49803,50918,352,9.8,441,12.3,6136,2340,3796,4.6,12.1,8365,2373,5992,4.7,16.4,-2229,-4.3,24.2,0,283,284,1407
1986,47940,3118,3475,47799,48763,357,10.2,417,11.9,6979,3575,3404,7.3,14.3,8907,3700,5207,7.6,18.3,-1928,-4,28.6,0,277,277,1957
1987,47940,3129,3498,48529,47922,438,12.6,403,11.5,9981,3534,6447,7.4,20.8,8767,2473,6294,5.2,18.3,1214,2.5,36.6,0,259,264,1349
1988,47940,3060,3444,50654,49201,340,9.8,368,10.6,8310,2284,6026,4.6,16.9,5403,2198,3205,4.5,11,2907,5.9,22,0,238,238,1138
1989,47940,3072,3467,53985,52345,326,9.4,304,8.8,7933,2524,5409,4.8,15.2,4653,1613,3040,3.1,8.9,3280,6.3,17.8,0,214,214,1002
1990,47940,3138,3548,56660,55181,374,10.7,277,7.9,8072,2621,5451,4.7,14.6,5113,1451,3662,2.6,9.3,2959,5.3,18.6,0,186,186,905
1991,47940,3169,3594,58009,57178,347,9.7,293,8.2,8125,2208,5917,3.9,14.2,6462,1979,4483,3.5,11.3,1663,2.9,22.6,0,194,194,1056
1992,47940,3216,3658,58479,58310,348,9.6,285,7.8,7474,2552,4922,4.4,12.8,7136,2182,4954,3.7,12.2,338,0.6,24.4,0,191,191,1516
1993,47940,3272,3702,59274,58845,332,9,275,7.5,6950,2013,4937,3.4,11.8,6092,1474,4618,2.5,10.4,858,1.4,20.8,0,194,194,818
1994,47940,3270,3698,59341,59249,308,8.3,299,8.1,6882,2643,4239,4.5,11.6,6698,2137,4561,3.6,11.3,184,0.3,22.6,0,212,212,1389
1995,47940,3285,3738,62867,61080,384,10.3,335,9,9483,4065,5418,6.7,15.5,5908,1931,3977,3.2,9.7,3575,5.8,19.4,0,230,232,1144
1996,47940,3298,3762,65518,64198,359,9.6,329,8.8,9704,3213,6491,5,15.1,7063,2190,4873,3.4,11,2641,4.1,22,0,211,211,1184
1997,47940,3298,3777,66387,66050,386,10.2,375,9.9,10146,4060,6086,6.1,15.4,9472,3385,6087,5.1,14.3,674,1.1,28.6,0,229,229,1600
1998,47940,3298,3786,68283,67420,338,8.9,326,8.6,9106,2826,6280,4.2,13.5,7379,2614,4765,3.9,10.9,1727,2.6,21.8,0,218,218,1466
1999,47940,3293,3788,68845,68726,336,8.9,329,8.7,8514,3281,5233,4.8,12.4,8275,2974,5301,4.3,12,239,0.4,24,0,202,202,1506
2000,47940,3248,3750,70938,69823,266,7.1,313,8.3,8667,2409,6258,3.5,12.4,6437,1804,4633,2.6,9.2,2230,3.2,18.4,0,188,188,836
2001,47940,3193,3705,70826,70961,277,7.4,341,9.1,6749,1987,4762,2.8,9.5,7018,2147,4871,3,9.9,-269,-0.4,19,0,184,184,842
2002,47940,3159,3685,69622,70213,344,9.3,363,9.8,8095,2819,5276,4,11.5,9277,2751,6526,3.9,13.2,-1182,-1.7,23,0,182,184,1038
2003,47940,3156,3709,71101,70010,339,9.2,264,7.2,8934,3877,5057,5.5,12.8,6751,1812,4939,2.6,9.6,2183,3.2,19.2,0,180,180,1397
2004,47940,3153,3705,71918,71336,303,8.2,284,7.7,8222,2816,5406,3.9,11.5,7058,2546,4512,3.6,9.9,1164,1.6,19.8,0,179,179,1292
2005,47940,3196,3762,71247,71423,338,9.1,244,6.6,7478,2182,5296,3.1,10.5,7829,2154,5675,3,11,-351,-0.5,21,0,168,168,984
2006,47940,3211,3824,73037,72069,391,10.3,298,7.9,10022,4071,5951,5.6,13.9,8085,2580,5505,3.6,11.2,1937,2.7,22.4,0,179,179,1988
2007,47940,3234,3836,72217,72480,320,8.4,294,7.7,8323,2124,6199,2.9,11.5,8849,2593,6256,3.6,12.2,-526,-0.7,23,0,169,171,1172
2008,47940,3185,3781,73582,72774,260,6.9,264,7,7481,2055,5426,2.8,10.3,5864,1375,4489,1.9,8.1,1617,2.2,16.2,0,173,173,839
2009,47940,3124,3716,75088,74247,244,6.5,298,8,8640,3489,5151,4.7,11.6,6958,1625,5333,2.2,9.4,1682,2.2,18.8,0,197,197,818
2010,47940,3126,3734,75398,75160,261,7,213,5.7,7284,2052,5232,2.7,9.7,6807,1504,5303,2,9.1,477,0.6,18.2,0,119,119,1053
2011,47940,3130,3751,75971,75597,278,7.4,243,6.5,7120,2210,4910,2.9,9.4,6372,1495,4877,2,8.4,748,1,16.8,0,158,160,862
2012,47940,3132,3788,78406,77134,312,8.3,275,7.3,9664,2554,7110,3.3,12.5,7119,2110,5009,2.7,9.2,2545,3.3,18.4,0,170,170,1188
2013,47940,3088,3763,80958,79464,242,6.4,264,7,9960,3183,6777,4,12.5,6972,1695,5277,2.1,8.8,2988,3.7,17.6,0,167,167,1246
2014,47940,3112,3779,76445,78488,283,7.5,233,6.2,6101,2154,3947,2.7,7.8,10186,5433,4753,6.9,13,-4085,-5.2,15.6,0,157,157,768
1977,48140,1854,1973,32529,31941,290,15,208,10.8,4555,1460,3095,4.6,14.3,3378,1472,1906,4.6,10.6,1177,3.7,21.2,0,143,143,536
1978,48140,1950,2077,36125,34327,308,15.2,205,10.1,6560,2517,4043,7.3,19.1,2963,1420,1543,4.1,8.6,3597,10.5,17.2,0,150,150,785
1979,48140,1982,2115,37529,36811,262,12.5,213,10.2,5595,1967,3628,5.3,15.2,4159,1393,2766,3.8,11.3,1436,3.9,22.6,0,147,149,925
1980,48140,1959,2096,38822,38165,232,11,239,11.3,6170,1397,4773,3.7,16.2,4856,1346,3510,3.5,12.7,1314,3.5,25.4,0,165,165,890
1981,48140,1899,2028,34866,36249,221,10.7,260,12.6,4351,1924,2427,5.3,12,7116,1601,5515,4.4,19.6,-2765,-7.6,24,0,158,158,784
1982,48140,1945,2109,33906,34387,286,13.8,182,8.8,3979,1673,2306,4.9,11.6,4941,1344,3597,3.9,14.4,-962,-2.8,23.2,0,103,103,488
1983,48140,1987,2157,33492,33689,225,10.5,207,9.7,4473,2184,2289,6.5,13.3,4867,1220,3647,3.6,14.4,-394,-1.1,26.6,0,120,120,507
1984,48140,2058,2233,35676,34584,290,13.2,212,9.7,6077,2376,3701,6.9,17.6,3893,2168,1725,6.3,11.3,2184,6.3,22.6,0,120,120,483
1985,48140,2096,2262,35908,35749,256,11.4,217,9.7,4128,1442,2686,4,11.5,3809,1105,2704,3.1,10.7,319,0.8,21.4,0,150,150,701
1986,48140,2016,2181,34895,35290,224,10.1,271,12.2,4406,1642,2764,4.7,12.5,5196,2817,2379,8,14.7,-790,-2.2,25,0,132,132,757
1987,48140,2181,2371,39016,37354,332,14.6,160,7,6562,2752,3810,7.4,17.6,3238,994,2244,2.7,8.7,3324,8.9,17.4,0,30,30,194
1988,48140,2214,2416,42626,40817,264,11,205,8.6,7224,1838,5386,4.5,17.7,3605,966,2639,2.4,8.8,3619,8.9,17.6,0,147,147,680
1989,48140,2267,2472,45498,44423,251,10.3,203,8.3,7284,2096,5188,4.7,16.4,5134,1662,3472,3.7,11.6,2150,4.8,23.2,0,138,139,946
1990,48140,2306,2521,46427,45942,245,9.8,179,7.2,5127,1468,3659,3.2,11.2,4157,1093,3064,2.4,9,970,2.2,18,0,129,129,871
1991,48140,2374,2622,47651,47064,276,10.7,183,7.1,5838,2355,3483,5,12.4,4663,1158,3505,2.5,9.9,1175,2.5,19.8,0,117,117,571
1992,48140,2442,2710,48677,48164,281,10.5,188,7,6020,1393,4627,2.9,12.5,4994,1538,3456,3.2,10.4,1026,2.1,20.8,0,110,113,533
1993,48140,2487,2745,50916,49798,247,9.1,211,7.7,6291,1424,4867,2.9,12.6,4054,1172,2882,2.4,8.1,2237,4.5,16.2,0,129,133,766
1994,48140,2554,2815,51916,51398,279,10,206,7.4,6547,2801,3746,5.4,12.7,5511,1512,3999,2.9,10.7,1036,2,21.4,0,138,138,740
1995,48140,2601,2878,54367,53128,283,9.9,206,7.2,6923,2474,4449,4.7,13,4444,1362,3082,2.6,8.4,2479,4.6,16.8,0,148,148,735
1996,48140,2602,2874,55173,54831,228,7.9,238,8.3,5979,1581,4398,2.9,10.9,5295,1784,3511,3.3,9.7,684,1.2,19.4,0,143,143,860
1997,48140,2656,2953,56450,55596,317,10.9,231,7.9,7607,2349,5258,4.2,13.7,5898,2072,3826,3.7,10.6,1709,3.1,21.2,0,130,130,892
1998,48140,2666,2955,57604,57004,237,8,229,7.8,6747,2277,4470,4,11.8,5546,2373,3173,4.2,9.7,1201,2.1,19.4,0,138,138,677
1999,48140,2682,2972,58562,58105,299,10.1,278,9.4,8050,2133,5917,3.7,13.9,7136,3993,3143,6.9,12.3,914,1.6,24.6,0,177,177,983
2000,48140,2714,3019,62262,60343,297,9.9,247,8.2,9780,4955,4825,8.2,16.2,5941,1948,3993,3.2,9.8,3839,6.4,19.6,0,149,149,805
2001,48140,2696,3025,59930,61170,284,9.4,293,9.7,7263,3297,3966,5.4,11.9,9742,3792,5950,6.2,15.9,-2479,-4,23.8,0,178,179,1622
2002,48140,2698,3044,63648,62912,301,9.9,278,9.2,9832,3577,6255,5.7,15.6,8360,2105,6255,3.3,13.3,1472,2.3,26.6,0,148,149,1044
2003,48140,2681,3032,60986,62026,277,9.2,254,8.4,7216,2164,5052,3.5,11.6,9295,1988,7307,3.2,15,-2079,-3.4,23.2,0,161,162,1375
2004,48140,2682,3096,63782,62184,306,10,219,7.2,9528,2967,6561,4.8,15.3,6331,2962,3369,4.8,10.2,3197,5.1,20.4,0,134,134,715
2005,48140,2724,3160,65096,63638,279,8.9,192,6.2,8351,1913,6438,3,13.1,5434,1094,4340,1.7,8.5,2917,4.6,17,0,125,126,738
2006,48140,2766,3204,67104,66036,279,8.8,216,6.8,8208,4085,4123,6.2,12.4,6071,1690,4381,2.6,9.2,2137,3.2,18.4,0,144,144,1159
2007,48140,2799,3262,67897,67376,307,9.5,239,7.4,11246,3906,7340,5.8,16.7,10203,2083,8120,3.1,15.1,1043,1.6,30.2,0,134,134,1224
2008,48140,2806,3272,68264,68038,268,8.2,242,7.4,7842,2453,5389,3.6,11.5,7390,1766,5624,2.6,10.9,452,0.6,21.8,0,168,168,1171
2009,48140,2727,3123,63181,65647,197,6.2,321,10.1,5158,1877,3281,2.9,7.9,10089,2613,7476,4,15.4,-4931,-7.5,15.8,0,164,164,1002
2010,48140,2681,3077,58004,60374,209,6.8,237,7.7,4971,1497,3474,2.5,8.2,9710,2915,6795,4.8,16.1,-4739,-7.9,16.4,0,152,152,2234
2011,48140,2656,3055,58813,58416,213,7,215,7,5669,1665,4004,2.9,9.7,4874,975,3899,1.7,8.3,795,1.4,16.6,0,133,133,558
2012,48140,2633,3029,60263,59283,260,8.6,286,9.4,7948,3617,4331,6.1,13.4,5988,1746,4242,2.9,10.1,1960,3.3,20.2,0,157,157,900
2013,48140,2629,3018,59924,59872,213,7.1,202,6.7,6060,1477,4583,2.5,10.1,5956,2261,3695,3.8,9.9,104,0.2,19.8,0,123,123,1767
2014,48140,2592,2968,60850,60316,181,6.1,204,6.8,6117,2566,3551,4.3,10.1,5048,1393,3655,2.3,8.4,1069,1.7,16.8,0,143,143,762
1977,48300,1407,1499,16679,15613,271,18.6,176,12.1,4660,1935,2725,12.4,29.8,2528,1094,1434,7,16.2,2132,13.6,32.4,0,125,125,864
1978,48300,1438,1536,18050,17358,241,15.9,199,13.1,3763,1003,2760,5.8,21.7,2378,813,1565,4.7,13.7,1385,8,27.4,0,131,131,459
1979,48300,1473,1575,18707,18351,247,15.9,194,12.5,3665,1297,2368,7.1,20,2952,892,2060,4.9,16.1,713,3.9,32.2,0,137,137,566
1980,48300,1447,1546,17624,18185,203,13,224,14.4,3358,1023,2335,5.6,18.5,4480,1245,3235,6.8,24.6,-1122,-6.1,37,0,144,144,650
1981,48300,1430,1520,16825,16901,229,15,235,15.4,3638,1491,2147,8.8,21.5,3790,1876,1914,11.1,22.4,-152,-0.9,43,0,146,146,710
1982,48300,1438,1548,17629,17198,239,15.5,189,12.3,4374,2602,1772,15.1,25.4,3511,958,2553,5.6,20.4,863,5,40.8,0,107,107,606
1983,48300,1535,1653,17664,17674,233,14.6,158,9.9,3083,994,2089,5.6,17.4,3102,723,2379,4.1,17.6,-19,-0.2,34.8,0,111,111,537
1984,48300,1608,1722,18760,18207,273,16.2,203,12,4172,1403,2769,7.7,22.9,3065,1372,1693,7.5,16.8,1107,6.1,33.6,0,131,131,814
1985,48300,1693,1803,20366,19862,258,14.6,179,10.1,3891,1126,2765,5.7,19.6,2882,976,1906,4.9,14.5,1009,5.1,29,0,118,119,582
1986,48300,1737,1840,20971,20660,251,13.8,205,11.3,4177,1735,2442,8.4,20.2,3554,1263,2291,6.1,17.2,623,3,34.4,0,115,115,582
1987,48300,1777,1892,21297,20978,291,15.6,220,11.8,4294,1752,2542,8.4,20.5,3656,1498,2158,7.1,17.4,638,3.1,34.8,0,146,146,995
1988,48300,1767,1888,20767,20646,255,13.5,235,12.5,4372,1298,3074,6.3,21.2,4130,1774,2356,8.6,20,242,1.2,40,0,153,153,971
1989,48300,1460,1572,18760,19823,190,11,505,29.2,3757,1624,2133,8.2,19,5882,3975,1907,20.1,29.7,-2125,-10.7,38,0,151,151,1045
1990,48300,1861,1974,22554,20622,540,30.5,127,7.2,6049,3487,2562,16.9,29.3,2185,639,1546,3.1,10.6,3864,18.7,21.2,0,80,80,371
1991,48300,1944,2078,22966,22683,295,14.6,187,9.2,4017,1658,2359,7.3,17.7,3451,1151,2300,5.1,15.2,566,2.5,30.4,0,122,125,664
1992,48300,2045,2195,23861,23386,329,15.4,204,9.5,4290,1533,2757,6.6,18.3,3340,1125,2215,4.8,14.3,950,4,28.6,0,135,135,715
1993,48300,2057,2211,25652,24791,288,13.1,254,11.5,5209,1780,3429,7.2,21,3487,1356,2131,5.5,14.1,1722,6.9,28.2,0,181,182,1012
1994,48300,2162,2320,26288,25932,334,14.7,209,9.2,4778,1797,2981,6.9,18.4,4065,1075,2990,4.1,15.7,713,2.7,31.4,0,148,148,714
1995,48300,2163,2319,26828,26513,292,12.6,268,11.6,4402,1754,2648,6.6,16.6,3772,1446,2326,5.5,14.2,630,2.4,28.4,0,185,190,874
1996,48300,2226,2387,26794,26892,323,13.7,254,10.8,4045,1399,2646,5.2,15,4241,1302,2939,4.8,15.8,-196,-0.8,30,0,177,177,988
1997,48300,2251,2419,28191,27485,309,12.8,264,11,5558,1889,3669,6.9,20.2,4146,1472,2674,5.4,15.1,1412,5.1,30.2,0,165,165,864
1998,48300,2273,2440,28612,28400,297,12.2,276,11.4,4579,1452,3127,5.1,16.1,4155,1255,2900,4.4,14.6,424,1.5,29.2,0,177,177,837
1999,48300,2281,2457,28375,28549,289,11.8,264,10.8,4125,1212,2913,4.2,14.4,4473,1517,2956,5.3,15.7,-348,-1.3,28.8,0,180,180,865
2000,48300,2253,2431,29144,28719,275,11.3,305,12.5,4716,1774,2942,6.2,16.4,3865,1540,2325,5.4,13.5,851,2.9,27,0,183,183,882
2001,48300,2271,2449,29249,29378,292,11.9,308,12.6,4263,1630,2633,5.5,14.5,4521,1691,2830,5.8,15.4,-258,-0.9,29,0,184,184,862
2002,48300,2256,2433,28945,29079,323,13.3,330,13.5,4780,1896,2884,6.5,16.4,5047,1918,3129,6.6,17.4,-267,-1,32.8,0,173,173,975
2003,48300,2297,2473,29410,29086,330,13.5,247,10.1,4203,1542,2661,5.3,14.5,3555,1173,2382,4,12.2,648,2.3,24.4,0,164,164,747
2004,48300,2333,2516,30114,29701,308,12.4,237,9.5,3999,1195,2804,4,13.5,3172,860,2312,2.9,10.7,827,2.8,21.4,0,151,151,507
2005,48300,2431,2622,30834,30430,360,14,232,9.1,6051,2920,3131,9.6,19.9,5243,2750,2493,9,17.2,808,2.7,34.4,0,156,156,1196
2006,48300,2508,2710,33334,32061,385,14.5,282,10.6,5932,2192,3740,6.8,18.5,3386,1184,2202,3.7,10.6,2546,7.9,21.2,0,188,188,701
2007,48300,2552,2770,33729,33494,339,12.4,275,10.1,4906,1532,3374,4.6,14.6,4436,1364,3072,4.1,13.2,470,1.4,26.4,0,168,168,732
2008,48300,2601,2818,33863,33662,330,11.9,263,9.4,4397,1582,2815,4.7,13.1,3995,1092,2903,3.2,11.9,402,1.2,23.8,0,171,171,801
2009,48300,2475,2695,33456,33592,240,8.7,340,12.4,4513,987,3526,2.9,13.4,4784,1333,3451,4,14.2,-271,-0.8,26.8,0,218,218,948
2010,48300,2451,2674,31641,32440,258,9.6,267,10,3469,1367,2102,4.2,10.7,5067,2372,2695,7.3,15.6,-1598,-4.9,21.4,0,167,167,2012
2011,48300,2416,2637,31465,31548,260,9.8,286,10.8,3274,963,2311,3.1,10.4,3440,974,2466,3.1,10.9,-166,-0.5,20.8,0,173,173,600
2012,48300,2380,2584,31107,31260,240,9.2,293,11.2,3203,787,2416,2.5,10.2,3508,1150,2358,3.7,11.2,-305,-1,20.4,0,163,163,555
2013,48300,2453,2660,32471,31779,286,10.9,215,8.2,4179,1410,2769,4.4,13.2,2794,957,1837,3,8.8,1385,4.4,17.6,0,131,131,550
2014,48300,2459,2660,32360,32211,273,10.3,260,9.8,3755,1188,2567,3.7,11.7,3457,1173,2284,3.6,10.7,298,1,21.4,0,171,171,641
1977,48540,2932,3263,53747,52624,411,12.6,398,12.2,9617,3770,5847,7.2,18.3,7371,3511,3860,6.7,14,2246,4.3,28,0,248,250,1619
1978,48540,2958,3284,52967,53360,336,10.3,314,9.6,7225,1666,5559,3.1,13.5,8010,3443,4567,6.5,15,-785,-1.5,27,0,206,209,1125
1979,48540,2994,3360,57235,54942,427,12.9,337,10.1,10772,3837,6935,7,19.6,6185,1927,4258,3.5,11.3,4587,8.3,22.6,0,246,246,1229
1980,48540,2995,3354,55981,56586,324,9.7,314,9.4,8220,2764,5456,4.9,14.5,9429,1865,7564,3.3,16.7,-1209,-2.2,29,0,204,205,678
1981,48540,2872,3218,50882,52569,295,9,393,12,5940,1890,4050,3.6,11.3,9314,3021,6293,5.7,17.7,-3374,-6.4,22.6,0,245,247,1025
1982,48540,2806,3169,47886,49393,335,10.5,334,10.4,6274,2807,3467,5.7,12.7,9287,4369,4918,8.8,18.8,-3013,-6.1,25.4,0,183,183,2770
1983,48540,2833,3197,44527,46721,286,9,306,9.6,5018,2319,2699,5,10.7,9406,2338,7068,5,20.1,-4388,-9.4,21.4,0,177,177,987
1984,48540,2811,3165,44346,44332,329,10.3,352,11.1,6675,2701,3974,6.1,15.1,6646,2289,4357,5.2,15,29,0.1,30,0,182,182,795
1985,48540,2916,3277,44590,44558,309,9.6,226,7,5880,2545,3335,5.7,13.2,5816,1685,4131,3.8,13.1,64,0.1,26.2,0,85,86,555
1986,48540,2881,3230,42913,43767,300,9.2,348,10.7,5521,1983,3538,4.5,12.6,7228,2954,4274,6.7,16.5,-1707,-3.9,25.2,0,218,219,1528
1987,48540,2910,3280,43949,43414,372,11.4,310,9.5,7072,2943,4129,6.8,16.3,6001,2121,3880,4.9,13.8,1071,2.5,27.6,0,193,193,1197
1988,48540,2847,3219,44413,44077,317,9.8,351,10.8,7905,3210,4695,7.3,17.9,7232,3436,3796,7.8,16.4,673,1.5,32.8,0,212,212,1685
1989,48540,2855,3228,45017,44654,314,9.7,293,9.1,7650,3466,4184,7.8,17.1,6923,2710,4213,6.1,15.5,727,1.6,31,0,190,190,1402
1990,48540,2864,3249,46434,45691,288,8.9,244,7.5,6585,2237,4348,4.9,14.4,5098,1367,3731,3,11.2,1487,3.2,22.4,0,168,168,752
1991,48540,2945,3348,46636,46642,303,9.2,219,6.6,5774,2217,3557,4.8,12.4,5785,1568,4217,3.4,12.4,-11,0,24.8,0,135,135,1166
1992,48540,2963,3364,46611,46723,306,9.1,275,8.2,6606,2243,4363,4.8,14.1,6830,1985,4845,4.2,14.6,-224,-0.5,28.2,0,172,172,932
1993,48540,2981,3386,47656,47106,275,8.1,244,7.2,6537,1967,4570,4.2,13.9,5437,1831,3606,3.9,11.5,1100,2.4,23,0,154,154,732
1994,48540,2967,3370,47198,47424,281,8.3,285,8.4,5325,1497,3828,3.2,11.2,5777,1463,4314,3.1,12.2,-452,-1,22.4,0,198,198,933
1995,48540,3030,3435,48642,47883,318,9.3,249,7.3,6439,1962,4477,4.1,13.4,4921,1557,3364,3.3,10.3,1518,3.1,20.6,0,162,163,716
1996,48540,3041,3448,49205,48851,306,8.9,273,7.9,6496,2438,4058,5,13.3,5787,1571,4216,3.2,11.8,709,1.5,23.6,0,191,191,941
1997,48540,3062,3477,51373,50299,342,9.9,316,9.1,8637,3356,5281,6.7,17.2,6489,2041,4448,4.1,12.9,2148,4.3,25.8,0,187,187,662
1998,48540,3120,3558,51828,51645,325,9.2,246,7,7166,2802,4364,5.4,13.9,6800,2021,4779,3.9,13.2,366,0.7,26.4,0,175,175,1147
1999,48540,3075,3521,51561,51690,297,8.4,331,9.3,6212,2136,4076,4.1,12,6470,2634,3836,5.1,12.5,-258,-0.5,24,0,218,218,1118
2000,48540,3048,3507,53268,52304,301,8.6,309,8.8,7730,3608,4122,6.9,14.8,5802,2252,3550,4.3,11.1,1928,3.7,22.2,0,201,201,1367
2001,48540,2997,3457,53239,53557,259,7.4,334,9.6,6525,2378,4147,4.4,12.2,7161,2417,4744,4.5,13.4,-636,-1.2,24.4,0,194,194,867
2002,48540,2986,3437,53402,53342,296,8.6,321,9.3,7463,2545,4918,4.8,14,7342,2604,4738,4.9,13.8,121,0.2,27.6,0,170,170,875
2003,48540,2927,3365,53025,52971,255,7.5,279,8.2,6650,2383,4267,4.5,12.6,6542,1973,4569,3.7,12.4,108,0.2,24.8,0,173,173,843
2004,48540,2944,3400,55119,54012,260,7.7,205,6.1,7469,2285,5184,4.2,13.8,5255,1661,3594,3.1,9.7,2214,4.1,19.4,0,144,144,1143
2005,48540,2891,3362,53799,54312,260,7.7,260,7.7,6646,2244,4402,4.1,12.2,7671,2106,5565,3.9,14.1,-1025,-1.9,24.4,0,193,194,1167
2006,48540,2832,3326,53764,53701,256,7.7,269,8.1,7764,3564,4200,6.6,14.5,7637,3106,4531,5.8,14.2,127,0.3,28.4,0,169,169,1547
2007,48540,2826,3324,53703,53650,284,8.6,273,8.2,6928,3101,3827,5.8,12.9,6821,1948,4873,3.6,12.7,107,0.2,25.4,0,159,160,1077
2008,48540,2749,3264,55195,54320,218,6.6,253,7.7,7792,2246,5546,4.1,14.3,6042,1523,4519,2.8,11.1,1750,3.2,22.2,0,186,186,1005
2009,48540,2685,3224,54411,54729,200,6.2,222,6.9,6168,2345,3823,4.3,11.3,6804,1483,5321,2.7,12.4,-636,-1.1,22.6,0,154,154,974
2010,48540,2658,3213,53782,54104,176,5.5,184,5.7,5442,2001,3441,3.7,10.1,6085,1021,5064,1.9,11.2,-643,-1.1,20.2,0,120,121,789
2011,48540,2627,3202,54754,54109,194,6.1,177,5.5,6153,1308,4845,2.4,11.4,4862,1566,3296,2.9,9,1291,2.4,18,0,128,128,1140
2012,48540,2617,3201,57122,55935,214,6.7,221,6.9,7506,1296,6210,2.3,13.4,5132,1570,3562,2.8,9.2,2374,4.2,18.4,0,133,134,701
2013,48540,2597,3180,55930,56343,192,6,201,6.3,5437,1560,3877,2.8,9.6,6263,1235,5028,2.2,11.1,-826,-1.5,19.2,0,127,128,778
2014,48540,2559,3161,56042,55863,221,7,212,6.7,6143,1622,4521,2.9,11,5785,1363,4422,2.4,10.4,358,0.6,20.8,0,141,141,843
1977,48620,8894,10072,173011,171450,1673,16.8,1406,14.1,31475,12674,18801,7.4,18.4,28353,11679,16674,6.8,16.5,3122,1.9,33,0,953,959,6458
1978,48620,9154,10385,184669,178841,1538,15,1217,11.9,33793,10370,23423,5.8,18.9,22136,8197,13939,4.6,12.4,11657,6.5,24.8,0,879,881,5080
1979,48620,9190,10437,202190,193167,1424,13.7,1310,12.6,39655,10617,29038,5.5,20.5,21609,9062,12547,4.7,11.2,18046,9.3,22.4,0,935,936,5114
1980,48620,9251,10506,209534,205963,1300,12.4,1195,11.4,32130,8557,23573,4.2,15.6,24987,7169,17818,3.5,12.1,7143,3.5,24.2,0,843,845,4606
1981,48620,9097,10335,205857,207321,1428,13.7,1503,14.4,28463,12249,16214,5.9,13.7,31391,11368,20023,5.5,15.1,-2928,-1.4,27.4,0,932,935,6196
1982,48620,9178,10622,200657,203100,1620,15.4,1243,11.9,26000,12582,13418,6.2,12.8,30885,11581,19304,5.7,15.2,-4885,-2.4,25.6,0,710,713,5523
1983,48620,9374,10831,183738,191147,1354,12.6,1180,11,25012,11569,13443,6.1,13.1,39830,8251,31579,4.3,20.8,-14818,-7.7,26.2,0,783,791,4645
1984,48620,9458,10934,202345,193096,1493,13.7,1393,12.8,42850,11948,30902,6.2,22.2,24352,9857,14495,5.1,12.6,18498,9.6,25.2,0,802,805,4620
1985,48620,9733,11225,207534,206973,1559,14.1,1264,11.4,31069,10760,20309,5.2,15,29947,11676,18271,5.6,14.5,1122,0.5,29,0,857,857,5921
1986,48620,9915,11451,209610,208288,1594,14.1,1330,11.7,35365,14103,21262,6.8,17,32720,13387,19333,6.4,15.7,2645,1.3,31.4,0,924,930,6470
1987,48620,9821,11450,179917,194924,1528,13.3,1482,12.9,29437,12201,17236,6.3,15.1,59451,41221,18230,21.1,30.5,-30014,-15.4,30.2,0,986,995,6325
1988,48620,9780,11551,184756,182185,1459,12.7,1307,11.4,32937,14911,18026,8.2,18.1,27795,10816,16979,5.9,15.3,5142,2.8,30.6,0,905,905,6805
1989,48620,9728,11532,214873,199737,1284,11.1,1317,11.4,56153,36131,20022,18.1,28.1,25881,10177,15704,5.1,13,30272,15.1,26,0,914,917,6420
1990,48620,9711,11503,220332,217497,1263,11,1212,10.5,32698,11769,20929,5.4,15,27028,10103,16925,4.6,12.4,5670,2.6,24.8,0,828,832,5317
1991,48620,9811,11705,221813,221243,1392,12,1191,10.3,32629,12911,19718,5.8,14.7,31488,9949,21539,4.5,14.2,1141,0.5,28.4,0,728,733,5840
1992,48620,9944,11883,220605,221058,1412,12,1196,10.1,31970,11285,20685,5.1,14.5,32875,12477,20398,5.6,14.9,-905,-0.4,29,0,759,762,6583
1993,48620,10175,12094,223170,222085,1329,11.1,1100,9.2,30312,10052,20260,4.5,13.6,28141,8622,19519,3.9,12.7,2171,0.9,25.4,0,727,728,4669
1994,48620,10447,12347,221920,222417,1445,11.8,1160,9.5,29361,10218,19143,4.6,13.2,30354,9969,20385,4.5,13.6,-993,-0.4,26.4,0,770,790,5084
1995,48620,10490,12439,226711,224209,1389,11.2,1234,10,30370,11285,19085,5,13.5,25366,8329,17037,3.7,11.3,5004,2.2,22.6,0,813,822,4143
1996,48620,10624,12583,234561,230633,1449,11.6,1270,10.2,34818,11178,23640,4.8,15.1,26962,9610,17352,4.2,11.7,7856,3.4,23.4,0,881,881,5751
1997,48620,10666,12784,247752,241261,1600,12.6,1387,10.9,44831,15872,28959,6.6,18.6,31849,12268,19581,5.1,13.2,12982,5.4,26.4,0,854,854,6498
1998,48620,10691,12914,258816,253254,1475,11.5,1308,10.2,44990,14528,30462,5.7,17.8,33865,13320,20545,5.3,13.4,11125,4.4,26.8,0,861,861,5557
1999,48620,10706,12964,260572,259726,1343,10.4,1282,9.9,39837,14299,25538,5.5,15.3,38144,18030,20114,6.9,14.7,1693,0.6,29.4,0,789,789,8438
2000,48620,10715,12973,259773,260280,1358,10.5,1368,10.5,41435,13559,27876,5.2,15.9,42448,16013,26435,6.2,16.3,-1013,-0.4,31.8,0,827,827,4818
2001,48620,10736,13136,259720,260145,1473,11.3,1401,10.7,35236,13592,21644,5.2,13.5,36086,14333,21753,5.5,13.9,-850,-0.4,27,0,841,841,6562
2002,48620,10745,13248,258270,259269,1590,12.1,1465,11.1,40505,16647,23858,6.4,15.6,42503,11847,30656,4.6,16.4,-1998,-0.8,31.2,0,761,761,4744
2003,48620,10787,13302,265733,260223,1469,11.1,1160,8.8,45546,24416,21130,9.4,17.5,34526,12337,22189,4.7,13.3,11020,4.2,26.6,0,792,797,5260
2004,48620,10862,13326,259753,262009,1386,10.4,1218,9.2,31867,12468,19399,4.8,12.2,36378,11838,24540,4.5,13.9,-4511,-1.7,24.4,0,773,773,5336
2005,48620,11003,13548,258905,258836,1457,10.9,1121,8.4,38277,14780,23497,5.7,14.8,38139,18566,19573,7.2,14.7,138,0.1,29.4,0,779,781,5358
2006,48620,10952,13569,259217,257895,1442,10.7,1317,9.7,34845,11593,23252,4.5,13.5,32200,10851,21349,4.2,12.5,2645,1,25,0,885,894,7339
2007,48620,11084,13755,264096,260772,1426,10.5,1206,8.8,38240,14887,23353,5.7,14.7,31591,8904,22687,3.4,12.1,6649,2.6,24.2,0,731,736,4373
2008,48620,11044,13812,274960,268845,1318,9.6,1129,8.2,41058,12316,28742,4.6,15.3,28828,9170,19658,3.4,10.7,12230,4.6,21.4,0,792,793,6395
2009,48620,10888,13631,267127,270539,1046,7.6,1124,8.2,29566,9173,20393,3.4,10.9,36389,7804,28585,2.9,13.5,-6823,-2.6,21.8,0,753,753,5238
2010,48620,10731,13516,254396,259956,1055,7.8,1063,7.9,25436,9017,16419,3.5,9.8,36556,8130,28426,3.1,14.1,-11120,-4.3,19.6,0,728,728,5307
2011,48620,10550,13359,248646,251183,1102,8.2,1131,8.4,28050,10145,17905,4,11.2,33123,8852,24271,3.5,13.2,-5073,-2,22.4,0,717,717,4436
2012,48620,10540,13302,254929,251847,1091,8.2,1146,8.6,33736,12397,21339,4.9,13.4,27571,9303,18268,3.7,10.9,6165,2.5,21.8,0,667,687,4348
2013,48620,10535,13284,259288,256779,1027,7.8,1014,7.7,31092,7212,23880,2.8,12.1,26073,8391,17682,3.3,10.2,5019,1.9,20.4,0,668,669,5716
2014,48620,10455,13227,263906,260917,1064,8.1,1011,7.7,32304,13813,18491,5.3,12.4,26326,8927,17399,3.4,10.1,5978,2.3,20.2,0,683,685,4680
1977,48660,2901,3144,35342,34302,518,16.8,390,12.7,7806,4155,3651,12.1,22.8,5725,2562,3163,7.5,16.7,2081,6.1,33.4,0,287,287,1733
1978,48660,2742,2985,36919,36036,382,12.5,506,16.5,8117,2932,5185,8.1,22.5,6350,4046,2304,11.2,17.6,1767,4.9,35.2,0,293,295,1782
1979,48660,2929,3193,40795,38947,431,14,246,8,9496,4527,4969,11.6,24.4,5799,2283,3516,5.9,14.9,3697,9.5,29.8,0,4,4,78
1980,48660,3053,3311,42895,41924,516,15.9,386,11.9,9058,3869,5189,9.2,21.6,7116,2581,4535,6.2,17,1942,4.6,34,0,263,265,1442
1981,48660,2998,3245,44151,43029,470,14.4,488,14.9,9586,4006,5580,9.3,22.3,7342,3526,3816,8.2,17.1,2244,5.2,34.2,0,312,314,1718
1982,48660,3075,3352,48418,46338,523,15.9,376,11.4,11137,5601,5536,12.1,24,6977,2969,4008,6.4,15.1,4160,8.9,30.2,0,222,222,1489
1983,48660,3137,3431,42012,44971,413,12.2,378,11.1,7407,3970,3437,8.8,16.5,13325,3721,9604,8.3,29.6,-5918,-13.1,33,0,259,260,2651
1984,48660,3213,3513,43359,42673,478,13.8,394,11.3,9074,3685,5389,8.6,21.3,7702,2809,4893,6.6,18,1372,3.3,36,0,270,270,1359
1985,48660,3246,3545,43585,43517,452,12.8,412,11.7,7364,2592,4772,6,16.9,7228,2876,4352,6.6,16.6,136,0.3,33.2,0,294,299,1915
1986,48660,3186,3474,42851,43178,397,11.3,460,13.1,7887,3914,3973,9.1,18.3,8541,3181,5360,7.4,19.8,-654,-1.5,36.6,0,322,322,1787
1987,48660,3099,3425,41768,42713,482,14,497,14.4,7746,4364,3382,10.2,18.1,9635,3749,5886,8.8,22.6,-1889,-4.5,36.2,0,344,345,2025
1988,48660,3022,3353,41766,41589,413,12.2,456,13.5,8064,4371,3693,10.5,19.4,7709,3224,4485,7.8,18.5,355,0.9,37,0,314,314,1610
1989,48660,2958,3289,42324,42111,350,10.5,421,12.7,7090,2810,4280,6.7,16.8,6663,3057,3606,7.3,15.8,427,1,31.6,0,281,281,1671
1990,48660,2912,3238,41947,42075,354,10.8,390,12,6408,2621,3787,6.2,15.2,6664,2615,4049,6.2,15.8,-256,-0.6,30.4,0,271,271,1265
1991,48660,2889,3227,40983,41595,342,10.6,359,11.1,6111,2759,3352,6.6,14.7,7335,3059,4276,7.4,17.6,-1224,-2.9,29.4,0,240,240,1326
1992,48660,2911,3260,42804,41889,386,11.9,345,10.6,8223,4290,3933,10.2,19.6,6392,2691,3701,6.4,15.3,1831,4.3,30.6,0,219,222,1444
1993,48660,2929,3251,44251,43514,330,10.1,327,10,7212,2743,4469,6.3,16.6,5738,2607,3131,6,13.2,1474,3.4,26.4,0,206,212,1268
1994,48660,2973,3312,47170,45730,373,11.4,308,9.4,7620,2874,4746,6.3,16.7,4739,1691,3048,3.7,10.4,2881,6.3,20.8,0,211,212,1052
1995,48660,2980,3305,46853,46726,354,10.7,345,10.4,6087,2230,3857,4.8,13,5833,2228,3605,4.8,12.5,254,0.5,25,0,237,238,1298
1996,48660,3003,3332,49725,48183,380,11.5,338,10.2,7820,3829,3991,7.9,16.2,4736,1584,3152,3.3,9.8,3084,6.4,19.6,0,230,230,845
1997,48660,3052,3399,49652,49676,390,11.6,329,9.8,7370,2852,4518,5.7,14.8,7418,2387,5031,4.8,14.9,-48,-0.1,29.6,0,230,230,1387
1998,48660,3005,3361,48437,48938,337,10,363,10.7,7791,2383,5408,4.9,15.9,8793,4190,4603,8.6,18,-1002,-2.1,31.8,0,256,256,2247
1999,48660,2883,3240,48472,48497,290,8.8,398,12.1,6807,1936,4871,4,14,6857,2437,4420,5,14.1,-50,-0.1,28,0,258,258,1490
2000,48660,2895,3264,48812,48699,361,11.1,342,10.5,7401,2990,4411,6.1,15.2,7175,3009,4166,6.2,14.7,226,0.5,29.4,0,200,200,771
2001,48660,2915,3276,48704,48851,355,10.8,373,11.4,6925,2986,3939,6.1,14.2,7218,2727,4491,5.6,14.8,-293,-0.6,28.4,0,212,212,1112
2002,48660,2923,3310,48820,48764,388,11.8,354,10.8,7684,3384,4300,6.9,15.8,7571,2673,4898,5.5,15.5,113,0.3,31,0,212,212,1207
2003,48660,2918,3296,50110,49162,333,10.1,296,9,7582,2794,4788,5.7,15.4,5685,1773,3912,3.6,11.6,1897,3.8,23.2,0,208,208,732
2004,48660,2904,3282,49814,49823,342,10.4,326,9.9,6415,2388,4027,4.8,12.9,6433,2058,4375,4.1,12.9,-18,0,25.8,0,241,241,971
2005,48660,2873,3268,49959,49744,328,10,303,9.3,6548,2473,4075,5,13.2,6117,2443,3674,4.9,12.3,431,0.9,24.6,0,228,228,1771
2006,48660,2912,3301,51586,50702,333,10.2,263,8,7681,2936,4745,5.8,15.1,5912,1506,4406,3,11.7,1769,3.4,23.4,0,178,178,974
2007,48660,2939,3349,52159,51860,363,10.9,322,9.7,9636,3973,5663,7.7,18.6,9038,3677,5361,7.1,17.4,598,1.2,34.8,0,196,198,1641
2008,48660,2946,3376,52407,51835,309,9.2,252,7.5,7228,2639,4589,5.1,13.9,6084,2073,4011,4,11.7,1144,2.2,23.4,0,185,185,1412
2009,48660,2921,3355,48760,50072,254,7.6,240,7.2,4737,1526,3211,3,9.5,7360,2269,5091,4.5,14.7,-2623,-5.2,19,0,180,180,1195
2010,48660,2901,3310,47453,48058,202,6.1,247,7.4,5463,2448,3015,5.1,11.4,6672,1279,5393,2.7,13.9,-1209,-2.5,22.8,0,156,156,644
2011,48660,2827,3236,48192,47609,226,6.9,251,7.7,6011,2190,3821,4.6,12.6,4845,1304,3541,2.7,10.2,1166,2.4,20.4,0,191,191,933
2012,48660,2856,3249,48580,48243,252,7.8,242,7.5,5846,1692,4154,3.5,12.1,5172,1383,3789,2.9,10.7,674,1.4,21.4,0,137,140,714
2013,48660,2854,3241,48574,48602,211,6.5,237,7.3,4695,1494,3201,3.1,9.7,4751,1106,3645,2.3,9.8,-56,-0.1,19.4,0,164,167,672
2014,48660,2868,3252,48473,48477,262,8.1,233,7.2,5443,1678,3765,3.5,11.2,5450,2299,3151,4.7,11.2,-7,0,22.4,0,171,171,1126
1977,48700,2008,2202,45510,42656,278,12.8,216,9.9,11277,2272,9005,5.3,26.4,5568,1863,3705,4.4,13.1,5709,13.3,26.2,0,137,137,996
1978,48700,2035,2234,41534,43519,263,11.9,225,10.1,6057,1486,4571,3.4,13.9,10027,1238,8789,2.8,23,-3970,-9.1,27.8,0,154,154,543
1979,48700,2043,2261,44038,42754,282,12.6,248,11,6880,1773,5107,4.1,16.1,4312,1514,2798,3.5,10.1,2568,6,20.2,0,181,181,684
1980,48700,2053,2267,40531,42277,224,9.9,214,9.5,4902,1643,3259,3.9,11.6,8393,2886,5507,6.8,19.9,-3491,-8.3,23.2,0,149,149,725
1981,48700,1917,2122,39148,39720,167,7.6,292,13.3,4731,1908,2823,4.8,11.9,5875,2072,3803,5.2,14.8,-1144,-2.9,23.8,0,171,171,754
1982,48700,1925,2154,40163,39625,274,12.8,212,9.9,6603,2419,4184,6.1,16.7,5526,1179,4347,3,13.9,1077,2.8,27.8,0,120,120,560
1983,48700,1974,2184,36960,38553,187,8.6,181,8.3,4253,1354,2899,3.5,11,7439,1025,6414,2.7,19.3,-3186,-8.3,22,0,109,109,665
1984,48700,2058,2267,38264,37586,260,11.7,176,7.9,5233,1844,3389,4.9,13.9,3876,1218,2658,3.2,10.3,1357,3.6,20.6,0,109,110,465
1985,48700,2107,2311,38591,38322,258,11.3,209,9.1,4353,1531,2822,4,11.4,3815,1278,2537,3.3,10,538,1.4,20,0,130,131,665
1986,48700,2170,2372,43572,41018,255,10.9,189,8.1,8564,4330,4234,10.6,20.9,3456,1367,2089,3.3,8.4,5108,12.5,16.8,0,114,114,527
1987,48700,2241,2454,44677,44138,310,12.8,219,9.1,6842,2673,4169,6.1,15.5,5763,1467,4296,3.3,13.1,1079,2.4,26.2,0,139,142,685
1988,48700,2240,2449,45144,44802,250,10.2,236,9.6,6414,1595,4819,3.6,14.3,5729,1655,4074,3.7,12.8,685,1.5,25.6,0,160,160,728
1989,48700,2271,2498,44576,45012,276,11.2,228,9.2,6753,2670,4083,5.9,15,7625,4264,3361,9.5,16.9,-872,-1.9,30,0,148,148,919
1990,48700,2361,2594,45684,45017,291,11.4,186,7.3,6049,2160,3889,4.8,13.4,4714,1399,3315,3.1,10.5,1335,2.9,21,0,123,127,749
1991,48700,2385,2620,43597,44772,242,9.3,215,8.3,4452,1515,2937,3.4,9.9,6802,1976,4826,4.4,15.2,-2350,-5.3,19.8,0,144,150,1222
1992,48700,2372,2625,43806,43636,241,9.2,227,8.6,5744,1513,4231,3.5,13.2,5404,1207,4197,2.8,12.4,340,0.8,24.8,0,160,160,720
1993,48700,2376,2629,43874,43855,227,8.6,214,8.1,4919,1846,3073,4.2,11.2,4880,1481,3399,3.4,11.1,39,0.1,22.2,0,162,162,771
1994,48700,2370,2623,44357,44122,217,8.3,214,8.1,5945,1756,4189,4,13.5,5475,1877,3598,4.3,12.4,470,1.1,24.8,0,145,145,863
1995,48700,2390,2651,44376,44385,256,9.7,223,8.5,5261,1941,3320,4.4,11.9,5278,1212,4066,2.7,11.9,-17,0,23.8,0,146,146,611
1996,48700,2422,2687,46388,45325,255,9.6,219,8.2,7193,2529,4664,5.6,15.9,5066,1633,3433,3.6,11.2,2127,4.7,22.4,0,155,155,749
1997,48700,2398,2663,46195,46191,213,8,233,8.7,5247,1340,3907,2.9,11.4,5239,2185,3054,4.7,11.3,8,0.1,22.6,0,150,150,1172
1998,48700,2385,2664,47176,46622,219,8.2,211,7.9,6366,1567,4799,3.4,13.7,5257,1437,3820,3.1,11.3,1109,2.4,22.6,0,145,145,840
1999,48700,2343,2612,47103,47721,201,7.6,252,9.6,5886,2490,3396,5.2,12.3,7122,4175,2947,8.7,14.9,-1236,-2.6,24.6,0,153,153,828
2000,48700,2332,2602,47981,46984,235,9,244,9.4,7388,3943,3445,8.4,15.7,5393,1676,3717,3.6,11.5,1995,4.2,23,0,140,140,491
2001,48700,2346,2630,45731,47069,240,9.2,224,8.6,5629,2444,3185,5.2,12,8304,1802,6502,3.8,17.6,-2675,-5.6,24,0,129,129,546
2002,48700,2313,2594,45757,45144,220,8.4,256,9.8,7850,2900,4950,6.4,17.4,6623,2668,3955,5.9,14.7,1227,2.7,29.4,0,129,129,1110
2003,48700,2309,2595,45691,45629,217,8.4,195,7.5,5083,1555,3528,3.4,11.1,4958,1017,3941,2.2,10.9,125,0.2,21.8,0,146,146,774
2004,48700,2297,2571,45403,45410,195,7.6,194,7.5,4740,925,3815,2,10.4,4753,1248,3505,2.7,10.5,-13,-0.1,20.8,0,125,125,686
2005,48700,2304,2594,45483,45338,228,8.8,191,7.4,4666,1335,3331,2.9,10.3,4376,1024,3352,2.3,9.7,290,0.6,19.4,0,134,134,619
2006,48700,2274,2590,45987,45694,231,8.9,216,8.3,5215,1437,3778,3.1,11.4,4628,972,3656,2.1,10.1,587,1.3,20.2,0,143,144,710
2007,48700,2299,2631,45979,45974,232,8.9,188,7.2,5453,1707,3746,3.7,11.9,5443,1422,4021,3.1,11.8,10,0.1,23.6,0,111,111,551
2008,48700,2286,2621,46490,46106,182,7,174,6.7,6008,1297,4711,2.8,13,5239,1407,3832,3.1,11.4,769,1.6,22.8,0,115,115,767
2009,48700,2252,2584,43530,44850,175,6.7,190,7.3,3910,1523,2387,3.4,8.7,6550,1548,5002,3.5,14.6,-2640,-5.9,17.4,0,121,122,1196
2010,48700,2247,2590,43965,43619,200,7.8,168,6.5,4621,1623,2998,3.7,10.6,3928,737,3191,1.7,9,693,1.6,18,0,97,97,322
2011,48700,2284,2631,46254,45051,212,8.1,154,5.9,6298,2542,3756,5.6,14,3892,630,3262,1.4,8.6,2406,5.4,17.2,0,104,104,455
2012,48700,2314,2658,46982,46493,209,7.9,179,6.8,6372,2170,4202,4.7,13.7,5393,2012,3381,4.3,11.6,979,2.1,23.2,0,121,121,1338
2013,48700,2311,2650,46724,46825,199,7.5,198,7.5,5273,2109,3164,4.5,11.3,5475,1646,3829,3.5,11.7,-202,-0.4,22.6,0,124,124,1135
2014,48700,2301,2639,46025,46266,176,6.7,159,6,4305,1117,3188,2.4,9.3,4787,1892,2895,4.1,10.3,-482,-1,18.6,0,112,113,1231
1977,48900,2707,2970,39823,39112,535,18.3,417,14.3,7500,3576,3924,9.1,19.2,6078,2798,3280,7.2,15.5,1422,3.7,31,0,301,304,1554
1978,48900,2803,3081,42398,41109,510,16.9,398,13.2,9085,4672,4413,11.4,22.1,6506,3033,3473,7.4,15.8,2579,6.3,31.6,0,283,284,2204
1979,48900,2883,3164,44098,43193,496,15.9,384,12.3,7855,2859,4996,6.6,18.2,6044,2313,3731,5.4,14,1811,4.2,28,0,286,286,1234
1980,48900,2937,3224,45862,44925,501,15.7,420,13.2,8819,3334,5485,7.4,19.6,6944,2447,4497,5.4,15.5,1875,4.1,31,0,312,313,1554
1981,48900,2893,3181,46427,46006,439,13.7,454,14.2,8270,3621,4649,7.9,18,7430,2811,4619,6.1,16.2,840,1.8,32.4,0,276,277,1343
1982,48900,2963,3282,46122,46218,517,16,393,12.2,8500,4449,4051,9.6,18.4,8692,3381,5311,7.3,18.8,-192,-0.4,36.8,0,251,251,1136
1983,48900,2865,3176,46204,45834,412,12.8,472,14.6,8393,3423,4970,7.5,18.3,7652,3532,4120,7.7,16.7,741,1.6,33.4,0,251,254,1403
1984,48900,3351,3693,51992,49266,647,18.8,196,5.7,11390,5291,6099,10.7,23.1,5937,2124,3813,4.3,12.1,5453,11,24.2,0,9,9,26
1985,48900,3643,4024,55467,53843,724,18.8,418,10.8,11183,5199,5984,9.7,20.8,7935,3104,4831,5.8,14.7,3248,6.1,29.4,0,277,277,1469
1986,48900,3868,4265,58357,56879,767,18.5,511,12.3,11617,4909,6708,8.6,20.4,8661,3359,5302,5.9,15.2,2956,5.2,30.4,0,344,355,2135
1987,48900,4147,4618,59646,58995,890,20,511,11.5,11791,5054,6737,8.6,20,10489,4491,5998,7.6,17.8,1302,2.2,35.6,0,332,332,2122
1988,48900,4240,4726,62263,60730,759,16.3,614,13.1,12771,6117,6654,10.1,21,9704,4240,5464,7,16,3067,5,32,0,425,425,2012
1989,48900,4384,4900,64895,63718,691,14.4,519,10.8,12361,4986,7375,7.8,19.4,10006,4261,5745,6.7,15.7,2355,3.7,31.4,0,361,361,2339
1990,48900,4544,5102,70062,67429,718,14.4,475,9.5,14136,5865,8271,8.7,21,8870,2969,5901,4.4,13.2,5266,7.8,26.4,0,335,336,1775
1991,48900,4710,5302,66373,67152,753,14.5,557,10.7,11603,5102,6501,7.6,17.3,13161,4978,8183,7.4,19.6,-1558,-2.3,34.6,0,359,359,2573
1992,48900,4853,5478,70021,68157,778,14.4,572,10.6,14068,5258,8810,7.7,20.6,10339,3835,6504,5.6,15.2,3729,5.4,30.4,0,389,392,2525
1993,48900,5048,5668,72083,71028,724,13,519,9.3,12789,4263,8526,6,18,10679,3594,7085,5.1,15,2110,3,30,0,350,350,1614
1994,48900,5278,5942,74796,73364,875,15.1,574,9.9,14237,6206,8031,8.5,19.4,11373,3961,7412,5.4,15.5,2864,3.9,31,0,392,392,1950
1995,48900,5586,6282,78743,76659,953,15.6,592,9.7,14036,5526,8510,7.2,18.3,9867,3620,6247,4.7,12.9,4169,5.4,25.8,0,406,409,1960
1996,48900,5889,6596,83956,81677,1018,15.8,673,10.5,16242,6822,9420,8.4,19.9,11683,4301,7382,5.3,14.3,4559,5.6,28.6,0,449,449,2482
1997,48900,6246,6998,88260,85997,1204,17.7,814,12,18754,8319,10435,9.7,21.8,14228,5515,8713,6.4,16.5,4526,5.3,33,0,521,521,2653
1998,48900,6488,7235,89530,88885,1123,15.8,875,12.3,15828,7017,8811,7.9,17.8,14537,5503,9034,6.2,16.4,1291,1.4,32.8,0,565,565,2921
1999,48900,6656,7426,97425,95007,1059,14.4,845,11.5,21516,11982,9534,12.6,22.6,16680,8512,8168,9,17.6,4836,5,35.2,0,585,585,2497
2000,48900,6609,7415,101183,99302,960,12.9,972,13.1,18709,7880,10829,7.9,18.8,14947,5603,9344,5.6,15.1,3762,3.7,30.2,0,657,657,3120
2001,48900,6744,7595,103902,102740,1007,13.4,898,12,18467,7582,10885,7.4,18,16143,6056,10087,5.9,15.7,2324,2.3,31.4,0,559,559,2910
2002,48900,6769,7651,100109,101783,1038,13.6,970,12.7,17280,8229,9051,8.1,17,20627,6851,13776,6.7,20.3,-3347,-3.3,34,0,545,545,2596
2003,48900,6977,7898,107917,103533,1095,14.2,695,9,22678,11519,11159,11.1,21.9,13910,5248,8662,5.1,13.4,8768,8.5,26.8,0,508,508,4071
2004,48900,7166,8118,109769,106571,1103,13.8,786,9.8,20277,7914,12363,7.4,19,13880,4985,8895,4.7,13,6397,6,26,0,550,550,3587
2005,48900,7580,8597,112306,110530,1274,15.3,727,8.7,19574,7746,11828,7,17.7,16022,4712,11310,4.3,14.5,3552,3.2,29,0,524,524,3254
2006,48900,7876,8955,117777,114922,1310,15,875,10,24360,9615,14745,8.4,21.2,18649,9633,9016,8.4,16.2,5711,5,32.4,0,662,663,8392
2007,48900,8118,9299,121594,119481,1315,14.4,959,10.5,24865,11235,13630,9.4,20.8,20639,6418,14221,5.4,17.3,4226,3.5,34.6,0,662,662,3638
2008,48900,8015,9238,120105,120151,1087,11.8,1036,11.2,20765,6907,13858,5.7,17.3,20856,6963,13893,5.8,17.4,-91,-0.1,34.6,0,774,774,3689
2009,48900,7546,8772,113214,116335,845,9.4,1214,13.5,16668,9533,7135,8.2,14.3,22909,5857,17052,5,19.7,-6241,-5.4,28.6,0,899,899,3618
2010,48900,7409,8665,110739,111715,886,10.2,967,11.1,14085,5773,8312,5.2,12.6,16037,4938,11099,4.4,14.4,-1952,-1.8,25.2,0,664,664,3475
2011,48900,7307,8605,113087,111573,913,10.6,888,10.3,16661,6337,10324,5.7,14.9,13633,4173,9460,3.7,12.2,3028,2.7,24.4,0,592,592,2727
2012,48900,7436,8733,111934,112260,957,11.1,846,9.8,15199,5329,9870,4.7,13.5,15851,5084,10767,4.5,14.1,-652,-0.6,27,0,516,518,3118
2013,48900,7586,8879,109840,108707,900,10.3,768,8.8,14480,5367,9113,4.9,13.3,12213,4845,7368,4.5,11.2,2267,2.1,22.4,0,491,491,3219
2014,48900,7631,8948,112088,110157,891,10,770,8.7,14856,4884,9972,4.4,13.5,10994,3705,7289,3.4,10,3862,3.5,20,0,538,542,2418
1977,49020,1349,1427,22321,20942,227,16.4,138,10,4758,1611,3147,7.7,22.7,1999,651,1348,3.1,9.5,2759,13.2,19,0,89,89,356
1978,49020,1381,1462,22799,22557,206,14.3,169,11.7,3691,965,2726,4.3,16.4,3207,861,2346,3.8,14.2,484,2.2,28.4,0,123,123,490
1979,49020,1383,1464,23976,23346,173,11.8,160,10.9,3495,972,2523,4.2,15,2235,584,1651,2.5,9.6,1260,5.4,19.2,0,116,117,395
1980,49020,1380,1459,24493,24213,152,10.4,151,10.3,3148,827,2321,3.4,13,2587,741,1846,3.1,10.7,561,2.3,21.4,0,110,110,367
1981,49020,1335,1428,23609,23751,171,11.9,187,13,3098,1058,2040,4.5,13,3382,1238,2144,5.2,14.2,-284,-1.2,26,0,123,123,656
1982,49020,1356,1461,23484,23555,199,13.8,139,9.6,3302,1268,2034,5.4,14,3443,972,2471,4.1,14.6,-141,-0.6,28,0,77,77,423
1983,49020,1431,1541,23428,23499,192,12.8,133,8.9,3899,1374,2525,5.8,16.6,4040,1029,3011,4.4,17.2,-141,-0.6,33.2,0,88,88,367
1984,49020,1424,1536,23627,23436,176,11.4,163,10.6,4009,1778,2231,7.6,17.1,3627,1765,1862,7.5,15.5,382,1.6,31,0,75,75,712
1985,49020,1583,1702,26722,25602,226,13.9,89,5.5,4342,1422,2920,5.6,17,2101,444,1657,1.7,8.2,2241,8.8,16.4,1,2,2,
1986,49020,1684,1812,29126,27923,253,14.4,144,8.2,5051,1452,3599,5.2,18.1,2644,962,1682,3.4,9.5,2407,8.6,19,0,86,86,343
1987,49020,1780,1924,31304,30142,291,15.6,162,8.7,5420,1966,3454,6.5,18,3095,881,2214,2.9,10.3,2325,7.7,20.6,0,90,93,592
1988,49020,1834,1989,29698,29665,281,14.4,204,10.4,4545,1633,2912,5.5,15.3,4479,1771,2708,6,15.1,66,0.2,30.2,0,131,131,670
1989,49020,1907,2067,31999,30847,270,13.3,187,9.2,5357,1946,3411,6.3,17.4,3053,1070,1983,3.5,9.9,2304,7.5,19.8,0,129,130,721
1990,49020,1952,2123,33488,33110,265,12.7,196,9.4,4799,1955,2844,5.9,14.5,4042,1078,2964,3.3,12.2,757,2.3,24.4,0,133,133,647
1991,49020,1960,2148,32640,33061,256,12,214,10,4494,1619,2875,4.9,13.6,5336,1563,3773,4.7,16.1,-842,-2.5,27.2,0,128,128,766
1992,49020,1969,2174,33504,33078,223,10.3,191,8.8,4760,1413,3347,4.3,14.4,3907,812,3095,2.5,11.8,853,2.6,23.6,0,117,117,407
1993,49020,2005,2202,33751,33541,218,10,190,8.7,3889,1298,2591,3.9,11.6,3469,1013,2456,3,10.3,420,1.3,20.6,0,113,113,568
1994,49020,2077,2274,35637,34689,267,11.9,190,8.5,4995,1784,3211,5.1,14.4,3098,923,2175,2.7,8.9,1897,5.5,17.8,0,123,123,431
1995,49020,2115,2323,37218,36448,250,10.9,204,8.9,5842,2066,3776,5.7,16,4302,1398,2904,3.8,11.8,1540,4.2,23.6,0,130,130,816
1996,49020,2135,2350,37094,37012,253,10.8,216,9.2,4456,1730,2726,4.7,12,4291,1132,3159,3.1,11.6,165,0.4,23.2,0,141,141,537
1997,49020,2210,2429,38644,38049,281,11.7,201,8.4,6771,1431,5340,3.8,17.8,5580,2857,2723,7.5,14.7,1191,3.1,29.4,0,120,120,2199
1998,49020,2212,2449,40955,39686,246,10.1,221,9.1,6399,1967,4432,5,16.1,3861,1153,2708,2.9,9.7,2538,6.4,19.4,0,144,144,564
1999,49020,2225,2469,42875,41905,240,9.8,218,8.9,7169,3439,3730,8.2,17.1,5228,1853,3375,4.4,12.5,1941,4.6,25,0,152,152,1090
2000,49020,2255,2518,44389,43631,267,10.7,217,8.7,8222,4543,3679,10.4,18.8,6706,1590,5116,3.6,15.4,1516,3.4,30.8,0,128,128,718
2001,49020,2290,2557,46390,45680,231,9.1,214,8.4,6665,2510,4155,5.5,14.6,5245,1398,3847,3.1,11.5,1420,3.1,23,0,124,124,471
2002,49020,2314,2590,47880,47105,280,10.9,240,9.3,8517,2387,6130,5.1,18.1,6967,1790,5177,3.8,14.8,1550,3.3,29.6,0,134,134,566
2003,49020,2329,2610,48704,48031,257,9.9,201,7.8,7748,2033,5715,4.2,16.1,6402,1932,4470,4,13.3,1346,2.8,26.6,0,124,124,701
2004,49020,2414,2694,46913,47629,310,11.7,197,7.5,6085,1629,4456,3.4,12.8,7516,3828,3688,8,15.8,-1431,-3,25.6,0,131,131,3237
2005,49020,2485,2771,48441,47458,340,12.5,235,8.6,6935,2313,4622,4.9,14.6,4968,1298,3670,2.7,10.5,1967,4.1,21,0,172,172,791
2006,49020,2539,2843,51583,49927,350,12.5,252,9,9143,3394,5749,6.8,18.3,5831,2586,3245,5.2,11.7,3312,6.6,23.4,0,168,168,1871
2007,49020,2593,2919,50243,50821,343,11.9,265,9.2,6756,2220,4536,4.4,13.3,7912,2523,5389,5,15.6,-1156,-2.3,26.6,0,176,177,1004
2008,49020,2592,2919,48952,49478,300,10.3,266,9.2,5250,2228,3022,4.5,10.6,6301,1512,4789,3.1,12.7,-1051,-2.1,21.2,0,199,199,1180
2009,49020,2480,2819,44708,46713,241,8.4,313,10.9,4364,1718,2646,3.7,9.3,8373,1916,6457,4.1,17.9,-4009,-8.6,18.6,0,212,212,1380
2010,49020,2435,2785,43873,44150,240,8.6,260,9.3,4195,1611,2584,3.6,9.5,4748,1180,3568,2.7,10.8,-553,-1.3,19,0,184,184,804
2011,49020,2431,2781,45246,44402,254,9.1,238,8.6,5709,1686,4023,3.8,12.9,4021,1346,2675,3,9.1,1688,3.8,18.2,0,171,171,1048
2012,49020,2474,2824,46958,45988,250,8.9,217,7.7,5945,1982,3963,4.3,12.9,4004,1060,2944,2.3,8.7,1941,4.2,17.4,0,124,124,477
2013,49020,2449,2803,47408,47211,226,8,251,8.9,4818,1267,3551,2.7,10.2,4423,1196,3227,2.5,9.4,395,0.8,18.8,0,165,165,849
2014,49020,2470,2827,48041,47669,244,8.7,201,7.2,4257,1142,3115,2.4,8.9,3513,810,2703,1.7,7.4,744,1.5,14.8,0,145,145,559
1977,49180,4854,5514,113831,112598,874,16.2,639,11.8,17141,5894,11247,5.2,15.2,14674,4275,10399,3.8,13,2467,2.2,26,0,423,424,2537
1978,49180,5044,5742,123927,118257,860,15.3,632,11.2,23531,7035,16496,5.9,19.9,12190,4479,7711,3.8,10.3,11341,9.6,20.6,0,443,443,2378
1979,49180,5122,5831,129339,126533,769,13.3,631,10.9,19196,6474,12722,5.1,15.2,13584,4251,9333,3.4,10.7,5612,4.5,21.4,0,449,454,2406
1980,49180,5164,5878,132308,130836,725,12.4,655,11.2,15760,5108,10652,3.9,12,12815,4137,8678,3.2,9.8,2945,2.2,19.6,0,471,474,2532
1981,49180,5026,5718,138263,134702,698,12,809,14,21597,7349,14248,5.5,16,14474,5846,8628,4.3,10.7,7123,5.3,21.4,0,512,514,2314
1982,49180,5084,5848,139642,138254,818,14.1,643,11.1,18302,7237,11065,5.2,13.2,15526,6258,9268,4.5,11.2,2776,2,22.4,0,396,396,2049
1983,49180,4938,5709,135913,136232,710,12.3,785,13.6,19714,6729,12985,4.9,14.5,20352,8624,11728,6.3,14.9,-638,-0.4,29,0,431,433,2335
1984,49180,5547,6366,146334,141392,886,14.7,346,5.7,25217,7694,17523,5.4,17.8,15333,3434,11899,2.4,10.8,9884,7,21.6,0,11,11,35
1985,49180,5800,6618,154386,151686,908,14,672,10.3,22576,7395,15181,4.9,14.9,17175,5553,11622,3.7,11.3,5401,3.6,22.6,0,419,419,2073
1986,49180,6121,6965,155427,154813,1061,15.6,683,10.1,20326,7452,12874,4.8,13.1,19098,5896,13202,3.8,12.3,1228,0.8,24.6,0,427,427,2675
1987,49180,6329,7287,155394,155463,1103,15.5,763,10.7,24287,9660,14627,6.2,15.6,24425,10694,13731,6.9,15.7,-138,-0.1,31.2,0,506,508,6334
1988,49180,6442,7472,175026,164777,1018,13.8,788,10.7,38109,16175,21934,9.8,23.1,17610,5160,12450,3.1,10.7,20499,12.4,21.4,0,495,495,2607
1989,49180,6630,7748,166363,171923,1065,14,797,10.5,25606,8752,16854,5.1,14.9,36725,5424,31301,3.2,21.4,-11119,-6.5,29.8,0,515,517,2739
1990,49180,6816,7905,163846,164934,1019,13,815,10.4,30646,12921,17725,7.8,18.6,32822,9244,23578,5.6,19.9,-2176,-1.3,37.2,0,532,532,3870
1991,49180,6891,8041,162699,163391,993,12.5,859,10.8,24901,10342,14559,6.3,15.2,26287,6943,19344,4.2,16.1,-1386,-0.9,30.4,0,556,562,3585
1992,49180,6935,8103,166931,164803,980,12.1,897,11.1,26939,7386,19553,4.5,16.3,22683,7457,15226,4.5,13.8,4256,2.5,27.6,0,578,582,4481
1993,49180,7069,8250,169105,167990,935,11.4,767,9.4,22086,6206,15880,3.7,13.1,19855,6018,13837,3.6,11.8,2231,1.3,23.6,0,532,534,2621
1994,49180,7204,8383,170328,169639,976,11.7,823,9.9,23098,8558,14540,5,13.6,21720,5278,16442,3.1,12.8,1378,0.8,25.6,0,570,571,2954
1995,49180,7394,8582,177847,174005,1031,12.2,803,9.5,28103,10046,18057,5.8,16.2,20418,6666,13752,3.8,11.7,7685,4.5,23.4,0,550,550,2927
1996,49180,7545,8747,184621,181369,1013,11.7,844,9.7,28517,12928,15589,7.1,15.7,22012,6505,15507,3.6,12.1,6505,3.6,24.2,0,518,518,2917
1997,49180,7702,8975,189206,186902,1149,13,901,10.2,27726,8708,19018,4.7,14.8,23117,8207,14910,4.4,12.4,4609,2.4,24.8,0,556,556,4489
1998,49180,7762,9080,192138,190675,1079,12,951,10.5,27894,10532,17362,5.5,14.6,24967,9590,15377,5,13.1,2927,1.5,26.2,0,651,651,3588
1999,49180,7812,9157,193923,193290,1040,11.4,943,10.3,26705,9786,16919,5.1,13.8,25439,8867,16572,4.6,13.2,1266,0.6,26.4,0,573,573,2861
2000,49180,7842,9242,193772,193903,1003,10.9,915,9.9,25666,9879,15787,5.1,13.2,25927,9869,16058,5.1,13.4,-261,-0.2,26.4,0,547,547,3524
2001,49180,7885,9336,198541,196431,1075,11.6,1064,11.4,30554,16349,14205,8.3,15.6,26334,8143,18191,4.1,13.4,4220,2.2,26.8,0,619,619,2932
2002,49180,7936,9385,192387,195827,1141,12.2,1076,11.5,26949,12059,14890,6.2,13.8,33828,11825,22003,6,17.3,-6879,-3.5,27.6,0,576,576,4723
2003,49180,7958,9400,191311,190988,1069,11.4,871,9.3,29226,15106,14120,7.9,15.3,28579,11677,16902,6.1,15,647,0.3,30,0,571,571,3996
2004,49180,8029,9440,192116,190932,980,10.4,845,9,25676,7066,18610,3.7,13.4,23307,7337,15970,3.8,12.2,2369,1.2,24.4,0,541,548,3178
2005,49180,8172,9647,192708,191031,1122,11.8,822,8.6,26940,9631,17309,5,14.1,23585,6675,16910,3.5,12.3,3355,1.8,24.6,0,560,560,3561
2006,49180,8235,9795,203935,197642,1116,11.5,866,8.9,33864,15557,18307,7.9,17.1,21278,5845,15433,3,10.8,12586,6.3,21.6,0,593,605,3634
2007,49180,8336,9971,207725,205346,1161,11.8,968,9.8,30749,10753,19996,5.2,15,25990,8926,17064,4.3,12.7,4759,2.3,25.4,0,596,601,3699
2008,49180,8311,9980,208051,207031,933,9.4,833,8.4,24328,6851,17477,3.3,11.8,22288,5908,16380,2.9,10.8,2040,1,21.6,0,609,610,3922
2009,49180,7866,9517,191770,198922,688,7.1,1046,10.8,16133,5391,10742,2.7,8.1,30436,8236,22200,4.1,15.3,-14303,-7.2,16.2,0,716,716,3698
2010,49180,7723,9322,179826,185168,782,8.3,919,9.8,17914,5734,12180,3.1,9.7,28598,5177,23421,2.8,15.4,-10684,-5.7,19.4,0,570,578,2640
2011,49180,7610,9195,180764,177978,782,8.5,835,9,23006,6221,16785,3.5,12.9,17434,5241,12193,2.9,9.8,5572,3.1,19.6,0,547,548,2981
2012,49180,7669,9274,181566,181052,803,8.7,739,8,20761,6262,14499,3.5,11.5,19733,4530,15203,2.5,10.9,1028,0.6,21.8,0,448,448,2746
2013,49180,7660,9323,186678,183607,777,8.4,726,7.8,22645,6142,16503,3.3,12.3,16503,5643,10860,3.1,9,6142,3.3,18,0,461,462,3059
2014,49180,7618,9287,187139,186557,800,8.6,773,8.3,19932,4438,15494,2.4,10.7,18768,5550,13218,3,10.1,1164,0.6,20.2,0,539,541,3290
1977,49340,10567,11774,210614,204199,1466,12.6,1183,10.2,38820,12922,25898,6.3,19,25989,10887,15102,5.3,12.7,12831,6.3,25.4,0,752,758,6157
1978,49340,10731,11927,231452,221081,1319,11.1,1170,9.9,47570,10999,36571,5,21.5,26827,11263,15564,5.1,12.1,20743,9.4,24.2,0,755,757,4881
1979,49340,10778,12016,232742,231976,1307,10.9,1151,9.6,37041,10685,26356,4.6,16,35509,8395,27114,3.6,15.3,1532,0.7,30.6,0,824,827,5126
1980,49340,10813,12029,250944,241771,1188,9.9,1138,9.5,49566,10762,38804,4.5,20.5,31221,10263,20958,4.2,12.9,18345,7.6,25.8,0,775,778,5261
1981,49340,10621,11801,237972,243097,1209,10.2,1340,11.3,40454,15579,24875,6.4,16.6,50704,25458,25246,10.5,20.9,-10250,-4.3,33.2,0,770,774,4424
1982,49340,10746,12061,231739,234992,1491,12.5,1118,9.4,31628,13837,17791,5.9,13.5,38133,9808,28325,4.2,16.2,-6505,-2.7,27,0,621,621,4149
1983,49340,10940,12300,227074,229507,1211,9.9,1061,8.7,29895,9629,20266,4.2,13,34762,9717,25045,4.2,15.1,-4867,-2.1,26,0,722,722,4209
1984,49340,11377,12783,246519,236713,1529,12.2,1045,8.3,44999,15108,29891,6.4,19,25387,9600,15787,4.1,10.7,19612,8.3,21.4,0,710,712,3764
1985,49340,11830,13297,251377,249910,1629,12.5,1123,8.6,41473,13256,28217,5.3,16.6,38539,15600,22939,6.2,15.4,2934,1.2,30.8,0,754,756,7797
1986,49340,12357,13877,261522,256466,1892,13.9,1254,9.2,48175,18635,29540,7.3,18.8,38062,13246,24816,5.2,14.8,10113,4,29.6,0,848,849,7953
1987,49340,12891,14560,264504,263890,2099,14.8,1375,9.7,44621,17313,27308,6.6,16.9,43393,17780,25613,6.7,16.4,1228,0.5,32.8,0,929,931,8716
1988,49340,13257,14972,282396,274669,1995,13.5,1514,10.3,56608,23325,33283,8.5,20.6,41154,13718,27436,5,15,15454,5.6,30,0,1021,1021,6213
1989,49340,13319,15144,286397,284328,1717,11.4,1586,10.5,44324,18819,25505,6.6,15.6,40186,12825,27361,4.5,14.1,4138,1.5,28.2,0,1103,1121,8132
1990,49340,12928,14793,273631,279623,1468,9.8,1658,11.1,37260,11937,25323,4.3,13.3,49243,15916,33327,5.7,17.6,-11983,-4.3,26.6,0,1182,1186,9380
1991,49340,12461,14377,256310,265456,1390,9.5,1762,12.1,32148,11717,20431,4.4,12.1,50439,16151,34288,6.1,19,-18291,-6.9,24.2,0,1087,1097,6847
1992,49340,12244,14204,250237,253485,1427,10,1530,10.7,36143,13379,22764,5.3,14.3,42638,15374,27264,6.1,16.8,-6495,-2.5,28.6,0,971,979,6466
1993,49340,12311,14224,259628,255203,1426,10,1374,9.7,40271,11130,29141,4.4,15.8,31420,11404,20016,4.5,12.3,8851,3.5,24.6,0,907,918,4692
1994,49340,12493,14461,267039,263149,1568,10.9,1271,8.9,38332,11334,26998,4.3,14.6,30552,8597,21955,3.3,11.6,7780,3,23.2,0,874,877,4701
1995,49340,12735,14737,267570,267261,1682,11.5,1367,9.4,38534,13348,25186,5,14.4,37915,12319,25596,4.6,14.2,619,0.2,28.4,0,876,878,5462
1996,49340,12962,14997,268905,268786,1618,10.9,1338,9,36295,12993,23302,4.8,13.5,36056,12521,23535,4.7,13.4,239,0.1,26.8,0,849,849,5185
1997,49340,13180,15270,276172,272513,1682,11.1,1421,9.4,43635,15839,27796,5.8,16,36316,11854,24462,4.3,13.3,7319,2.7,26.6,0,878,878,4614
1998,49340,13281,15390,285266,280369,1533,10,1372,8.9,44586,13419,31167,4.8,15.9,34791,11893,22898,4.2,12.4,9795,3.5,24.8,0,915,915,5529
1999,49340,13369,15523,282483,283853,1530,9.9,1380,8.9,39221,13265,25956,4.7,13.8,41960,17048,24912,6,14.8,-2739,-1,27.6,0,902,902,6327
2000,49340,13345,15552,288969,285579,1465,9.4,1418,9.1,45418,15138,30280,5.3,15.9,38637,12613,26024,4.4,13.5,6781,2.4,27,0,916,916,5201
2001,49340,13800,16065,297882,294427,1664,10.5,1456,9.2,44478,14240,30238,4.8,15.1,37568,12746,24822,4.3,12.8,6910,2.3,25.6,0,836,836,5601
2002,49340,13867,16181,287053,292037,1833,11.4,1700,10.5,41839,17680,24159,6.1,14.3,51807,19728,32079,6.8,17.7,-9968,-3.4,28.6,0,868,868,6108
2003,49340,14165,16518,289637,287390,1892,11.6,1342,8.2,43771,18027,25744,6.3,15.2,39277,12279,26998,4.3,13.7,4494,1.5,27.4,0,878,878,6682
2004,49340,14388,16751,288083,288112,1840,11.1,1464,8.8,38091,12852,25239,4.5,13.2,38149,11310,26839,3.9,13.2,-58,0,26.4,0,1005,1006,5219
2005,49340,14026,16451,289229,287983,1781,10.7,1931,11.7,37240,14346,22894,5,12.9,34748,10565,24183,3.7,12.1,2492,0.8,24.2,0,1473,1474,6401
2006,49340,14041,16572,291003,289536,1828,11.1,1582,9.6,37613,13727,23886,4.7,13,34678,12696,21982,4.4,12,2935,1,24,0,1047,1047,7196
2007,49340,14033,16647,291259,290841,1736,10.5,1648,9.9,42237,12641,29596,4.3,14.5,41401,13065,28336,4.5,14.2,836,0.3,28.4,0,1018,1025,6126
2008,49340,13809,16408,288398,288381,1415,8.6,1532,9.3,35199,10481,24718,3.6,12.2,35165,9802,25363,3.4,12.2,34,0,24.4,0,1088,1088,5680
2009,49340,13288,15874,275788,281161,1251,7.8,1632,10.1,27010,8376,18634,3,9.6,37756,10182,27574,3.6,13.4,-10746,-3.8,19.2,0,1079,1079,6016
2010,49340,13099,15712,267727,269909,1270,8.1,1346,8.5,25574,7957,17617,2.9,9.5,29937,8004,21933,3,11.1,-4363,-1.6,19,0,875,875,5320
2011,49340,13011,15654,271186,268935,1333,8.5,1290,8.2,29524,9241,20283,3.4,11,25021,6724,18297,2.5,9.3,4503,1.7,18.6,0,820,820,3914
2012,49340,13162,15780,277658,273749,1379,8.8,1242,7.9,34398,9123,25275,3.3,12.6,26580,8260,18320,3,9.7,7818,2.9,19.4,0,720,726,4472
2013,49340,13123,15744,280333,278762,1280,8.1,1348,8.6,30694,9215,21479,3.3,11,27551,7892,19659,2.8,9.9,3143,1.1,19.8,0,809,828,4938
2014,49340,13159,15759,283502,280814,1357,8.6,1225,7.8,29369,7345,22024,2.6,10.5,23993,8861,15132,3.2,8.5,5376,2,17,0,807,809,3981
1977,49420,3024,3361,38920,37730,634,19.3,446,13.6,10119,5125,4994,13.6,26.8,7739,3329,4410,8.8,20.5,2380,6.3,41,0,284,285,2012
1978,49420,3113,3443,41576,40224,573,16.8,494,14.5,9912,2942,6970,7.3,24.6,7207,3483,3724,8.7,17.9,2705,6.7,35.8,0,308,309,1894
1979,49420,3163,3505,43094,42270,551,15.9,455,13.1,9143,3624,5519,8.6,21.6,7494,3058,4436,7.2,17.7,1649,3.9,35.4,0,297,298,1217
1980,49420,3176,3514,43022,43023,489,13.9,461,13.1,8154,3456,4698,8,19,8156,2676,5480,6.2,19,-2,0,38,0,316,318,1545
1981,49420,3001,3318,39292,39454,383,11.3,508,14.9,7638,2381,5257,6,19.4,7961,3258,4703,8.3,20.2,-323,-0.8,38.8,0,287,287,1207
1982,49420,3020,3383,38612,39023,472,14.1,380,11.3,7066,3856,3210,9.9,18.1,7888,1963,5925,5,20.2,-822,-2.1,36.2,0,222,223,1121
1983,49420,3089,3448,39650,39045,412,12.1,380,11.1,7270,2524,4746,6.5,18.6,6059,1897,4162,4.9,15.5,1211,3.1,31,0,239,245,1001
1984,49420,3205,3573,41295,40408,484,13.8,354,10.1,8593,3672,4921,9.1,21.3,6818,2292,4526,5.7,16.9,1775,4.4,33.8,0,225,225,1063
1985,49420,3266,3636,43778,43804,456,12.6,425,11.8,7329,2743,4586,6.3,16.7,7380,2417,4963,5.5,16.8,-51,-0.1,33.4,0,266,266,1325
1986,49420,3292,3664,43670,43679,463,12.7,413,11.3,7547,2514,5033,5.8,17.3,7564,2745,4819,6.3,17.3,-17,0,34.6,0,248,249,1731
1987,49420,3346,3697,46175,44859,508,13.8,453,12.3,9684,3318,6366,7.4,21.6,7051,2962,4089,6.6,15.7,2633,5.9,31.4,0,270,279,1649
1988,49420,3359,3729,45077,44216,469,12.7,392,10.6,8617,3339,5278,7.6,19.5,6894,2492,4402,5.6,15.6,1723,3.9,31.2,0,235,235,1230
1989,49420,2797,3165,61000,53086,355,10.3,925,26.8,26175,2690,23485,5.1,49.3,10346,6944,3402,13.1,19.5,15829,29.8,39,0,264,264,1301
1990,49420,3448,3841,50701,55805,966,27.6,281,8,14087,8824,5263,15.8,25.2,24294,1733,22561,3.1,43.5,-10207,-18.3,50.4,0,192,192,1163
1991,49420,3516,3929,51369,51365,463,11.9,375,9.7,8809,2575,6234,5,17.1,8801,2727,6074,5.3,17.1,8,0,34.2,0,224,225,1907
1992,49420,3600,4016,53159,52237,510,12.8,402,10.1,10058,2925,7133,5.6,19.3,8213,2440,5773,4.7,15.7,1845,3.6,31.4,0,239,259,1389
1993,49420,3667,4092,53585,53261,440,10.9,361,8.9,8955,3107,5848,5.8,16.8,8307,3056,5251,5.7,15.6,648,1.2,31.2,0,242,242,1561
1994,49420,3757,4193,56124,54802,531,12.8,402,9.7,10181,3351,6830,6.1,18.6,7536,2633,4903,4.8,13.8,2645,4.8,27.6,0,274,274,1463
1995,49420,3752,4197,56370,56147,451,10.8,409,9.8,8620,3168,5452,5.6,15.4,8173,2358,5815,4.2,14.6,447,0.8,29.2,0,284,284,1513
1996,49420,3770,4204,56388,56392,447,10.6,438,10.4,8050,2620,5430,4.6,14.3,8057,2503,5554,4.4,14.3,-7,0,28.6,0,276,276,1375
1997,49420,3813,4239,58917,57550,502,11.9,467,11.1,11082,4071,7011,7.1,19.3,8347,2718,5629,4.7,14.5,2735,4.8,29,0,287,287,1190
1998,49420,3835,4261,57781,57896,496,11.7,457,10.8,8855,2789,6066,4.8,15.3,9085,3166,5919,5.5,15.7,-230,-0.4,30.6,0,292,292,1546
1999,49420,3809,4243,59968,58950,432,10.2,441,10.4,10310,4133,6177,7,17.5,8273,2835,5438,4.8,14,2037,3.5,28,0,281,281,1309
2000,49420,3750,4195,59085,58908,431,10.2,478,11.3,8298,2749,5549,4.7,14.1,7944,2882,5062,4.9,13.5,354,0.6,27,0,284,284,1859
2001,49420,3712,4174,59180,59438,419,10,500,11.9,7544,2811,4733,4.7,12.7,8059,2780,5279,4.7,13.6,-515,-0.9,25.4,0,281,281,1376
2002,49420,3690,4142,57794,58565,479,11.5,500,12,8540,3310,5230,5.7,14.6,10082,3248,6834,5.5,17.2,-1542,-2.6,29.2,0,267,267,1338
2003,49420,3705,4151,57967,57313,469,11.4,377,9.2,8216,2763,5453,4.8,14.3,6908,2086,4822,3.6,12.1,1308,2.2,24.2,0,254,254,1488
2004,49420,3729,4181,59581,58500,420,10.1,351,8.4,8562,2940,5622,5,14.6,6399,2163,4236,3.7,10.9,2163,3.7,21.8,0,232,232,1144
2005,49420,3808,4279,60805,60062,461,10.9,342,8.1,8839,2924,5915,4.9,14.7,7352,2315,5037,3.9,12.2,1487,2.5,24.4,0,238,238,1567
2006,49420,3821,4308,63606,62099,470,11,410,9.6,10345,2803,7542,4.5,16.7,7331,2318,5013,3.7,11.8,3014,4.9,23.6,0,273,273,1681
2007,49420,3888,4392,62793,62798,449,10.3,366,8.4,8935,2649,6286,4.2,14.2,8945,2427,6518,3.9,14.2,-10,0,28.4,0,231,231,1499
2008,49420,3832,4370,64878,63503,404,9.3,384,8.8,9434,2986,6448,4.7,14.9,6684,1640,5044,2.6,10.5,2750,4.4,21,0,287,287,1195
2009,49420,3733,4263,62338,63409,347,8.1,417,9.7,6803,2288,4515,3.6,10.7,8945,2764,6181,4.4,14.1,-2142,-3.4,21.4,0,296,296,2245
2010,49420,3707,4254,61463,61855,337,7.9,340,8,7092,2143,4949,3.5,11.5,7875,2411,5464,3.9,12.7,-783,-1.2,23,0,214,214,1334
2011,49420,3664,4198,61216,61244,327,7.8,361,8.6,6398,1852,4546,3,10.4,6454,1612,4842,2.6,10.5,-56,-0.1,20.8,0,242,244,1179
2012,49420,3645,4174,61868,61530,369,8.8,400,9.6,7654,2037,5617,3.3,12.4,6977,1750,5227,2.8,11.3,677,1.1,22.6,0,234,236,876
2013,49420,3650,4195,62560,61934,349,8.4,334,8,7212,2207,5005,3.6,11.6,5960,1568,4392,2.5,9.6,1252,2,19.2,0,215,215,1019
2014,49420,3643,4207,62991,62656,367,8.8,334,8,6805,2081,4724,3.3,10.9,6135,1480,4655,2.4,9.8,670,1.1,19.6,0,217,217,878
1977,49620,4886,5494,105008,103489,728,13.5,531,9.8,15372,6342,9030,6.1,14.9,12333,4880,7453,4.7,11.9,3039,3,23.8,0,339,341,3060
1978,49620,4984,5611,110761,107883,645,11.6,524,9.4,18707,6523,12184,6,17.3,12951,5982,6969,5.5,12,5756,5.3,24,0,341,342,3315
1979,49620,5067,5708,121803,116236,622,11,504,8.9,21629,5692,15937,4.9,18.6,10495,3680,6815,3.2,9,11134,9.6,18,0,368,371,2488
1980,49620,5034,5676,124571,123157,532,9.3,550,9.7,16011,3904,12107,3.2,13,13183,4004,9179,3.3,10.7,2828,2.3,21.4,0,402,403,2059
1981,49620,4870,5519,120183,122127,507,9.1,608,10.9,17399,8938,8461,7.3,14.2,21286,8325,12961,6.8,17.4,-3887,-3.2,28.4,0,360,360,2421
1982,49620,4850,5597,117959,119229,660,11.9,497,8.9,14328,5986,8342,5,12,16867,5648,11219,4.7,14.1,-2539,-2.1,24,0,290,291,1206
1983,49620,4941,5697,111986,114990,525,9.3,488,8.6,14010,4895,9115,4.3,12.2,20018,7278,12740,6.3,17.4,-6008,-5.2,24.4,0,324,325,1814
1984,49620,5180,5949,119869,115913,766,13.2,517,8.9,20123,7644,12479,6.6,17.4,12210,3999,8211,3.5,10.5,7913,6.9,21,0,327,332,2237
1985,49620,5319,6080,123880,121989,701,11.7,573,9.5,18678,6142,12536,5,15.3,14895,5622,9273,4.6,12.2,3783,3.1,24.4,0,358,358,2176
1986,49620,5557,6327,128137,125974,806,13,548,8.8,18757,6626,12131,5.3,14.9,14430,4300,10130,3.4,11.5,4327,3.4,23,0,344,344,2131
1987,49620,5753,6602,129863,129047,881,13.6,595,9.2,19421,8307,11114,6.4,15,17788,6843,10945,5.3,13.8,1633,1.2,27.6,0,387,389,3680
1988,49620,5897,6788,136395,132951,820,12.3,612,9.1,22522,7183,15339,5.4,16.9,15634,5518,10116,4.2,11.8,6888,5.1,23.6,0,385,385,2076
1989,49620,5991,6934,138410,137238,779,11.4,634,9.2,20807,7290,13517,5.3,15.2,18462,5835,12627,4.3,13.5,2345,1.7,27,0,431,434,3157
1990,49620,6050,7030,139655,138904,719,10.3,595,8.5,18651,5795,12856,4.2,13.4,17148,5625,11523,4,12.3,1503,1.1,24.6,0,421,421,3099
1991,49620,6129,7140,137556,138683,716,10.1,602,8.5,17871,7789,10082,5.6,12.9,20125,6281,13844,4.5,14.5,-2254,-1.6,25.8,0,396,398,2968
1992,49620,6105,7131,136210,136906,668,9.3,656,9.2,16567,5182,11385,3.8,12.1,17959,5082,12877,3.7,13.1,-1392,-1,24.2,0,453,455,3023
1993,49620,6125,7156,139704,137945,584,8.2,549,7.7,18396,6010,12386,4.4,13.3,14878,4174,10704,3,10.8,3518,2.5,21.6,0,382,382,2068
1994,49620,6120,7169,141357,140469,623,8.7,582,8.1,18813,6282,12531,4.5,13.4,17036,5585,11451,4,12.1,1777,1.3,24.2,0,406,406,2472
1995,49620,6201,7260,147269,144277,716,9.9,597,8.3,19921,6489,13432,4.5,13.8,13936,4713,9223,3.3,9.7,5985,4.1,19.4,0,413,416,2531
1996,49620,6231,7323,148566,148050,694,9.5,629,8.6,18339,5650,12689,3.8,12.4,17306,5370,11936,3.6,11.7,1033,0.7,23.4,0,402,402,2278
1997,49620,6267,7400,146595,147570,754,10.2,683,9.3,18614,5387,13227,3.7,12.6,20564,8293,12271,5.6,13.9,-1950,-1.3,25.2,0,399,399,2781
1998,49620,6285,7475,150087,148380,718,9.7,638,8.6,19574,7022,12552,4.7,13.2,16159,4962,11197,3.3,10.9,3415,2.3,21.8,0,426,426,2829
1999,49620,6334,7551,150032,150028,696,9.3,621,8.3,17611,5123,12488,3.4,11.7,17602,5832,11770,3.9,11.7,9,0,23.4,0,401,401,2117
2000,49620,6298,7509,154380,152281,688,9.1,725,9.6,21904,6471,15433,4.2,14.4,17706,7737,9969,5.1,11.6,4198,2.8,23.2,0,424,424,2652
2001,49620,6422,7683,157527,156461,764,10,645,8.5,20640,8160,12480,5.2,13.2,18507,5228,13279,3.3,11.8,2133,1.4,23.6,0,381,381,2534
2002,49620,6483,7742,155851,156480,763,9.9,686,8.9,20959,8288,12671,5.3,13.4,22217,6944,15273,4.4,14.2,-1258,-0.8,26.8,0,368,368,2390
2003,49620,6476,7756,154458,153636,702,9.1,569,7.4,18668,5340,13328,3.5,12.2,17024,5336,11688,3.5,11.1,1644,1.1,22.2,0,400,400,3535
2004,49620,6531,7796,155981,154558,719,9.3,599,7.7,19190,7227,11963,4.7,12.4,16343,5108,11235,3.3,10.6,2847,1.8,21.2,0,401,401,2265
2005,49620,6581,7873,159217,157064,746,9.5,589,7.5,20895,6963,13932,4.4,13.3,16589,5721,10868,3.6,10.6,4306,2.7,21.2,0,408,408,3224
2006,49620,6622,7952,160599,159735,784,9.9,661,8.4,18230,6462,11768,4,11.4,16501,5638,10863,3.5,10.3,1729,1.1,20.6,0,450,459,3873
2007,49620,6723,8055,162906,161489,841,10.5,714,8.9,21731,8092,13639,5,13.5,18897,6926,11971,4.3,11.7,2834,1.8,23.4,0,445,455,2964
2008,49620,6677,8104,166460,164299,723,9,621,7.7,20788,6455,14333,3.9,12.7,16466,3918,12548,2.4,10,4322,2.7,20,0,453,454,2498
2009,49620,6552,8001,157439,161597,599,7.5,650,8.1,14545,4163,10382,2.6,9,22861,5567,17294,3.4,14.1,-8316,-5.1,18,0,438,439,2886
2010,49620,6430,7918,152590,154341,578,7.3,608,7.7,14772,5388,9384,3.5,9.6,18274,4383,13891,2.8,11.8,-3502,-2.2,19.2,0,402,402,2643
2011,49620,6417,7910,155586,153709,618,7.8,546,6.9,17205,5352,11853,3.5,11.2,13450,2850,10600,1.9,8.8,3755,2.4,17.6,0,358,358,1659
2012,49620,6453,7973,159181,157166,622,7.8,557,7,19692,6287,13405,4,12.5,15661,4791,10870,3,10,4031,2.5,20,0,358,360,2267
2013,49620,6459,7981,159523,159302,563,7.1,554,7,15388,3731,11657,2.3,9.7,14946,4378,10568,2.7,9.4,442,0.3,18.8,0,349,350,2515
2014,49620,6412,7955,160675,159478,586,7.4,531,6.7,16336,4364,11972,2.7,10.2,13942,3610,10332,2.3,8.7,2394,1.5,17.4,0,377,380,2276
1977,49660,9453,10987,240410,224098,1528,14.1,1180,10.9,59681,17013,42668,7.6,26.6,27057,8551,18506,3.8,12.1,32624,14.5,24.2,0,745,745,4273
1978,49660,9636,11192,220682,230572,1312,11.8,1120,10.1,32380,8946,23434,3.9,14,52159,8286,43873,3.6,22.6,-19779,-8.6,28,0,736,736,3385
1979,49660,9786,11318,227550,223967,1297,11.5,1129,10,34349,9852,24497,4.4,15.3,27182,8729,18453,3.9,12.1,7167,3.2,24.2,0,744,745,3843
1980,49660,9778,11310,221240,224295,1165,10.3,1123,9.9,25490,10252,15238,4.6,11.4,31602,9700,21902,4.3,14.1,-6112,-2.7,22.8,0,763,767,3839
1981,49660,9361,10824,206875,211112,1015,9.2,1402,12.7,26946,11220,15726,5.3,12.8,35421,13876,21545,6.6,16.8,-8475,-4,25.6,0,800,801,4207
1982,49660,9248,10828,194736,200649,1246,11.5,1097,10.1,24578,10851,13727,5.4,12.2,36404,7681,28723,3.8,18.1,-11826,-5.9,24.4,0,615,615,3430
1983,49660,9314,10822,182976,188896,999,9.2,1122,10.4,25563,9063,16500,4.8,13.5,37402,11400,26002,6,19.8,-11839,-6.3,27,0,674,681,4870
1984,49660,9528,11032,192898,188206,1243,11.4,1055,9.7,30593,9855,20738,5.2,16.3,21208,8481,12727,4.5,11.3,9385,5,22.6,0,635,636,3017
1985,49660,9690,11154,193279,193110,1272,11.5,1140,10.3,26235,9644,16591,5,13.6,25896,11208,14688,5.8,13.4,339,0.2,26.8,0,710,715,4534
1986,49660,9961,11442,196049,194584,1352,12,1030,9.1,27500,11539,15961,5.9,14.1,24570,8561,16009,4.4,12.6,2930,1.5,25.2,0,664,664,4425
1987,49660,10062,11668,196257,197023,1479,12.8,1214,10.5,28828,11855,16973,6,14.6,30362,11640,18722,5.9,15.4,-1534,-0.8,29.2,0,762,777,5573
1988,49660,10172,11825,204637,200470,1363,11.6,1195,10.2,31506,11753,19753,5.9,15.7,23172,8668,14504,4.3,11.6,8334,4.1,23.2,0,748,748,3377
1989,49660,10270,11958,216096,210722,1310,11,1183,9.9,35268,12768,22500,6.1,16.7,24520,9435,15085,4.5,11.6,10748,5.1,23.2,0,804,806,5581
1990,49660,10302,12028,218168,216486,1190,9.9,1082,9,29934,10896,19038,5,13.8,26569,9665,16904,4.5,12.3,3365,1.5,24.6,0,754,759,5785
1991,49660,10390,12179,211569,214828,1253,10.4,1106,9.1,26012,10160,15852,4.7,12.1,32529,14123,18406,6.6,15.1,-6517,-3,24.2,0,702,706,9327
1992,49660,10396,12235,213026,212028,1239,10.1,1141,9.3,28193,8872,19321,4.2,13.3,26197,8096,18101,3.8,12.4,1996,0.9,24.8,0,738,749,4184
1993,49660,10505,12296,213216,213838,1108,9,1032,8.4,27664,8728,18936,4.1,12.9,28907,7331,21576,3.4,13.5,-1243,-0.6,25.8,0,664,669,3642
1994,49660,10592,12420,215129,213760,1168,9.5,992,8,28530,10515,18015,4.9,13.3,25792,7501,18291,3.5,12.1,2738,1.2,24.2,0,644,647,3700
1995,49660,10734,12583,220381,217756,1201,9.6,1008,8.1,28753,9469,19284,4.3,13.2,23502,7243,16259,3.3,10.8,5251,2.4,21.6,0,648,650,4072
1996,49660,10848,12717,220689,220637,1218,9.6,1086,8.6,29524,12371,17153,5.6,13.4,29420,9390,20030,4.3,13.3,104,0.1,26.6,0,713,713,3650
1997,49660,10967,12887,226397,223791,1382,10.8,1207,9.4,34054,12080,21974,5.4,15.2,28842,11514,17328,5.1,12.9,5212,2.3,25.8,0,751,751,4542
1998,49660,10969,12912,228607,227610,1225,9.5,1201,9.3,31824,10877,20947,4.8,14,29829,11280,18549,5,13.1,1995,0.9,26.2,0,774,774,6527
1999,49660,10910,12848,223163,225627,1177,9.1,1210,9.4,29318,10933,18385,4.8,13,34245,10909,23336,4.8,15.2,-4927,-2.2,26,0,762,762,5072
2000,49660,10875,12890,232258,227867,1181,9.2,1144,8.9,36927,10937,25990,4.8,16.2,28145,8759,19386,3.8,12.4,8782,3.8,24.8,0,686,686,5137
2001,49660,10789,12850,221438,227045,1093,8.5,1214,9.4,24204,8894,15310,3.9,10.7,35417,11446,23971,5,15.6,-11213,-4.9,21.4,0,722,722,4131
2002,49660,10669,12750,210926,215764,1212,9.5,1272,10,30857,12752,18105,5.9,14.3,40533,11167,29366,5.2,18.8,-9676,-4.5,28.6,0,676,678,4006
2003,49660,10616,12687,212213,209820,1143,9,1016,8,30218,9981,20237,4.8,14.4,25431,8821,16610,4.2,12.1,4787,2.3,24.2,0,681,683,5166
2004,49660,10616,12714,213592,212372,1141,9,996,7.9,26376,7867,18509,3.7,12.4,23936,6740,17196,3.2,11.3,2440,1.1,22.6,0,660,660,4227
2005,49660,10561,12706,214662,213494,1112,8.8,1018,8,29781,14426,15355,6.8,13.9,27445,7411,20034,3.5,12.9,2336,1,25.8,0,698,698,4377
2006,49660,10380,12554,211909,213162,1089,8.6,1164,9.2,26385,9418,16967,4.4,12.4,28890,10224,18666,4.8,13.6,-2505,-1.2,24.8,0,777,777,5115
2007,49660,10330,12534,212882,212051,1127,9,1117,8.9,27944,9620,18324,4.5,13.2,26281,7879,18402,3.7,12.4,1663,0.8,24.8,0,680,690,4350
2008,49660,10197,12382,210540,211142,1003,8.1,1046,8.4,26960,10924,16036,5.2,12.8,28163,6990,21173,3.3,13.3,-1203,-0.5,25.6,0,746,747,4986
2009,49660,9809,11950,194623,201969,765,6.3,1113,9.2,20072,6956,13116,3.4,9.9,34764,8524,26240,4.2,17.2,-14692,-7.3,19.8,0,739,742,5023
2010,49660,9646,11787,196779,195211,808,6.8,888,7.5,26673,12063,14610,6.2,13.7,23536,5991,17545,3.1,12.1,3137,1.6,24.2,0,589,589,3949
2011,49660,9454,11608,198963,197551,799,6.8,888,7.6,22992,5759,17233,2.9,11.6,20167,5757,14410,2.9,10.2,2825,1.4,20.4,0,591,591,3994
2012,49660,9399,11576,203307,201002,871,7.5,911,7.9,25111,7002,18109,3.5,12.5,20500,7016,13484,3.5,10.2,4611,2.3,20.4,0,536,540,3200
2013,49660,9330,11477,201417,202013,697,6.1,787,6.8,22570,7433,15137,3.7,11.2,23762,5870,17892,2.9,11.8,-1192,-0.6,22.4,0,514,514,3227
2014,49660,9226,11411,210805,205733,799,7,806,7.1,30334,7314,23020,3.6,14.7,20189,6376,13813,3.1,9.8,10145,4.9,19.6,0,547,548,3570
1977,49700,1525,1609,15193,14472,298,19.1,201,12.9,3770,1560,2210,10.8,26.1,2328,1044,1284,7.2,16.1,1442,10,32.2,0,130,130,594
1978,49700,1566,1659,16221,15713,307,18.8,264,16.2,4061,1650,2411,10.5,25.8,3045,1947,1098,12.4,19.4,1016,6.4,38.8,0,170,170,780
1979,49700,1683,1777,18003,17089,365,21.2,231,13.4,4642,2357,2285,13.8,27.2,2813,1108,1705,6.5,16.5,1829,10.7,33,0,167,167,659
1980,49700,1749,1848,17915,17894,327,18,239,13.2,3556,1532,2024,8.6,19.9,3513,1582,1931,8.8,19.6,43,0.3,39.2,0,168,168,1122
1981,49700,1683,1780,17631,17569,251,13.9,299,16.5,3286,1445,1841,8.2,18.7,3161,1487,1674,8.5,18,125,0.7,36,0,187,187,807
1982,49700,1693,1828,20971,19311,298,16.5,223,12.3,6878,5212,1666,27,35.6,3557,1154,2403,6,18.4,3321,17.2,36.8,0,109,109,601
1983,49700,1737,1877,18213,19567,238,12.8,208,11.2,3575,1647,1928,8.4,18.3,6283,1042,5241,5.3,32.1,-2708,-13.8,36.6,0,132,132,495
1984,49700,1794,1938,19180,18765,275,14.4,208,10.9,3650,1517,2133,8.1,19.5,2820,1026,1794,5.5,15,830,4.5,30,0,127,127,541
1985,49700,1847,1978,19637,19569,275,14,249,12.7,3540,1281,2259,6.5,18.1,3404,1487,1917,7.6,17.4,136,0.7,34.8,0,156,156,693
1986,49700,1883,2008,19915,19764,279,14,240,12,3830,1840,1990,9.3,19.4,3527,1268,2259,6.4,17.8,303,1.6,35.6,0,152,152,615
1987,49700,1919,2037,21277,20559,301,14.9,255,12.6,4819,2239,2580,10.9,23.4,3382,1163,2219,5.7,16.5,1437,6.9,33,0,156,159,621
1988,49700,1915,2033,21015,20950,269,13.3,251,12.4,4583,1799,2784,8.6,21.9,4453,2215,2238,10.6,21.3,130,0.6,42.6,0,163,163,1124
1989,49700,1779,1894,20642,20825,256,13,391,19.9,4018,1711,2307,8.2,19.3,4383,2142,2241,10.3,21,-365,-1.7,38.6,0,147,147,890
1990,49700,2024,2165,23904,22259,443,21.8,164,8.1,5957,2871,3086,12.9,26.8,2666,972,1694,4.4,12,3291,14.8,24,0,109,109,568
1991,49700,2094,2239,23428,23606,305,13.9,233,10.6,4142,1809,2333,7.7,17.5,4498,1164,3334,4.9,19.1,-356,-1.6,35,0,121,122,619
1992,49700,2098,2238,23518,23486,296,13.2,282,12.6,4618,2109,2509,9,19.7,4553,1723,2830,7.3,19.4,65,0.3,38.8,0,179,181,943
1993,49700,2068,2207,23493,23483,255,11.5,265,11.9,4195,1473,2722,6.3,17.9,4175,1381,2794,5.9,17.8,20,0.1,35.6,0,188,188,1002
1994,49700,2029,2176,23157,23299,249,11.4,264,12,4090,1677,2413,7.2,17.6,4374,1926,2448,8.3,18.8,-284,-1.2,35.2,0,169,169,879
1995,49700,2006,2159,22763,22771,248,11.5,244,11.3,3170,994,2176,4.4,13.9,3185,1011,2174,4.4,14,-15,-0.1,27.8,0,160,160,642
1996,49700,2018,2173,24847,23831,227,10.5,205,9.5,4715,1275,3440,5.4,19.8,2682,995,1687,4.2,11.3,2033,8.5,22.6,0,135,135,602
1997,49700,1994,2155,27417,26361,260,12,283,13.1,6846,1367,5479,5.2,26,4733,2071,2662,7.9,18,2113,8,36,0,177,177,861
1998,49700,1965,2134,25845,26630,237,11.1,250,11.7,4812,1921,2891,7.2,18.1,6381,1540,4841,5.8,24,-1569,-5.9,36.2,0,159,159,796
1999,49700,1957,2139,25906,25700,245,11.5,235,11,4388,1589,2799,6.2,17.1,3976,1339,2637,5.2,15.5,412,1.6,31,0,145,145,536
2000,49700,1984,2168,25790,25870,268,12.4,239,11.1,4261,1683,2578,6.5,16.5,4420,2027,2393,7.8,17.1,-159,-0.6,33,0,127,127,1002
2001,49700,2038,2223,26245,26116,266,12.1,243,11,4362,1991,2371,7.6,16.7,4103,2032,2071,7.8,15.7,259,1,31.4,0,130,130,859
2002,49700,2072,2254,27740,26986,303,13.5,271,12.1,5282,1889,3393,7,19.6,3773,1199,2574,4.4,14,1509,5.6,28,0,160,160,654
2003,49700,2092,2273,29771,28515,306,13.6,251,11.1,6213,3524,2689,12.4,21.8,3700,1368,2332,4.8,13,2513,8.8,26,0,168,168,938
2004,49700,2117,2302,31301,30441,303,13.3,244,10.7,5770,2237,3533,7.3,19,4049,1276,2773,4.2,13.3,1721,5.7,26.6,0,171,171,757
2005,49700,2119,2324,29857,29611,291,12.6,243,10.5,4712,1586,3126,5.4,15.9,4219,1873,2346,6.3,14.2,493,1.7,28.4,0,167,167,1378
2006,49700,2139,2361,31586,30406,322,13.8,259,11.1,6227,2101,4126,6.9,20.5,3866,1352,2514,4.4,12.7,2361,7.8,25.4,0,181,181,1003
2007,49700,2190,2433,31755,31654,328,13.7,256,10.7,5275,2217,3058,7,16.7,5073,1352,3721,4.3,16,202,0.7,32,0,184,186,743
2008,49700,2153,2388,31370,31331,252,10.5,264,11,4972,1737,3235,5.5,15.9,4894,1522,3372,4.9,15.6,78,0.3,31.2,0,172,172,940
2009,49700,2087,2317,28205,29380,236,10.1,302,12.9,2855,1079,1776,3.7,9.7,5205,1278,3927,4.3,17.7,-2350,-8,19.4,0,213,213,947
2010,49700,2024,2243,28263,28621,217,9.5,265,11.7,3623,1071,2552,3.7,12.7,4339,1793,2546,6.3,15.2,-716,-2.5,25.4,0,171,171,769
2011,49700,1987,2218,26977,27702,223,10,220,9.9,3243,1298,1945,4.7,11.7,4692,1175,3517,4.2,16.9,-1449,-5.2,23.4,0,153,153,588
2012,49700,1993,2225,27585,27224,221,10,220,9.9,4291,1773,2518,6.5,15.8,3568,1176,2392,4.3,13.1,723,2.7,26.2,0,128,128,790
2013,49700,1995,2233,28939,28280,204,9.2,209,9.4,4218,1377,2841,4.9,14.9,2900,894,2006,3.2,10.3,1318,4.6,20.6,0,132,132,527
2014,49700,2021,2264,29194,29030,250,11.2,203,9.1,3666,1132,2534,3.9,12.6,3337,1089,2248,3.8,11.5,329,1.1,23,0,149,149,663
1977,49740,1332,1451,13684,13045,268,19,186,13.2,3560,1777,1783,13.6,27.3,2282,1055,1227,8.1,17.5,1278,9.8,35,0,134,134,729
1978,49740,1245,1373,14888,14250,210,14.9,267,18.9,4022,1570,2452,11,28.2,2746,1498,1248,10.5,19.3,1276,8.9,38.6,0,157,157,863
1979,49740,1373,1505,16272,15637,254,17.6,131,9.1,4283,1716,2567,11,27.4,3013,1042,1971,6.7,19.3,1270,8.1,38.6,0,5,6,21
1980,49740,1423,1560,16277,16272,274,17.9,212,13.8,3504,1876,1628,11.5,21.5,3493,1274,2219,7.8,21.5,11,0,43,0,139,139,706
1981,49740,1415,1542,16100,15917,230,14.9,231,14.9,3678,1345,2333,8.5,23.1,3312,1581,1731,9.9,20.8,366,2.3,41.6,0,147,148,1061
1982,49740,1479,1637,16712,16368,301,18.9,187,11.7,4019,2429,1590,14.8,24.6,3330,924,2406,5.6,20.3,689,4.3,40.6,0,99,99,438
1983,49740,1523,1685,16241,16460,250,15.1,208,12.5,3764,1767,1997,10.7,22.9,4202,1631,2571,9.9,25.5,-438,-2.6,45.8,0,137,137,858
1984,49740,1584,1748,18114,17211,274,16,207,12.1,4861,1928,2933,11.2,28.2,3055,1417,1638,8.2,17.8,1806,10.4,35.6,0,126,127,735
1985,49740,1655,1838,21315,19783,325,18.1,236,13.1,6251,2566,3685,13,31.6,3187,1465,1722,7.4,16.1,3064,15.5,32.2,0,157,157,1013
1986,49740,1702,1880,22783,22055,276,14.9,227,12.2,5544,2329,3215,10.6,25.1,4087,1405,2682,6.4,18.5,1457,6.6,37,0,141,141,866
1987,49740,1714,1910,24127,23484,306,16.1,258,13.6,6300,3213,3087,13.7,26.8,5013,2614,2399,11.1,21.3,1287,5.5,42.6,0,146,146,1178
1988,49740,1757,1953,25787,25222,294,15.3,221,11.5,6274,3217,3057,12.8,24.9,5143,1817,3326,7.2,20.4,1131,4.5,40.8,0,134,134,815
1989,49740,1788,2004,25881,25796,266,13.4,209,10.6,5173,2395,2778,9.3,20.1,5002,1333,3669,5.2,19.4,171,0.7,38.8,0,135,135,797
1990,49740,1842,2070,27620,26311,286,14.1,211,10.4,7100,3256,3844,12.4,27,4481,2006,2475,7.6,17,2619,10,34,0,140,140,1018
1991,49740,1922,2158,46948,37407,287,13.6,201,9.5,25686,3018,22668,8.1,68.7,6604,1833,4771,4.9,17.7,19082,51,35.4,0,130,130,1101
1992,49740,1962,2206,29845,38398,299,13.7,249,11.4,7852,2387,5465,6.2,20.4,24958,,3014,,65,-17106,-44.6,40.8,1,147,149,1146
1993,49740,2000,2235,28845,29306,245,11,207,9.3,5532,2040,3492,7,18.9,6453,1777,4676,6.1,22,-921,-3.1,37.8,0,136,136,851
1994,49740,2058,2311,29880,29344,300,13.2,222,9.8,6227,3007,3220,10.2,21.2,5155,2045,3110,7,17.6,1072,3.6,35.2,0,161,161,1338
1995,49740,2071,2333,30608,30164,304,13.1,267,11.5,6021,2691,3330,8.9,20,5133,2144,2989,7.1,17,888,3,34,0,198,199,945
1996,49740,2112,2373,33048,31821,281,11.9,241,10.2,7049,3475,3574,10.9,22.2,4595,1735,2860,5.5,14.4,2454,7.8,28.8,0,149,150,1004
1997,49740,2174,2440,36154,35859,374,15.5,306,12.7,6182,3093,3089,8.6,17.2,5592,2241,3351,6.2,15.6,590,1.6,31.2,0,198,198,1081
1998,49740,2201,2474,36146,35825,319,13,268,10.9,6304,2467,3837,6.9,17.6,5661,2812,2849,7.8,15.8,643,1.8,31.6,0,178,178,1023
1999,49740,2258,2537,34734,34258,306,12.2,252,10.1,6879,2554,4325,7.5,20.1,5926,2947,2979,8.6,17.3,953,2.8,34.6,0,164,164,838
2000,49740,2285,2576,35208,35009,295,11.5,263,10.3,5606,2347,3259,6.7,16,5207,1479,3728,4.2,14.9,399,1.1,29.8,0,162,162,773
2001,49740,2303,2601,36239,35838,320,12.3,322,12.4,6373,2958,3415,8.3,17.8,5571,2428,3143,6.8,15.5,802,2.3,31,0,179,179,1158
2002,49740,2315,2626,40404,38324,322,12.3,300,11.5,9767,3190,6577,8.3,25.5,5606,2060,3546,5.4,14.6,4161,10.9,29.2,0,170,170,974
2003,49740,2317,2642,39514,39679,324,12.4,253,9.7,6654,2057,4597,5.2,16.8,6983,1844,5139,4.6,17.6,-329,-0.8,33.6,0,176,176,1104
2004,49740,2400,2738,42076,40603,334,12.4,217,8.1,7360,2463,4897,6.1,18.1,4413,1669,2744,4.1,10.9,2947,7.2,21.8,0,150,150,1040
2005,49740,2495,2861,44429,42881,394,14.1,235,8.4,8873,3947,4926,9.2,20.7,5776,1813,3963,4.2,13.5,3097,7.2,27,0,166,166,1185
2006,49740,2598,3002,47554,45596,438,15,272,9.3,9393,4514,4879,9.9,20.6,5477,2130,3347,4.7,12,3916,8.6,24,0,197,197,1053
2007,49740,2673,3107,47616,47489,402,13.2,302,9.9,8596,3269,5327,6.9,18.1,8341,2635,5706,5.5,17.6,255,0.5,35.2,0,189,189,1297
2008,49740,2682,3141,47801,47556,351,11.3,286,9.2,7552,3158,4394,6.6,15.9,7061,1448,5613,3,14.8,491,1.1,29.6,0,223,223,930
2009,49740,2647,3106,47050,47477,288,9.2,298,9.6,6861,3806,3055,8,14.5,7714,1582,6132,3.3,16.2,-853,-1.7,29,0,214,214,1149
2010,49740,2568,3015,45827,46091,263,8.6,333,10.9,6357,3442,2915,7.5,13.8,6884,1913,4971,4.2,14.9,-527,-1.1,27.6,0,247,248,1176
2011,49740,2515,2977,45049,45335,283,9.5,294,9.8,5206,1921,3285,4.2,11.5,5778,1858,3920,4.1,12.7,-572,-1.2,23,0,197,201,1270
2012,49740,2499,2963,45225,45149,263,8.9,280,9.4,6095,2033,4062,4.5,13.5,5942,2411,3531,5.3,13.2,153,0.3,26.4,0,169,170,893
2013,49740,2466,2922,43993,43817,218,7.4,255,8.7,5754,1907,3847,4.4,13.1,5402,1413,3989,3.2,12.3,352,0.8,24.6,0,167,167,898
2014,49740,2485,2971,44690,44247,285,9.7,216,7.4,6483,1882,4601,4.3,14.7,5596,2241,3355,5.1,12.6,887,2.1,25.2,0,143,143,927
